"","data","nome_aeroporto","tipo_transporte","tipo_voo","pousos_no_mes","decolagens_no_mes","pou_dec_no_mes","embarcado_no_mes","desembarcado_no_mes","emb_desemb_no_mes","carregada_no_mes","descarregada_no_mes","car_descar_no_mes","transito_no_mes"
"1",2012-04-01,"sbbe","transporte regular","voo doméstico",1632,1635,3267,129783,124350,254133,100650,332477,433127,0
"2",2012-04-01,"sbbe","transporte regular","voo internacional",25,25,50,2057,1805,3862,0,29,29,0
"3",2012-04-01,"sbbe","transporte não regular","voo doméstico",489,488,977,2364,2271,4635,0,0,0,0
"4",2012-04-01,"sbbe","transporte não regular","voo internacional",20,18,38,44,28,72,0,0,0,0
"5",2012-04-01,"sbbg","transporte regular","voo doméstico",0,0,0,0,0,0,0,0,0,0
"6",2012-04-01,"sbbg","transporte regular","voo internacional",0,0,0,0,0,0,0,0,0,0
"7",2012-04-01,"sbbg","transporte não regular","voo doméstico",22,24,46,155,138,293,0,0,0,0
"8",2012-04-01,"sbbg","transporte não regular","voo internacional",1,1,2,7,0,7,0,0,0,0
"9",2012-04-01,"sbbh","transporte regular","voo doméstico",666,672,1338,22515,23695,46210,0,0,0,0
"10",2012-04-01,"sbbh","transporte regular","voo internacional",0,0,0,0,0,0,0,0,0,0
"11",2012-04-01,"sbbh","transporte não regular","voo doméstico",2210,2208,4418,9278,9275,18553,0,0,0,0
"12",2012-04-01,"sbbh","transporte não regular","voo internacional",9,10,19,49,44,93,0,0,0,0
"13",2012-04-01,"sbbi","transporte regular","voo doméstico",0,0,0,0,0,0,0,0,0,0
"14",2012-04-01,"sbbi","transporte regular","voo internacional",0,0,0,0,0,0,0,0,0,0
"15",2012-04-01,"sbbi","transporte não regular","voo doméstico",1274,1260,2534,4496,3012,7508,0,0,0,0
"16",2012-04-01,"sbbi","transporte não regular","voo internacional",3,8,11,0,0,0,0,0,0,0
"17",2012-04-01,"sbbv","transporte regular","voo doméstico",90,91,181,12202,12069,24271,0,0,0,0
"18",2012-04-01,"sbbv","transporte regular","voo internacional",0,0,0,0,0,0,0,0,0,0
"19",2012-04-01,"sbbv","transporte não regular","voo doméstico",419,425,844,1098,689,1787,0,0,0,0
"20",2012-04-01,"sbbv","transporte não regular","voo internacional",38,29,67,21,10,31,0,0,0,0
"21",2012-04-01,"sbcg","transporte regular","voo doméstico",796,797,1593,65075,62250,127325,62415,140937,203352,0
"22",2012-04-01,"sbcg","transporte regular","voo internacional",51,51,102,1595,1653,3248,0,0,0,0
"23",2012-04-01,"sbcg","transporte não regular","voo doméstico",341,348,689,118,454,572,0,0,0,0
"24",2012-04-01,"sbcg","transporte não regular","voo internacional",15,17,32,0,0,0,0,0,0,0
"25",2012-04-01,"sbcj","transporte regular","voo doméstico",146,145,291,4283,4099,8382,0,0,0,0
"26",2012-04-01,"sbcj","transporte regular","voo internacional",0,0,0,0,0,0,0,0,0,0
"27",2012-04-01,"sbcj","transporte não regular","voo doméstico",126,128,254,929,1285,2214,0,0,0,0
"28",2012-04-01,"sbcj","transporte não regular","voo internacional",1,1,2,0,0,0,0,0,0,0
"29",2012-04-01,"sbcr","transporte regular","voo doméstico",30,30,60,1266,1253,2519,0,0,0,0
"30",2012-04-01,"sbcr","transporte regular","voo internacional",0,0,0,0,0,0,0,0,0,0
"31",2012-04-01,"sbcr","transporte não regular","voo doméstico",50,51,101,160,161,321,0,0,0,0
"32",2012-04-01,"sbcr","transporte não regular","voo internacional",4,3,7,10,11,21,0,0,0,0
"33",2012-04-01,"sbct","transporte regular","voo doméstico",3208,3199,6407,292924,284684,577608,173468,66420,239888,274697
"34",2012-04-01,"sbct","transporte regular","voo internacional",123,121,244,5557,4803,10360,0,0,0,0
"35",2012-04-01,"sbct","transporte não regular","voo doméstico",404,401,805,2407,2498,4905,0,0,0,0
"36",2012-04-01,"sbct","transporte não regular","voo internacional",23,28,51,141,28,169,0,0,0,0
"37",2012-04-01,"sbcz","transporte regular","voo doméstico",30,30,60,2337,2351,4688,0,0,0,0
"38",2012-04-01,"sbcz","transporte regular","voo internacional",0,0,0,0,0,0,0,0,0,0
"39",2012-04-01,"sbcz","transporte não regular","voo doméstico",217,219,436,1166,727,1893,4226,23420,27646,0
"40",2012-04-01,"sbcz","transporte não regular","voo internacional",1,1,2,0,0,0,0,0,0,0
"41",2012-04-01,"sbeg","transporte regular","voo doméstico",1351,1349,2700,113122,102072,215194,0,0,0,0
"42",2012-04-01,"sbeg","transporte regular","voo internacional",70,66,136,6146,6140,12286,0,0,0,0
"43",2012-04-01,"sbeg","transporte não regular","voo doméstico",672,690,1362,6433,6661,13094,0,0,0,0
"44",2012-04-01,"sbeg","transporte não regular","voo internacional",202,204,406,154,134,288,0,0,0,0
"45",2012-04-01,"sbfi","transporte regular","voo doméstico",618,617,1235,67082,68676,135758,0,0,0,0
"46",2012-04-01,"sbfi","transporte regular","voo internacional",30,30,60,2991,2881,5872,0,0,0,0
"47",2012-04-01,"sbfi","transporte não regular","voo doméstico",112,107,219,396,956,1352,0,0,0,0
"48",2012-04-01,"sbfi","transporte não regular","voo internacional",27,30,57,333,371,704,0,0,0,0
"49",2012-04-01,"sbgo","transporte regular","voo doméstico",1525,1524,3049,122510,123330,245840,110004,211967,321971,158041
"50",2012-04-01,"sbgo","transporte regular","voo internacional",0,0,0,0,0,0,0,0,0,0
"51",2012-04-01,"sbgo","transporte não regular","voo doméstico",1663,1663,3326,8608,8426,17034,0,0,0,0
"52",2012-04-01,"sbgo","transporte não regular","voo internacional",3,6,9,30,15,45,0,0,0,0
"53",2012-04-01,"sbht","transporte regular","voo doméstico",194,194,388,5636,5758,11394,0,0,0,0
"54",2012-04-01,"sbht","transporte regular","voo internacional",0,0,0,0,0,0,0,0,0,0
"55",2012-04-01,"sbht","transporte não regular","voo doméstico",156,155,311,142,171,313,12740,22676,35416,5627
"56",2012-04-01,"sbht","transporte não regular","voo internacional",0,0,0,0,0,0,0,0,0,0
"57",2012-04-01,"sbiz","transporte regular","voo doméstico",178,177,355,12865,12392,25257,0,0,0,0
"58",2012-04-01,"sbiz","transporte regular","voo internacional",0,0,0,0,0,0,0,0,0,0
"59",2012-04-01,"sbiz","transporte não regular","voo doméstico",173,173,346,385,421,806,0,0,0,0
"60",2012-04-01,"sbiz","transporte não regular","voo internacional",1,2,3,0,0,0,0,0,0,0
"61",2012-04-01,"sbjc","transporte regular","voo doméstico",0,0,0,0,0,0,0,0,0,0
"62",2012-04-01,"sbjc","transporte regular","voo internacional",0,0,0,0,0,0,0,0,0,0
"63",2012-04-01,"sbjc","transporte não regular","voo doméstico",619,625,1244,1023,1049,2072,0,0,0,0
"64",2012-04-01,"sbjc","transporte não regular","voo internacional",0,0,0,0,0,0,0,0,0,0
"65",2012-04-01,"sbjr","transporte regular","voo doméstico",0,0,0,0,0,0,0,0,0,0
"66",2012-04-01,"sbjr","transporte regular","voo internacional",0,0,0,0,0,0,0,0,0,0
"67",2012-04-01,"sbjr","transporte não regular","voo doméstico",3274,3290,6564,8662,4000,12662,0,0,0,0
"68",2012-04-01,"sbjr","transporte não regular","voo internacional",0,0,0,0,0,0,0,0,0,0
"69",2012-04-01,"sbjv","transporte regular","voo doméstico",275,277,552,18534,18186,36720,0,0,0,0
"70",2012-04-01,"sbjv","transporte regular","voo internacional",0,0,0,0,0,0,0,0,0,0
"71",2012-04-01,"sbjv","transporte não regular","voo doméstico",156,153,309,110,106,216,0,0,0,0
"72",2012-04-01,"sbjv","transporte não regular","voo internacional",1,1,2,0,0,0,0,0,0,0
"73",2012-04-01,"sblo","transporte regular","voo doméstico",622,622,1244,46192,46118,92310,0,0,0,0
"74",2012-04-01,"sblo","transporte regular","voo internacional",0,0,0,0,0,0,0,0,0,0
"75",2012-04-01,"sblo","transporte não regular","voo doméstico",881,883,1764,443,1053,1496,0,0,0,0
"76",2012-04-01,"sblo","transporte não regular","voo internacional",0,0,0,0,0,0,0,0,0,0
"77",2012-04-01,"sbma","transporte regular","voo doméstico",396,393,789,15653,14876,30529,0,0,0,0
"78",2012-04-01,"sbma","transporte regular","voo internacional",0,0,0,0,0,0,0,0,0,0
"79",2012-04-01,"sbma","transporte não regular","voo doméstico",219,223,442,434,484,918,0,0,0,0
"80",2012-04-01,"sbma","transporte não regular","voo internacional",3,3,6,0,0,0,0,0,0,0
"81",2012-04-01,"sbmk","transporte regular","voo doméstico",320,323,643,15482,15186,30668,0,0,0,0
"82",2012-04-01,"sbmk","transporte regular","voo internacional",0,0,0,0,0,0,0,0,0,0
"83",2012-04-01,"sbmk","transporte não regular","voo doméstico",218,216,434,127,154,281,0,0,0,0
"84",2012-04-01,"sbmk","transporte não regular","voo internacional",1,1,2,0,0,0,0,0,0,0
"85",2012-04-01,"sbmq","transporte regular","voo doméstico",208,209,417,21340,23016,44356,22300,32000,54300,0
"86",2012-04-01,"sbmq","transporte regular","voo internacional",0,0,0,0,0,0,0,0,0,0
"87",2012-04-01,"sbmq","transporte não regular","voo doméstico",231,229,460,424,219,643,0,0,0,0
"88",2012-04-01,"sbmq","transporte não regular","voo internacional",7,5,12,0,0,0,0,0,0,0
"89",2012-04-01,"sbmt","transporte regular","voo doméstico",0,0,0,0,0,0,0,0,0,0
"90",2012-04-01,"sbmt","transporte regular","voo internacional",0,0,0,0,0,0,0,0,0,0
"91",2012-04-01,"sbmt","transporte não regular","voo doméstico",6209,6231,12440,18635,18471,37106,0,0,0,0
"92",2012-04-01,"sbmt","transporte não regular","voo internacional",11,10,21,0,0,0,0,0,0,0
"93",2012-04-01,"sbnf","transporte regular","voo doméstico",622,624,1246,54079,52612,106691,0,0,0,0
"94",2012-04-01,"sbnf","transporte regular","voo internacional",0,0,0,0,0,0,0,0,0,0
"95",2012-04-01,"sbnf","transporte não regular","voo doméstico",383,383,766,1668,2024,3692,0,0,0,0
"96",2012-04-01,"sbnf","transporte não regular","voo internacional",6,7,13,14,14,28,0,0,0,0
"97",2012-04-01,"sbpb","transporte regular","voo doméstico",0,0,0,0,0,0,0,0,0,0
"98",2012-04-01,"sbpb","transporte regular","voo internacional",0,0,0,0,0,0,0,0,0,0
"99",2012-04-01,"sbpb","transporte não regular","voo doméstico",52,52,104,95,93,188,0,0,0,0
"100",2012-04-01,"sbpb","transporte não regular","voo internacional",0,0,0,0,0,0,0,0,0,0
"101",2012-04-01,"sbpj","transporte regular","voo doméstico",371,372,743,25690,25809,51499,0,0,0,0
"102",2012-04-01,"sbpj","transporte regular","voo internacional",0,0,0,0,0,0,0,0,0,0
"103",2012-04-01,"sbpj","transporte não regular","voo doméstico",386,391,777,534,421,955,18500,28237,46737,0
"104",2012-04-01,"sbpj","transporte não regular","voo internacional",5,5,10,0,10,10,0,0,0,0
"105",2012-04-01,"sbpk","transporte regular","voo doméstico",82,82,164,251,184,435,0,0,0,0
"106",2012-04-01,"sbpk","transporte regular","voo internacional",0,0,0,0,0,0,0,0,0,0
"107",2012-04-01,"sbpk","transporte não regular","voo doméstico",31,29,60,106,111,217,0,0,0,0
"108",2012-04-01,"sbpk","transporte não regular","voo internacional",0,1,1,3,0,3,0,0,0,0
"109",2012-04-01,"sbpl","transporte regular","voo doméstico",205,206,411,19965,20060,40025,0,0,0,0
"110",2012-04-01,"sbpl","transporte regular","voo internacional",4,4,8,0,0,0,0,0,0,0
"111",2012-04-01,"sbpl","transporte não regular","voo doméstico",67,69,136,43,48,91,0,0,0,0
"112",2012-04-01,"sbpl","transporte não regular","voo internacional",1,1,2,0,0,0,0,0,0,0
"113",2012-04-01,"sbpp","transporte regular","voo doméstico",0,0,0,0,0,0,0,0,0,0
"114",2012-04-01,"sbpp","transporte regular","voo internacional",0,0,0,0,0,0,0,0,0,0
"115",2012-04-01,"sbpp","transporte não regular","voo doméstico",58,60,118,144,133,277,0,0,0,0
"116",2012-04-01,"sbpp","transporte não regular","voo internacional",8,8,16,4,4,8,0,0,0,0
"117",2012-04-01,"sbpr","transporte regular","voo doméstico",0,0,0,0,0,0,0,0,0,0
"118",2012-04-01,"sbpr","transporte regular","voo internacional",0,0,0,0,0,0,0,0,0,0
"119",2012-04-01,"sbpr","transporte não regular","voo doméstico",1839,1842,3681,1937,1844,3781,0,0,0,0
"120",2012-04-01,"sbpr","transporte não regular","voo internacional",1,1,2,0,0,0,0,0,0,0
"121",2012-04-01,"sbpv","transporte regular","voo doméstico",596,595,1191,42682,41831,84513,45588,236756,282344,0
"122",2012-04-01,"sbpv","transporte regular","voo internacional",0,0,0,0,0,0,0,0,0,0
"123",2012-04-01,"sbpv","transporte não regular","voo doméstico",308,307,615,0,0,0,0,0,0,0
"124",2012-04-01,"sbpv","transporte não regular","voo internacional",1,1,2,6,6,12,0,0,0,0
"125",2012-04-01,"sbrb","transporte regular","voo doméstico",185,185,370,14216,14575,28791,0,0,0,0
"126",2012-04-01,"sbrb","transporte regular","voo internacional",0,0,0,0,0,0,0,0,0,0
"127",2012-04-01,"sbrb","transporte não regular","voo doméstico",337,334,671,960,952,1912,0,0,0,0
"128",2012-04-01,"sbrb","transporte não regular","voo internacional",0,0,0,0,0,0,0,0,0,0
"129",2012-04-01,"sbrj","transporte regular","voo doméstico",4167,4184,8351,377742,363395,741137,0,0,0,0
"130",2012-04-01,"sbrj","transporte regular","voo internacional",0,0,0,0,0,0,0,0,0,0
"131",2012-04-01,"sbrj","transporte não regular","voo doméstico",1514,1502,3016,846,786,1632,0,0,0,0
"132",2012-04-01,"sbrj","transporte não regular","voo internacional",13,13,26,0,0,0,0,0,0,0
"133",2012-04-01,"sbsj","transporte regular","voo doméstico",125,125,250,6731,6478,13209,0,0,0,0
"134",2012-04-01,"sbsj","transporte regular","voo internacional",0,0,0,0,0,0,0,0,0,0
"135",2012-04-01,"sbsj","transporte não regular","voo doméstico",565,554,1119,1645,1590,3235,0,0,0,0
"136",2012-04-01,"sbsj","transporte não regular","voo internacional",7,25,32,81,7,88,0,0,0,0
"137",2012-04-01,"sbsl","transporte regular","voo doméstico",822,820,1642,83041,84303,167344,0,0,0,0
"138",2012-04-01,"sbsl","transporte regular","voo internacional",0,0,0,0,0,0,0,0,0,0
"139",2012-04-01,"sbsl","transporte não regular","voo doméstico",394,395,789,1253,1115,2368,0,0,0,0
"140",2012-04-01,"sbsl","transporte não regular","voo internacional",1,0,1,0,5,5,0,0,0,0
"141",2012-04-01,"sbsn","transporte regular","voo doméstico",342,342,684,18100,17703,35803,0,0,0,0
"142",2012-04-01,"sbsn","transporte regular","voo internacional",0,0,0,0,0,0,0,0,0,0
"143",2012-04-01,"sbsn","transporte não regular","voo doméstico",332,331,663,723,754,1477,0,0,0,0
"144",2012-04-01,"sbsn","transporte não regular","voo internacional",0,0,0,0,0,0,0,0,0,0
"145",2012-04-01,"sbsp","transporte regular","voo doméstico",6298,6411,12709,722345,682120,1404465,0,0,0,0
"146",2012-04-01,"sbsp","transporte regular","voo internacional",0,0,0,0,0,0,0,0,0,0
"147",2012-04-01,"sbsp","transporte não regular","voo doméstico",2340,2234,4574,8104,9473,17577,0,0,0,0
"148",2012-04-01,"sbsp","transporte não regular","voo internacional",71,76,147,0,0,0,0,0,0,0
"149",2012-04-01,"sbte","transporte regular","voo doméstico",431,432,863,40268,42132,82400,0,0,0,0
"150",2012-04-01,"sbte","transporte regular","voo internacional",0,0,0,0,0,0,0,0,0,0
"151",2012-04-01,"sbte","transporte não regular","voo doméstico",205,206,411,1060,890,1950,0,0,0,0
"152",2012-04-01,"sbte","transporte não regular","voo internacional",0,0,0,0,0,0,0,0,0,0
"153",2012-04-01,"sbtf","transporte regular","voo doméstico",73,73,146,1388,1486,2874,0,0,0,0
"154",2012-04-01,"sbtf","transporte regular","voo internacional",0,0,0,0,0,0,0,0,0,0
"155",2012-04-01,"sbtf","transporte não regular","voo doméstico",447,448,895,2496,2476,4972,3606,7211,10817,14919
"156",2012-04-01,"sbtf","transporte não regular","voo internacional",0,0,0,0,0,0,0,0,0,0
"157",2012-04-01,"sbtt","transporte regular","voo doméstico",39,39,78,1258,1365,2623,0,0,0,0
"158",2012-04-01,"sbtt","transporte regular","voo internacional",0,0,0,0,0,0,0,0,0,0
"159",2012-04-01,"sbtt","transporte não regular","voo doméstico",53,54,107,213,207,420,2357,3574,5931,449
"160",2012-04-01,"sbtt","transporte não regular","voo internacional",0,0,0,0,0,0,0,0,0,0
"161",2012-04-01,"sbuf","transporte regular","voo doméstico",0,0,0,0,0,0,0,0,0,0
"162",2012-04-01,"sbuf","transporte regular","voo internacional",0,0,0,0,0,0,0,0,0,0
"163",2012-04-01,"sbuf","transporte não regular","voo doméstico",30,29,59,60,78,138,0,0,0,0
"164",2012-04-01,"sbuf","transporte não regular","voo internacional",0,0,0,0,0,0,0,0,0,0
"165",2012-04-01,"sbug","transporte regular","voo doméstico",20,20,40,132,122,254,0,0,0,0
"166",2012-04-01,"sbug","transporte regular","voo internacional",0,0,0,0,0,0,0,0,0,0
"167",2012-04-01,"sbug","transporte não regular","voo doméstico",6,5,11,14,14,28,0,0,0,0
"168",2012-04-01,"sbug","transporte não regular","voo internacional",4,4,8,0,0,0,0,0,0,0
"169",2012-04-01,"sbul","transporte regular","voo doméstico",573,575,1148,38278,37282,75560,0,0,0,0
"170",2012-04-01,"sbul","transporte regular","voo internacional",0,0,0,0,0,0,0,0,0,0
"171",2012-04-01,"sbul","transporte não regular","voo doméstico",522,526,1048,1353,1339,2692,0,0,0,0
"172",2012-04-01,"sbul","transporte não regular","voo internacional",0,0,0,0,0,0,0,0,0,0
"173",2012-04-01,"sbur","transporte regular","voo doméstico",209,212,421,7014,7222,14236,0,0,0,0
"174",2012-04-01,"sbur","transporte regular","voo internacional",0,0,0,0,0,0,0,0,0,0
"175",2012-04-01,"sbur","transporte não regular","voo doméstico",209,198,407,905,927,1832,0,0,0,0
"176",2012-04-01,"sbur","transporte não regular","voo internacional",0,0,0,0,0,0,0,0,0,0
"177",2012-08-01,"sbbe","transporte regular","voo doméstico",1724,1744,3468,145209,141486,286695,117067,401391,518458,0
"178",2012-08-01,"sbbe","transporte regular","voo internacional",29,28,57,2231,2445,4676,0,16,16,0
"179",2012-08-01,"sbbe","transporte não regular","voo doméstico",623,608,1231,2802,5190,7992,0,0,0,0
"180",2012-08-01,"sbbe","transporte não regular","voo internacional",14,11,25,20,32,52,0,0,0,0
"181",2012-08-01,"sbbg","transporte regular","voo doméstico",0,0,0,0,0,0,0,0,0,0
"182",2012-08-01,"sbbg","transporte regular","voo internacional",0,0,0,0,0,0,0,0,0,0
"183",2012-08-01,"sbbg","transporte não regular","voo doméstico",7,6,13,46,45,91,0,0,0,0
"184",2012-08-01,"sbbg","transporte não regular","voo internacional",1,1,2,6,6,12,0,0,0,0
"185",2012-08-01,"sbbh","transporte regular","voo doméstico",712,716,1428,20497,22128,42625,0,0,0,0
"186",2012-08-01,"sbbh","transporte regular","voo internacional",0,0,0,0,0,0,0,0,0,0
"187",2012-08-01,"sbbh","transporte não regular","voo doméstico",2911,2916,5827,11111,11081,22192,0,0,0,0
"188",2012-08-01,"sbbh","transporte não regular","voo internacional",18,15,33,83,99,182,0,0,0,0
"189",2012-08-01,"sbbi","transporte regular","voo doméstico",0,0,0,0,0,0,0,0,0,0
"190",2012-08-01,"sbbi","transporte regular","voo internacional",0,0,0,0,0,0,0,0,0,0
"191",2012-08-01,"sbbi","transporte não regular","voo doméstico",1594,1589,3183,3790,3448,7238,0,0,0,0
"192",2012-08-01,"sbbi","transporte não regular","voo internacional",5,4,9,0,0,0,0,0,0,0
"193",2012-08-01,"sbbv","transporte regular","voo doméstico",93,93,186,12631,13148,25779,0,0,0,0
"194",2012-08-01,"sbbv","transporte regular","voo internacional",0,0,0,0,0,0,0,0,0,0
"195",2012-08-01,"sbbv","transporte não regular","voo doméstico",419,417,836,961,290,1251,0,0,0,0
"196",2012-08-01,"sbbv","transporte não regular","voo internacional",27,23,50,13,12,25,0,0,0,0
"197",2012-08-01,"sbcg","transporte regular","voo doméstico",896,894,1790,70843,68735,139578,77828,165225,243053,0
"198",2012-08-01,"sbcg","transporte regular","voo internacional",61,61,122,609,2412,3021,0,0,0,0
"199",2012-08-01,"sbcg","transporte não regular","voo doméstico",523,519,1042,307,114,421,0,0,0,0
"200",2012-08-01,"sbcg","transporte não regular","voo internacional",7,6,13,0,0,0,0,0,0,0
"201",2012-08-01,"sbcj","transporte regular","voo doméstico",210,203,413,5291,5681,10972,0,0,0,0
"202",2012-08-01,"sbcj","transporte regular","voo internacional",0,0,0,0,0,0,0,0,0,0
"203",2012-08-01,"sbcj","transporte não regular","voo doméstico",121,130,251,865,422,1287,0,0,0,0
"204",2012-08-01,"sbcj","transporte não regular","voo internacional",0,0,0,0,0,0,0,0,0,0
"205",2012-08-01,"sbcr","transporte regular","voo doméstico",31,31,62,1416,1412,2828,0,0,0,0
"206",2012-08-01,"sbcr","transporte regular","voo internacional",0,0,0,0,0,0,0,0,0,0
"207",2012-08-01,"sbcr","transporte não regular","voo doméstico",176,176,352,337,316,653,0,0,0,0
"208",2012-08-01,"sbcr","transporte não regular","voo internacional",4,4,8,15,12,27,0,0,0,0
"209",2012-08-01,"sbct","transporte regular","voo doméstico",3437,3441,6878,308888,284873,593761,200679,81302,281981,317473
"210",2012-08-01,"sbct","transporte regular","voo internacional",86,87,173,3437,2171,5608,0,0,0,0
"211",2012-08-01,"sbct","transporte não regular","voo doméstico",329,320,649,1876,2965,4841,0,0,0,0
"212",2012-08-01,"sbct","transporte não regular","voo internacional",18,19,37,27,82,109,0,0,0,0
"213",2012-08-01,"sbcz","transporte regular","voo doméstico",30,30,60,2822,2660,5482,0,0,0,0
"214",2012-08-01,"sbcz","transporte regular","voo internacional",0,0,0,0,0,0,0,0,0,0
"215",2012-08-01,"sbcz","transporte não regular","voo doméstico",251,248,499,1041,972,2013,422,3355,3777,0
"216",2012-08-01,"sbcz","transporte não regular","voo internacional",0,0,0,0,0,0,0,0,0,0
"217",2012-08-01,"sbeg","transporte regular","voo doméstico",1341,1329,2670,118013,116614,234627,0,0,0,0
"218",2012-08-01,"sbeg","transporte regular","voo internacional",111,113,224,7934,7290,15224,0,0,0,0
"219",2012-08-01,"sbeg","transporte não regular","voo doméstico",712,728,1440,6469,5059,11528,0,0,0,0
"220",2012-08-01,"sbeg","transporte não regular","voo internacional",168,166,334,175,294,469,0,0,0,0
"221",2012-08-01,"sbfi","transporte regular","voo doméstico",662,660,1322,70068,71630,141698,0,0,0,0
"222",2012-08-01,"sbfi","transporte regular","voo internacional",18,18,36,2229,2272,4501,0,0,0,0
"223",2012-08-01,"sbfi","transporte não regular","voo doméstico",161,163,324,255,668,923,0,0,0,0
"224",2012-08-01,"sbfi","transporte não regular","voo internacional",40,42,82,330,369,699,0,0,0,0
"225",2012-08-01,"sbgo","transporte regular","voo doméstico",1604,1598,3202,130901,130722,261623,120638,212437,333075,191549
"226",2012-08-01,"sbgo","transporte regular","voo internacional",0,0,0,0,0,0,0,0,0,0
"227",2012-08-01,"sbgo","transporte não regular","voo doméstico",1441,1478,2919,4649,243,4892,0,0,0,0
"228",2012-08-01,"sbgo","transporte não regular","voo internacional",8,7,15,0,0,0,0,0,0,0
"229",2012-08-01,"sbht","transporte regular","voo doméstico",266,266,532,7071,6943,14014,0,0,0,0
"230",2012-08-01,"sbht","transporte regular","voo internacional",0,0,0,0,0,0,0,0,0,0
"231",2012-08-01,"sbht","transporte não regular","voo doméstico",155,157,312,149,152,301,13177,20325,33502,9664
"232",2012-08-01,"sbht","transporte não regular","voo internacional",1,1,2,0,0,0,0,0,0,0
"233",2012-08-01,"sbiz","transporte regular","voo doméstico",185,184,369,14821,16226,31047,0,0,0,0
"234",2012-08-01,"sbiz","transporte regular","voo internacional",0,0,0,0,0,0,0,0,0,0
"235",2012-08-01,"sbiz","transporte não regular","voo doméstico",176,172,348,412,455,867,0,0,0,0
"236",2012-08-01,"sbiz","transporte não regular","voo internacional",0,0,0,0,0,0,0,0,0,0
"237",2012-08-01,"sbjc","transporte regular","voo doméstico",0,0,0,0,0,0,0,0,0,0
"238",2012-08-01,"sbjc","transporte regular","voo internacional",0,0,0,0,0,0,0,0,0,0
"239",2012-08-01,"sbjc","transporte não regular","voo doméstico",821,826,1647,1296,1314,2610,0,0,0,0
"240",2012-08-01,"sbjc","transporte não regular","voo internacional",1,2,3,0,0,0,0,0,0,0
"241",2012-08-01,"sbjr","transporte regular","voo doméstico",0,0,0,0,0,0,0,0,0,0
"242",2012-08-01,"sbjr","transporte regular","voo internacional",0,0,0,0,0,0,0,0,0,0
"243",2012-08-01,"sbjr","transporte não regular","voo doméstico",3593,3600,7193,8589,3687,12276,0,0,0,0
"244",2012-08-01,"sbjr","transporte não regular","voo internacional",0,0,0,0,0,0,0,0,0,0
"245",2012-08-01,"sbjv","transporte regular","voo doméstico",298,297,595,17746,17436,35182,0,0,0,0
"246",2012-08-01,"sbjv","transporte regular","voo internacional",0,0,0,0,0,0,0,0,0,0
"247",2012-08-01,"sbjv","transporte não regular","voo doméstico",140,138,278,235,1075,1310,0,0,0,0
"248",2012-08-01,"sbjv","transporte não regular","voo internacional",0,0,0,0,0,0,0,0,0,0
"249",2012-08-01,"sblo","transporte regular","voo doméstico",647,646,1293,50032,49329,99361,0,0,0,0
"250",2012-08-01,"sblo","transporte regular","voo internacional",0,0,0,0,0,0,0,0,0,0
"251",2012-08-01,"sblo","transporte não regular","voo doméstico",929,926,1855,623,563,1186,0,0,0,0
"252",2012-08-01,"sblo","transporte não regular","voo internacional",3,0,3,0,0,0,0,0,0,0
"253",2012-08-01,"sbma","transporte regular","voo doméstico",459,459,918,17739,17771,35510,0,0,0,0
"254",2012-08-01,"sbma","transporte regular","voo internacional",0,0,0,0,0,0,0,0,0,0
"255",2012-08-01,"sbma","transporte não regular","voo doméstico",276,278,554,475,818,1293,0,0,0,0
"256",2012-08-01,"sbma","transporte não regular","voo internacional",6,6,12,0,0,0,0,0,0,0
"257",2012-08-01,"sbmk","transporte regular","voo doméstico",341,341,682,14239,13656,27895,0,0,0,0
"258",2012-08-01,"sbmk","transporte regular","voo internacional",0,0,0,0,0,0,0,0,0,0
"259",2012-08-01,"sbmk","transporte não regular","voo doméstico",196,194,390,39,59,98,0,0,0,0
"260",2012-08-01,"sbmk","transporte não regular","voo internacional",0,0,0,0,0,0,0,0,0,0
"261",2012-08-01,"sbmq","transporte regular","voo doméstico",234,239,473,24999,27321,52320,29010,39550,68560,0
"262",2012-08-01,"sbmq","transporte regular","voo internacional",14,13,27,0,0,0,0,0,0,0
"263",2012-08-01,"sbmq","transporte não regular","voo doméstico",342,336,678,714,557,1271,0,0,0,0
"264",2012-08-01,"sbmq","transporte não regular","voo internacional",1,1,2,0,0,0,0,0,0,0
"265",2012-08-01,"sbmt","transporte regular","voo doméstico",0,0,0,0,0,0,0,0,0,0
"266",2012-08-01,"sbmt","transporte regular","voo internacional",0,0,0,0,0,0,0,0,0,0
"267",2012-08-01,"sbmt","transporte não regular","voo doméstico",7154,7168,14322,21429,21357,42786,0,0,0,0
"268",2012-08-01,"sbmt","transporte não regular","voo internacional",9,6,15,0,0,0,0,0,0,0
"269",2012-08-01,"sbnf","transporte regular","voo doméstico",658,656,1314,51670,54047,105717,0,0,0,0
"270",2012-08-01,"sbnf","transporte regular","voo internacional",2,1,3,0,0,0,0,0,0,0
"271",2012-08-01,"sbnf","transporte não regular","voo doméstico",379,368,747,1427,1536,2963,0,0,0,0
"272",2012-08-01,"sbnf","transporte não regular","voo internacional",1,1,2,0,0,0,0,0,0,0
"273",2012-08-01,"sbpb","transporte regular","voo doméstico",0,0,0,0,0,0,0,0,0,0
"274",2012-08-01,"sbpb","transporte regular","voo internacional",0,0,0,0,0,0,0,0,0,0
"275",2012-08-01,"sbpb","transporte não regular","voo doméstico",44,43,87,87,105,192,0,0,0,0
"276",2012-08-01,"sbpb","transporte não regular","voo internacional",1,1,2,0,0,0,0,0,0,0
"277",2012-08-01,"sbpj","transporte regular","voo doméstico",286,284,570,23375,22541,45916,0,0,0,0
"278",2012-08-01,"sbpj","transporte regular","voo internacional",0,0,0,0,0,0,0,0,0,0
"279",2012-08-01,"sbpj","transporte não regular","voo doméstico",556,558,1114,1095,980,2075,26250,40000,66250,0
"280",2012-08-01,"sbpj","transporte não regular","voo internacional",3,3,6,0,0,0,0,0,0,0
"281",2012-08-01,"sbpk","transporte regular","voo doméstico",81,80,161,214,183,397,0,0,0,0
"282",2012-08-01,"sbpk","transporte regular","voo internacional",0,0,0,0,0,0,0,0,0,0
"283",2012-08-01,"sbpk","transporte não regular","voo doméstico",115,116,231,303,286,589,0,0,0,0
"284",2012-08-01,"sbpk","transporte não regular","voo internacional",3,2,5,0,7,7,0,0,0,0
"285",2012-08-01,"sbpl","transporte regular","voo doméstico",177,177,354,18970,18238,37208,0,0,0,0
"286",2012-08-01,"sbpl","transporte regular","voo internacional",5,5,10,0,0,0,0,0,0,0
"287",2012-08-01,"sbpl","transporte não regular","voo doméstico",65,64,129,81,84,165,0,0,0,0
"288",2012-08-01,"sbpl","transporte não regular","voo internacional",0,0,0,0,0,0,0,0,0,0
"289",2012-08-01,"sbpp","transporte regular","voo doméstico",0,0,0,0,0,0,0,0,0,0
"290",2012-08-01,"sbpp","transporte regular","voo internacional",0,0,0,0,0,0,0,0,0,0
"291",2012-08-01,"sbpp","transporte não regular","voo doméstico",80,81,161,138,128,266,0,0,0,0
"292",2012-08-01,"sbpp","transporte não regular","voo internacional",10,11,21,9,9,18,0,0,0,0
"293",2012-08-01,"sbpr","transporte regular","voo doméstico",0,0,0,0,0,0,0,0,0,0
"294",2012-08-01,"sbpr","transporte regular","voo internacional",0,0,0,0,0,0,0,0,0,0
"295",2012-08-01,"sbpr","transporte não regular","voo doméstico",1786,1784,3570,1817,1753,3570,0,0,0,0
"296",2012-08-01,"sbpr","transporte não regular","voo internacional",0,0,0,0,0,0,0,0,0,0
"297",2012-08-01,"sbpv","transporte regular","voo doméstico",640,640,1280,46240,46040,92280,63076,247815,310891,0
"298",2012-08-01,"sbpv","transporte regular","voo internacional",0,0,0,0,0,0,0,0,0,0
"299",2012-08-01,"sbpv","transporte não regular","voo doméstico",286,286,572,0,0,0,0,0,0,0
"300",2012-08-01,"sbpv","transporte não regular","voo internacional",0,0,0,0,0,0,0,0,0,0
"301",2012-08-01,"sbrb","transporte regular","voo doméstico",207,207,414,16245,18099,34344,0,0,0,0
"302",2012-08-01,"sbrb","transporte regular","voo internacional",0,0,0,0,0,0,0,0,0,0
"303",2012-08-01,"sbrb","transporte não regular","voo doméstico",336,336,672,1016,746,1762,0,0,0,0
"304",2012-08-01,"sbrb","transporte não regular","voo internacional",2,2,4,0,0,0,0,0,0,0
"305",2012-08-01,"sbrj","transporte regular","voo doméstico",4662,4671,9333,410646,408555,819201,0,0,0,0
"306",2012-08-01,"sbrj","transporte regular","voo internacional",0,0,0,0,0,0,0,0,0,0
"307",2012-08-01,"sbrj","transporte não regular","voo doméstico",1452,1432,2884,220,715,935,0,0,0,0
"308",2012-08-01,"sbrj","transporte não regular","voo internacional",18,18,36,0,0,0,0,0,0,0
"309",2012-08-01,"sbsj","transporte regular","voo doméstico",160,160,320,7708,7653,15361,0,0,0,0
"310",2012-08-01,"sbsj","transporte regular","voo internacional",0,0,0,0,0,0,0,0,0,0
"311",2012-08-01,"sbsj","transporte não regular","voo doméstico",799,770,1569,2427,2415,4842,0,0,0,0
"312",2012-08-01,"sbsj","transporte não regular","voo internacional",4,17,21,75,13,88,0,0,0,0
"313",2012-08-01,"sbsl","transporte regular","voo doméstico",812,811,1623,84587,84807,169394,0,0,0,0
"314",2012-08-01,"sbsl","transporte regular","voo internacional",0,0,0,0,0,0,0,0,0,0
"315",2012-08-01,"sbsl","transporte não regular","voo doméstico",546,544,1090,924,753,1677,70791,211257,282048,0
"316",2012-08-01,"sbsl","transporte não regular","voo internacional",2,2,4,0,0,0,0,0,0,0
"317",2012-08-01,"sbsn","transporte regular","voo doméstico",354,354,708,20189,20130,40319,0,0,0,0
"318",2012-08-01,"sbsn","transporte regular","voo internacional",0,0,0,0,0,0,0,0,0,0
"319",2012-08-01,"sbsn","transporte não regular","voo doméstico",464,462,926,950,919,1869,0,0,0,0
"320",2012-08-01,"sbsn","transporte não regular","voo internacional",3,3,6,0,0,0,0,0,0,0
"321",2012-08-01,"sbsp","transporte regular","voo doméstico",6947,7007,13954,731201,722161,1453362,0,0,0,0
"322",2012-08-01,"sbsp","transporte regular","voo internacional",0,0,0,0,0,0,0,0,0,0
"323",2012-08-01,"sbsp","transporte não regular","voo doméstico",2584,2545,5129,10164,10219,20383,0,0,0,0
"324",2012-08-01,"sbsp","transporte não regular","voo internacional",50,51,101,0,0,0,0,0,0,0
"325",2012-08-01,"sbte","transporte regular","voo doméstico",450,451,901,45794,43431,89225,28753,96305,125058,285885
"326",2012-08-01,"sbte","transporte regular","voo internacional",0,0,0,0,0,0,0,0,0,0
"327",2012-08-01,"sbte","transporte não regular","voo doméstico",216,210,426,896,969,1865,0,0,0,0
"328",2012-08-01,"sbte","transporte não regular","voo internacional",0,0,0,0,0,0,0,0,0,0
"329",2012-08-01,"sbtf","transporte regular","voo doméstico",77,77,154,1612,1748,3360,0,0,0,0
"330",2012-08-01,"sbtf","transporte regular","voo internacional",1,1,2,0,0,0,0,0,0,0
"331",2012-08-01,"sbtf","transporte não regular","voo doméstico",351,353,704,1296,1210,2506,2290,4438,6728,15215
"332",2012-08-01,"sbtf","transporte não regular","voo internacional",0,0,0,0,0,0,0,0,0,0
"333",2012-08-01,"sbtt","transporte regular","voo doméstico",63,63,126,1908,2140,4048,0,0,0,0
"334",2012-08-01,"sbtt","transporte regular","voo internacional",0,0,0,0,0,0,0,0,0,0
"335",2012-08-01,"sbtt","transporte não regular","voo doméstico",62,62,124,305,330,635,1657,4564,6221,607
"336",2012-08-01,"sbtt","transporte não regular","voo internacional",0,0,0,0,0,0,0,0,0,0
"337",2012-08-01,"sbuf","transporte regular","voo doméstico",0,0,0,0,0,0,0,0,0,0
"338",2012-08-01,"sbuf","transporte regular","voo internacional",0,0,0,0,0,0,0,0,0,0
"339",2012-08-01,"sbuf","transporte não regular","voo doméstico",34,35,69,124,122,246,0,0,0,0
"340",2012-08-01,"sbuf","transporte não regular","voo internacional",0,0,0,0,0,0,0,0,0,0
"341",2012-08-01,"sbug","transporte regular","voo doméstico",22,22,44,103,98,201,0,0,0,0
"342",2012-08-01,"sbug","transporte regular","voo internacional",0,0,0,0,0,0,0,0,0,0
"343",2012-08-01,"sbug","transporte não regular","voo doméstico",22,21,43,47,34,81,0,0,0,0
"344",2012-08-01,"sbug","transporte não regular","voo internacional",0,1,1,0,0,0,0,0,0,0
"345",2012-08-01,"sbul","transporte regular","voo doméstico",682,682,1364,46803,45275,92078,0,0,0,0
"346",2012-08-01,"sbul","transporte regular","voo internacional",0,0,0,0,0,0,0,0,0,0
"347",2012-08-01,"sbul","transporte não regular","voo doméstico",705,708,1413,1648,1721,3369,0,0,0,0
"348",2012-08-01,"sbul","transporte não regular","voo internacional",1,1,2,5,5,10,0,0,0,0
"349",2012-08-01,"sbur","transporte regular","voo doméstico",232,232,464,7301,7335,14636,0,0,0,0
"350",2012-08-01,"sbur","transporte regular","voo internacional",0,0,0,0,0,0,0,0,0,0
"351",2012-08-01,"sbur","transporte não regular","voo doméstico",211,200,411,1048,933,1981,0,0,0,0
"352",2012-08-01,"sbur","transporte não regular","voo internacional",1,1,2,0,0,0,0,0,0,0
"353",2012-12-01,"sbbe","transporte regular","voo doméstico",1545,1542,3087,139696,144039,283735,10700,79636,90336,0
"354",2012-12-01,"sbbe","transporte regular","voo internacional",17,17,34,1639,1836,3475,0,38,38,0
"355",2012-12-01,"sbbe","transporte não regular","voo doméstico",651,646,1297,3193,3905,7098,85502,294356,379858,0
"356",2012-12-01,"sbbe","transporte não regular","voo internacional",20,23,43,64,36,100,0,0,0,0
"357",2012-12-01,"sbbg","transporte regular","voo doméstico",0,0,0,0,0,0,0,0,0,0
"358",2012-12-01,"sbbg","transporte regular","voo internacional",0,0,0,0,0,0,0,0,0,0
"359",2012-12-01,"sbbg","transporte não regular","voo doméstico",18,18,36,81,113,194,0,0,0,0
"360",2012-12-01,"sbbg","transporte não regular","voo internacional",2,2,4,12,12,24,0,0,0,0
"361",2012-12-01,"sbbh","transporte regular","voo doméstico",673,674,1347,22335,24110,46445,0,0,0,0
"362",2012-12-01,"sbbh","transporte regular","voo internacional",0,0,0,0,0,0,0,0,0,0
"363",2012-12-01,"sbbh","transporte não regular","voo doméstico",2039,2044,4083,8855,9039,17894,0,0,0,0
"364",2012-12-01,"sbbh","transporte não regular","voo internacional",7,5,12,34,39,73,0,0,0,0
"365",2012-12-01,"sbbi","transporte regular","voo doméstico",0,0,0,0,0,0,0,0,0,0
"366",2012-12-01,"sbbi","transporte regular","voo internacional",0,0,0,0,0,0,0,0,0,0
"367",2012-12-01,"sbbi","transporte não regular","voo doméstico",918,919,1837,2767,2603,5370,0,0,0,0
"368",2012-12-01,"sbbi","transporte não regular","voo internacional",1,0,1,0,0,0,0,0,0,0
"369",2012-12-01,"sbbv","transporte regular","voo doméstico",93,93,186,15761,13020,28781,0,0,0,0
"370",2012-12-01,"sbbv","transporte regular","voo internacional",0,0,0,0,0,0,0,0,0,0
"371",2012-12-01,"sbbv","transporte não regular","voo doméstico",111,115,226,231,108,339,0,0,0,0
"372",2012-12-01,"sbbv","transporte não regular","voo internacional",41,37,78,6,5,11,0,0,0,0
"373",2012-12-01,"sbcg","transporte regular","voo doméstico",854,858,1712,78557,71275,149832,74009,166919,240928,0
"374",2012-12-01,"sbcg","transporte regular","voo internacional",0,0,0,0,0,0,0,0,0,0
"375",2012-12-01,"sbcg","transporte não regular","voo doméstico",297,292,589,424,281,705,0,0,0,0
"376",2012-12-01,"sbcg","transporte não regular","voo internacional",7,7,14,0,0,0,0,0,0,0
"377",2012-12-01,"sbcj","transporte regular","voo doméstico",133,133,266,4384,3418,7802,20,0,20,0
"378",2012-12-01,"sbcj","transporte regular","voo internacional",0,0,0,0,0,0,0,0,0,0
"379",2012-12-01,"sbcj","transporte não regular","voo doméstico",97,97,194,632,760,1392,0,0,0,0
"380",2012-12-01,"sbcj","transporte não regular","voo internacional",0,0,0,0,0,0,0,0,0,0
"381",2012-12-01,"sbcr","transporte regular","voo doméstico",30,30,60,973,1041,2014,0,0,0,0
"382",2012-12-01,"sbcr","transporte regular","voo internacional",0,0,0,0,0,0,0,0,0,0
"383",2012-12-01,"sbcr","transporte não regular","voo doméstico",97,99,196,278,238,516,0,0,0,0
"384",2012-12-01,"sbcr","transporte não regular","voo internacional",3,3,6,9,7,16,0,0,0,0
"385",2012-12-01,"sbct","transporte regular","voo doméstico",3049,3060,6109,272126,240015,512141,185424,97596,283020,423630
"386",2012-12-01,"sbct","transporte regular","voo internacional",90,90,180,2312,1820,4132,0,0,0,3107
"387",2012-12-01,"sbct","transporte não regular","voo doméstico",343,331,674,479,805,1284,0,0,0,0
"388",2012-12-01,"sbct","transporte não regular","voo internacional",19,22,41,0,0,0,0,0,0,0
"389",2012-12-01,"sbcz","transporte regular","voo doméstico",31,31,62,1961,2041,4002,0,0,0,0
"390",2012-12-01,"sbcz","transporte regular","voo internacional",0,0,0,0,0,0,0,0,0,0
"391",2012-12-01,"sbcz","transporte não regular","voo doméstico",190,191,381,750,688,1438,0,0,0,0
"392",2012-12-01,"sbcz","transporte não regular","voo internacional",0,0,0,0,0,0,0,0,0,0
"393",2012-12-01,"sbeg","transporte regular","voo doméstico",1318,1322,2640,132520,111070,243590,0,0,0,0
"394",2012-12-01,"sbeg","transporte regular","voo internacional",111,114,225,10997,9150,20147,0,0,0,0
"395",2012-12-01,"sbeg","transporte não regular","voo doméstico",763,752,1515,5882,5807,11689,0,0,0,0
"396",2012-12-01,"sbeg","transporte não regular","voo internacional",189,188,377,1437,292,1729,0,0,0,0
"397",2012-12-01,"sbfi","transporte regular","voo doméstico",513,512,1025,63559,65590,129149,0,400,400,0
"398",2012-12-01,"sbfi","transporte regular","voo internacional",17,17,34,2288,1893,4181,0,0,0,0
"399",2012-12-01,"sbfi","transporte não regular","voo doméstico",127,128,255,702,932,1634,0,0,0,0
"400",2012-12-01,"sbfi","transporte não regular","voo internacional",53,56,109,202,426,628,0,0,0,0
"401",2012-12-01,"sbgo","transporte regular","voo doméstico",1341,1336,2677,125780,119367,245147,123452,206314,329766,198363
"402",2012-12-01,"sbgo","transporte regular","voo internacional",0,0,0,0,0,0,0,0,0,0
"403",2012-12-01,"sbgo","transporte não regular","voo doméstico",1077,1116,2193,6973,5763,12736,0,0,0,0
"404",2012-12-01,"sbgo","transporte não regular","voo internacional",6,2,8,10,30,40,0,0,0,0
"405",2012-12-01,"sbht","transporte regular","voo doméstico",193,193,386,6827,5731,12558,0,0,0,0
"406",2012-12-01,"sbht","transporte regular","voo internacional",0,0,0,0,0,0,0,0,0,0
"407",2012-12-01,"sbht","transporte não regular","voo doméstico",188,191,379,1210,537,1747,12071,16743,28814,9115
"408",2012-12-01,"sbht","transporte não regular","voo internacional",0,0,0,0,0,0,0,0,0,0
"409",2012-12-01,"sbiz","transporte regular","voo doméstico",183,183,366,11691,12060,23751,0,0,0,0
"410",2012-12-01,"sbiz","transporte regular","voo internacional",0,0,0,0,0,0,0,0,0,0
"411",2012-12-01,"sbiz","transporte não regular","voo doméstico",174,177,351,1055,635,1690,0,0,0,0
"412",2012-12-01,"sbiz","transporte não regular","voo internacional",0,0,0,0,0,0,0,0,0,0
"413",2012-12-01,"sbjc","transporte regular","voo doméstico",0,0,0,0,0,0,0,0,0,0
"414",2012-12-01,"sbjc","transporte regular","voo internacional",0,0,0,0,0,0,0,0,0,0
"415",2012-12-01,"sbjc","transporte não regular","voo doméstico",715,712,1427,1780,1527,3307,0,0,0,0
"416",2012-12-01,"sbjc","transporte não regular","voo internacional",2,0,2,0,0,0,0,0,0,0
"417",2012-12-01,"sbjr","transporte regular","voo doméstico",0,0,0,0,0,0,0,0,0,0
"418",2012-12-01,"sbjr","transporte regular","voo internacional",0,0,0,0,0,0,0,0,0,0
"419",2012-12-01,"sbjr","transporte não regular","voo doméstico",3379,3380,6759,8093,4476,12569,0,0,0,0
"420",2012-12-01,"sbjr","transporte não regular","voo internacional",0,0,0,0,0,0,0,0,0,0
"421",2012-12-01,"sbjv","transporte regular","voo doméstico",286,286,572,14087,15544,29631,0,0,0,0
"422",2012-12-01,"sbjv","transporte regular","voo internacional",0,0,0,0,0,0,0,0,0,0
"423",2012-12-01,"sbjv","transporte não regular","voo doméstico",120,120,240,70,189,259,0,0,0,0
"424",2012-12-01,"sbjv","transporte não regular","voo internacional",0,0,0,0,0,0,0,0,0,0
"425",2012-12-01,"sblo","transporte regular","voo doméstico",646,644,1290,43687,44679,88366,0,0,0,0
"426",2012-12-01,"sblo","transporte regular","voo internacional",0,0,0,0,0,0,0,0,0,0
"427",2012-12-01,"sblo","transporte não regular","voo doméstico",736,744,1480,854,1073,1927,0,0,0,0
"428",2012-12-01,"sblo","transporte não regular","voo internacional",2,2,4,0,0,0,0,0,0,0
"429",2012-12-01,"sbma","transporte regular","voo doméstico",413,412,825,17154,14774,31928,0,0,0,0
"430",2012-12-01,"sbma","transporte regular","voo internacional",0,0,0,0,0,0,0,0,0,0
"431",2012-12-01,"sbma","transporte não regular","voo doméstico",289,292,581,368,298,666,0,0,0,0
"432",2012-12-01,"sbma","transporte não regular","voo internacional",3,3,6,0,0,0,0,0,0,0
"433",2012-12-01,"sbmk","transporte regular","voo doméstico",267,268,535,12142,13285,25427,0,0,0,0
"434",2012-12-01,"sbmk","transporte regular","voo internacional",0,0,0,0,0,0,0,0,0,0
"435",2012-12-01,"sbmk","transporte não regular","voo doméstico",191,193,384,42,40,82,0,0,0,0
"436",2012-12-01,"sbmk","transporte não regular","voo internacional",2,2,4,0,0,0,0,0,0,0
"437",2012-12-01,"sbmq","transporte regular","voo doméstico",240,234,474,25784,22080,47864,21150,36300,57450,0
"438",2012-12-01,"sbmq","transporte regular","voo internacional",0,0,0,0,0,0,0,0,0,0
"439",2012-12-01,"sbmq","transporte não regular","voo doméstico",274,279,553,797,258,1055,0,0,0,0
"440",2012-12-01,"sbmq","transporte não regular","voo internacional",10,12,22,0,0,0,0,0,0,0
"441",2012-12-01,"sbmt","transporte regular","voo doméstico",0,0,0,0,0,0,0,0,0,0
"442",2012-12-01,"sbmt","transporte regular","voo internacional",0,0,0,0,0,0,0,0,0,0
"443",2012-12-01,"sbmt","transporte não regular","voo doméstico",5370,5383,10753,16082,15603,31685,0,0,0,0
"444",2012-12-01,"sbmt","transporte não regular","voo internacional",2,3,5,0,0,0,0,0,0,0
"445",2012-12-01,"sbnf","transporte regular","voo doméstico",610,610,1220,45729,55557,101286,0,0,0,0
"446",2012-12-01,"sbnf","transporte regular","voo internacional",0,0,0,0,0,0,0,0,0,0
"447",2012-12-01,"sbnf","transporte não regular","voo doméstico",423,415,838,1509,1764,3273,0,0,0,0
"448",2012-12-01,"sbnf","transporte não regular","voo internacional",7,8,15,6,0,6,0,0,0,0
"449",2012-12-01,"sbpb","transporte regular","voo doméstico",0,0,0,0,0,0,0,0,0,0
"450",2012-12-01,"sbpb","transporte regular","voo internacional",0,0,0,0,0,0,0,0,0,0
"451",2012-12-01,"sbpb","transporte não regular","voo doméstico",92,81,173,161,213,374,0,0,0,0
"452",2012-12-01,"sbpb","transporte não regular","voo internacional",0,0,0,0,0,0,0,0,0,0
"453",2012-12-01,"sbpj","transporte regular","voo doméstico",264,262,526,22268,22614,44882,0,0,0,0
"454",2012-12-01,"sbpj","transporte regular","voo internacional",0,0,0,0,0,0,0,0,0,0
"455",2012-12-01,"sbpj","transporte não regular","voo doméstico",398,402,800,535,391,926,23900,36264,60164,0
"456",2012-12-01,"sbpj","transporte não regular","voo internacional",5,5,10,0,0,0,0,0,0,0
"457",2012-12-01,"sbpk","transporte regular","voo doméstico",52,53,105,103,99,202,0,0,0,0
"458",2012-12-01,"sbpk","transporte regular","voo internacional",0,0,0,0,0,0,0,0,0,0
"459",2012-12-01,"sbpk","transporte não regular","voo doméstico",63,56,119,145,159,304,0,0,0,0
"460",2012-12-01,"sbpk","transporte não regular","voo internacional",3,2,5,5,41,46,0,0,0,0
"461",2012-12-01,"sbpl","transporte regular","voo doméstico",219,219,438,19226,21974,41200,0,0,0,0
"462",2012-12-01,"sbpl","transporte regular","voo internacional",3,3,6,0,0,0,0,0,0,0
"463",2012-12-01,"sbpl","transporte não regular","voo doméstico",75,75,150,51,104,155,0,0,0,0
"464",2012-12-01,"sbpl","transporte não regular","voo internacional",5,5,10,0,0,0,0,0,0,0
"465",2012-12-01,"sbpp","transporte regular","voo doméstico",0,0,0,0,0,0,0,0,0,0
"466",2012-12-01,"sbpp","transporte regular","voo internacional",0,0,0,0,0,0,0,0,0,0
"467",2012-12-01,"sbpp","transporte não regular","voo doméstico",104,106,210,176,172,348,0,0,0,0
"468",2012-12-01,"sbpp","transporte não regular","voo internacional",7,7,14,9,9,18,0,0,0,0
"469",2012-12-01,"sbpr","transporte regular","voo doméstico",0,0,0,0,0,0,0,0,0,0
"470",2012-12-01,"sbpr","transporte regular","voo internacional",0,0,0,0,0,0,0,0,0,0
"471",2012-12-01,"sbpr","transporte não regular","voo doméstico",1269,1272,2541,1383,1232,2615,0,0,0,0
"472",2012-12-01,"sbpr","transporte não regular","voo internacional",0,0,0,0,0,0,0,0,0,0
"473",2012-12-01,"sbpv","transporte regular","voo doméstico",598,599,1197,52537,41488,94025,54665,254255,308920,0
"474",2012-12-01,"sbpv","transporte regular","voo internacional",0,0,0,0,0,0,0,0,0,0
"475",2012-12-01,"sbpv","transporte não regular","voo doméstico",226,226,452,0,0,0,0,0,0,0
"476",2012-12-01,"sbpv","transporte não regular","voo internacional",0,0,0,0,0,0,0,0,0,0
"477",2012-12-01,"sbrb","transporte regular","voo doméstico",206,207,413,17099,14968,32067,0,0,0,0
"478",2012-12-01,"sbrb","transporte regular","voo internacional",0,0,0,0,0,0,0,0,0,0
"479",2012-12-01,"sbrb","transporte não regular","voo doméstico",289,287,576,985,821,1806,0,0,0,0
"480",2012-12-01,"sbrb","transporte não regular","voo internacional",0,0,0,0,0,0,0,0,0,0
"481",2012-12-01,"sbrj","transporte regular","voo doméstico",4001,4025,8026,340098,375287,715385,0,0,0,0
"482",2012-12-01,"sbrj","transporte regular","voo internacional",0,0,0,0,0,0,0,0,0,0
"483",2012-12-01,"sbrj","transporte não regular","voo doméstico",1343,1319,2662,6895,6479,13374,0,0,0,0
"484",2012-12-01,"sbrj","transporte não regular","voo internacional",2,2,4,0,0,0,0,0,0,0
"485",2012-12-01,"sbsj","transporte regular","voo doméstico",167,170,337,7906,7251,15157,0,0,0,0
"486",2012-12-01,"sbsj","transporte regular","voo internacional",0,0,0,0,0,0,0,0,0,0
"487",2012-12-01,"sbsj","transporte não regular","voo doméstico",463,467,930,1377,950,2327,0,0,0,0
"488",2012-12-01,"sbsj","transporte não regular","voo internacional",12,34,46,41,17,58,0,0,0,0
"489",2012-12-01,"sbsl","transporte regular","voo doméstico",727,728,1455,77317,90318,167635,0,0,0,0
"490",2012-12-01,"sbsl","transporte regular","voo internacional",0,0,0,0,0,0,0,0,0,0
"491",2012-12-01,"sbsl","transporte não regular","voo doméstico",442,444,886,1043,1246,2289,61750,140886,202636,0
"492",2012-12-01,"sbsl","transporte não regular","voo internacional",3,4,7,0,0,0,0,0,0,0
"493",2012-12-01,"sbsn","transporte regular","voo doméstico",321,321,642,19052,20836,39888,0,0,0,0
"494",2012-12-01,"sbsn","transporte regular","voo internacional",0,0,0,0,0,0,0,0,0,0
"495",2012-12-01,"sbsn","transporte não regular","voo doméstico",340,339,679,856,631,1487,0,0,0,0
"496",2012-12-01,"sbsn","transporte não regular","voo internacional",0,1,1,0,0,0,0,0,0,0
"497",2012-12-01,"sbsp","transporte regular","voo doméstico",6568,6668,13236,740223,641167,1381390,0,0,0,0
"498",2012-12-01,"sbsp","transporte regular","voo internacional",0,0,0,0,0,0,0,0,0,0
"499",2012-12-01,"sbsp","transporte não regular","voo doméstico",2435,2345,4780,14542,12516,27058,0,0,0,0
"500",2012-12-01,"sbsp","transporte não regular","voo internacional",17,17,34,0,0,0,0,0,0,0
"501",2012-12-01,"sbte","transporte regular","voo doméstico",441,441,882,37254,50086,87340,22174,76350,98524,191765
"502",2012-12-01,"sbte","transporte regular","voo internacional",0,0,0,0,0,0,0,0,0,0
"503",2012-12-01,"sbte","transporte não regular","voo doméstico",189,195,384,858,1258,2116,0,0,0,0
"504",2012-12-01,"sbte","transporte não regular","voo internacional",0,0,0,0,0,0,0,0,0,0
"505",2012-12-01,"sbtf","transporte regular","voo doméstico",74,74,148,1806,1731,3537,0,0,0,0
"506",2012-12-01,"sbtf","transporte regular","voo internacional",0,0,0,0,0,0,0,0,0,0
"507",2012-12-01,"sbtf","transporte não regular","voo doméstico",306,307,613,566,532,1098,6315,6054,12369,25840
"508",2012-12-01,"sbtf","transporte não regular","voo internacional",0,0,0,0,0,0,0,0,0,0
"509",2012-12-01,"sbtt","transporte regular","voo doméstico",61,61,122,2166,2781,4947,0,0,0,0
"510",2012-12-01,"sbtt","transporte regular","voo internacional",0,0,0,0,0,0,0,0,0,0
"511",2012-12-01,"sbtt","transporte não regular","voo doméstico",54,53,107,203,217,420,3675,6444,10119,782
"512",2012-12-01,"sbtt","transporte não regular","voo internacional",2,3,5,12,8,20,0,0,0,0
"513",2012-12-01,"sbuf","transporte regular","voo doméstico",0,0,0,0,0,0,0,0,0,0
"514",2012-12-01,"sbuf","transporte regular","voo internacional",0,0,0,0,0,0,0,0,0,0
"515",2012-12-01,"sbuf","transporte não regular","voo doméstico",32,32,64,67,67,134,0,0,0,0
"516",2012-12-01,"sbuf","transporte não regular","voo internacional",0,0,0,0,0,0,0,0,0,0
"517",2012-12-01,"sbug","transporte regular","voo doméstico",15,15,30,55,78,133,0,0,0,0
"518",2012-12-01,"sbug","transporte regular","voo internacional",0,0,0,0,0,0,0,0,0,0
"519",2012-12-01,"sbug","transporte não regular","voo doméstico",8,9,17,19,12,31,0,0,0,0
"520",2012-12-01,"sbug","transporte não regular","voo internacional",1,0,1,0,0,0,0,0,0,0
"521",2012-12-01,"sbul","transporte regular","voo doméstico",629,627,1256,40203,40340,80543,0,0,0,0
"522",2012-12-01,"sbul","transporte regular","voo internacional",0,0,0,0,0,0,0,0,0,0
"523",2012-12-01,"sbul","transporte não regular","voo doméstico",612,616,1228,2037,1571,3608,0,0,0,0
"524",2012-12-01,"sbul","transporte não regular","voo internacional",1,1,2,14,16,30,0,0,0,0
"525",2012-12-01,"sbur","transporte regular","voo doméstico",144,145,289,5312,5200,10512,0,0,0,0
"526",2012-12-01,"sbur","transporte regular","voo internacional",0,0,0,0,0,0,0,0,0,0
"527",2012-12-01,"sbur","transporte não regular","voo doméstico",181,177,358,834,858,1692,0,0,0,0
"528",2012-12-01,"sbur","transporte não regular","voo internacional",1,1,2,0,0,0,0,0,0,0
"529",2012-02-01,"sbbe","transporte regular","voo doméstico",1513,1515,3028,118406,109674,228080,91962,357598,449560,0
"530",2012-02-01,"sbbe","transporte regular","voo internacional",20,20,40,1958,1710,3668,0,206,206,0
"531",2012-02-01,"sbbe","transporte não regular","voo doméstico",518,518,1036,2461,2331,4792,0,0,0,0
"532",2012-02-01,"sbbe","transporte não regular","voo internacional",17,18,35,36,16,52,0,0,0,0
"533",2012-02-01,"sbbg","transporte regular","voo doméstico",0,0,0,0,0,0,0,0,0,0
"534",2012-02-01,"sbbg","transporte regular","voo internacional",0,0,0,0,0,0,0,0,0,0
"535",2012-02-01,"sbbg","transporte não regular","voo doméstico",12,10,22,64,65,129,0,0,0,0
"536",2012-02-01,"sbbg","transporte não regular","voo internacional",1,1,2,15,15,30,0,0,0,0
"537",2012-02-01,"sbbh","transporte regular","voo doméstico",588,600,1188,18117,20097,38214,0,0,0,0
"538",2012-02-01,"sbbh","transporte regular","voo internacional",0,0,0,0,0,0,0,0,0,0
"539",2012-02-01,"sbbh","transporte não regular","voo doméstico",2038,2036,4074,8322,8266,16588,0,0,0,0
"540",2012-02-01,"sbbh","transporte não regular","voo internacional",13,11,24,43,55,98,0,0,0,0
"541",2012-02-01,"sbbi","transporte regular","voo doméstico",0,0,0,0,0,0,0,0,0,0
"542",2012-02-01,"sbbi","transporte regular","voo internacional",0,0,0,0,0,0,0,0,0,0
"543",2012-02-01,"sbbi","transporte não regular","voo doméstico",1257,1262,2519,4656,4448,9104,0,0,0,0
"544",2012-02-01,"sbbi","transporte não regular","voo internacional",2,2,4,0,0,0,0,0,0,0
"545",2012-02-01,"sbbv","transporte regular","voo doméstico",104,104,208,11324,14293,25617,0,0,0,0
"546",2012-02-01,"sbbv","transporte regular","voo internacional",0,0,0,0,0,0,0,0,0,0
"547",2012-02-01,"sbbv","transporte não regular","voo doméstico",434,437,871,781,411,1192,0,0,0,0
"548",2012-02-01,"sbbv","transporte não regular","voo internacional",43,33,76,22,44,66,0,0,0,0
"549",2012-02-01,"sbcg","transporte regular","voo doméstico",743,740,1483,52446,55511,107957,53980,144138,198118,0
"550",2012-02-01,"sbcg","transporte regular","voo internacional",58,59,117,2389,1435,3824,0,0,0,0
"551",2012-02-01,"sbcg","transporte não regular","voo doméstico",251,256,507,100,182,282,0,0,0,0
"552",2012-02-01,"sbcg","transporte não regular","voo internacional",13,13,26,0,0,0,0,0,0,0
"553",2012-02-01,"sbcj","transporte regular","voo doméstico",177,177,354,4237,5125,9362,0,0,0,0
"554",2012-02-01,"sbcj","transporte regular","voo internacional",0,0,0,0,0,0,0,0,0,0
"555",2012-02-01,"sbcj","transporte não regular","voo doméstico",91,90,181,450,566,1016,0,0,0,0
"556",2012-02-01,"sbcj","transporte não regular","voo internacional",0,0,0,0,0,0,0,0,0,0
"557",2012-02-01,"sbcr","transporte regular","voo doméstico",29,29,58,1124,1172,2296,0,0,0,0
"558",2012-02-01,"sbcr","transporte regular","voo internacional",0,0,0,0,0,0,0,0,0,0
"559",2012-02-01,"sbcr","transporte não regular","voo doméstico",52,52,104,235,206,441,0,0,0,0
"560",2012-02-01,"sbcr","transporte não regular","voo internacional",1,1,2,2,2,4,0,0,0,0
"561",2012-02-01,"sbct","transporte regular","voo doméstico",3050,3047,6097,235394,235547,470941,320501,117327,437828,335852
"562",2012-02-01,"sbct","transporte regular","voo internacional",124,125,249,4440,4094,8534,0,0,0,0
"563",2012-02-01,"sbct","transporte não regular","voo doméstico",260,265,525,1541,1628,3169,0,0,0,0
"564",2012-02-01,"sbct","transporte não regular","voo internacional",25,25,50,45,31,76,0,0,0,0
"565",2012-02-01,"sbcz","transporte regular","voo doméstico",28,28,56,2051,2181,4232,0,0,0,0
"566",2012-02-01,"sbcz","transporte regular","voo internacional",0,0,0,0,0,0,0,0,0,0
"567",2012-02-01,"sbcz","transporte não regular","voo doméstico",166,165,331,574,544,1118,3672,17635,21307,0
"568",2012-02-01,"sbcz","transporte não regular","voo internacional",0,0,0,0,0,0,0,0,0,0
"569",2012-02-01,"sbeg","transporte regular","voo doméstico",1360,1357,2717,100472,111312,211784,0,0,0,0
"570",2012-02-01,"sbeg","transporte regular","voo internacional",66,67,133,5288,5690,10978,0,0,0,0
"571",2012-02-01,"sbeg","transporte não regular","voo doméstico",699,685,1384,4684,5099,9783,0,0,0,0
"572",2012-02-01,"sbeg","transporte não regular","voo internacional",331,340,671,768,700,1468,0,0,0,0
"573",2012-02-01,"sbfi","transporte regular","voo doméstico",589,588,1177,61325,59700,121025,0,0,0,0
"574",2012-02-01,"sbfi","transporte regular","voo internacional",29,29,58,3116,3089,6205,0,0,0,0
"575",2012-02-01,"sbfi","transporte não regular","voo doméstico",94,102,196,628,802,1430,0,0,0,0
"576",2012-02-01,"sbfi","transporte não regular","voo internacional",57,51,108,673,533,1206,0,0,0,0
"577",2012-02-01,"sbgo","transporte regular","voo doméstico",1482,1482,2964,97490,96318,193808,97304,209197,306501,142610
"578",2012-02-01,"sbgo","transporte regular","voo internacional",0,0,0,0,0,0,0,0,0,0
"579",2012-02-01,"sbgo","transporte não regular","voo doméstico",1462,1461,2923,7820,7790,15610,0,0,0,0
"580",2012-02-01,"sbgo","transporte não regular","voo internacional",15,12,27,60,75,135,0,0,0,0
"581",2012-02-01,"sbht","transporte regular","voo doméstico",145,145,290,4113,4507,8620,0,0,0,0
"582",2012-02-01,"sbht","transporte regular","voo internacional",0,0,0,0,0,0,0,0,0,0
"583",2012-02-01,"sbht","transporte não regular","voo doméstico",138,138,276,1187,231,1418,10013,18886,28899,7803
"584",2012-02-01,"sbht","transporte não regular","voo internacional",3,3,6,0,0,0,0,0,0,0
"585",2012-02-01,"sbiz","transporte regular","voo doméstico",170,170,340,11383,9782,21165,0,10,10,0
"586",2012-02-01,"sbiz","transporte regular","voo internacional",0,0,0,0,0,0,0,0,0,0
"587",2012-02-01,"sbiz","transporte não regular","voo doméstico",137,135,272,230,293,523,0,100,100,0
"588",2012-02-01,"sbiz","transporte não regular","voo internacional",0,0,0,0,0,0,0,0,0,0
"589",2012-02-01,"sbjc","transporte regular","voo doméstico",0,0,0,0,0,0,0,0,0,0
"590",2012-02-01,"sbjc","transporte regular","voo internacional",0,0,0,0,0,0,0,0,0,0
"591",2012-02-01,"sbjc","transporte não regular","voo doméstico",637,640,1277,1032,1090,2122,0,0,0,0
"592",2012-02-01,"sbjc","transporte não regular","voo internacional",0,0,0,0,0,0,0,0,0,0
"593",2012-02-01,"sbjr","transporte regular","voo doméstico",0,0,0,0,0,0,0,0,0,0
"594",2012-02-01,"sbjr","transporte regular","voo internacional",0,0,0,0,0,0,0,0,0,0
"595",2012-02-01,"sbjr","transporte não regular","voo doméstico",3442,3466,6908,9571,5455,15026,0,0,0,0
"596",2012-02-01,"sbjr","transporte não regular","voo internacional",0,0,0,0,0,0,0,0,0,0
"597",2012-02-01,"sbjv","transporte regular","voo doméstico",302,301,603,18046,17518,35564,0,0,0,0
"598",2012-02-01,"sbjv","transporte regular","voo internacional",0,0,0,0,0,0,0,0,0,0
"599",2012-02-01,"sbjv","transporte não regular","voo doméstico",140,143,283,85,206,291,0,0,0,0
"600",2012-02-01,"sbjv","transporte não regular","voo internacional",2,2,4,4,4,8,0,0,0,0
"601",2012-02-01,"sblo","transporte regular","voo doméstico",573,575,1148,38609,38648,77257,0,0,0,0
"602",2012-02-01,"sblo","transporte regular","voo internacional",0,0,0,0,0,0,0,0,0,0
"603",2012-02-01,"sblo","transporte não regular","voo doméstico",747,751,1498,259,329,588,0,0,0,0
"604",2012-02-01,"sblo","transporte não regular","voo internacional",0,0,0,0,0,0,0,0,0,0
"605",2012-02-01,"sbma","transporte regular","voo doméstico",376,377,753,11918,11718,23636,0,0,0,0
"606",2012-02-01,"sbma","transporte regular","voo internacional",0,0,0,0,0,0,0,0,0,0
"607",2012-02-01,"sbma","transporte não regular","voo doméstico",202,203,405,750,763,1513,0,0,0,0
"608",2012-02-01,"sbma","transporte não regular","voo internacional",7,8,15,0,0,0,0,0,0,0
"609",2012-02-01,"sbmk","transporte regular","voo doméstico",186,185,371,8480,8525,17005,0,0,0,0
"610",2012-02-01,"sbmk","transporte regular","voo internacional",0,0,0,0,0,0,0,0,0,0
"611",2012-02-01,"sbmk","transporte não regular","voo doméstico",232,230,462,423,451,874,0,0,0,0
"612",2012-02-01,"sbmk","transporte não regular","voo internacional",0,0,0,0,0,0,0,0,0,0
"613",2012-02-01,"sbmq","transporte regular","voo doméstico",206,208,414,18438,20048,38486,20180,31300,51480,0
"614",2012-02-01,"sbmq","transporte regular","voo internacional",0,0,0,0,0,0,0,0,0,0
"615",2012-02-01,"sbmq","transporte não regular","voo doméstico",236,231,467,622,373,995,0,0,0,0
"616",2012-02-01,"sbmq","transporte não regular","voo internacional",16,18,34,0,21,21,0,0,0,0
"617",2012-02-01,"sbmt","transporte regular","voo doméstico",0,0,0,0,0,0,0,0,0,0
"618",2012-02-01,"sbmt","transporte regular","voo internacional",0,0,0,0,0,0,0,0,0,0
"619",2012-02-01,"sbmt","transporte não regular","voo doméstico",6249,6228,12477,18672,18642,37314,0,0,0,0
"620",2012-02-01,"sbmt","transporte não regular","voo internacional",10,9,19,0,0,0,0,0,0,0
"621",2012-02-01,"sbnf","transporte regular","voo doméstico",537,535,1072,43819,42203,86022,0,0,0,0
"622",2012-02-01,"sbnf","transporte regular","voo internacional",0,0,0,0,0,0,0,0,0,0
"623",2012-02-01,"sbnf","transporte não regular","voo doméstico",346,346,692,1387,1140,2527,0,0,0,0
"624",2012-02-01,"sbnf","transporte não regular","voo internacional",7,7,14,0,15,15,0,0,0,0
"625",2012-02-01,"sbpb","transporte regular","voo doméstico",0,0,0,0,0,0,0,0,0,0
"626",2012-02-01,"sbpb","transporte regular","voo internacional",0,0,0,0,0,0,0,0,0,0
"627",2012-02-01,"sbpb","transporte não regular","voo doméstico",69,69,138,142,162,304,0,0,0,0
"628",2012-02-01,"sbpb","transporte não regular","voo internacional",0,0,0,0,0,0,0,0,0,0
"629",2012-02-01,"sbpj","transporte regular","voo doméstico",337,340,677,20445,19946,40391,0,0,0,0
"630",2012-02-01,"sbpj","transporte regular","voo internacional",0,0,0,0,0,0,0,0,0,0
"631",2012-02-01,"sbpj","transporte não regular","voo doméstico",360,366,726,384,371,755,18480,24230,42710,0
"632",2012-02-01,"sbpj","transporte não regular","voo internacional",6,6,12,0,3,3,0,0,0,0
"633",2012-02-01,"sbpk","transporte regular","voo doméstico",75,74,149,184,175,359,0,0,0,0
"634",2012-02-01,"sbpk","transporte regular","voo internacional",0,0,0,0,0,0,0,0,0,0
"635",2012-02-01,"sbpk","transporte não regular","voo doméstico",61,59,120,160,166,326,0,0,0,0
"636",2012-02-01,"sbpk","transporte não regular","voo internacional",3,4,7,13,11,24,0,0,0,0
"637",2012-02-01,"sbpl","transporte regular","voo doméstico",202,204,406,17995,16844,34839,0,0,0,0
"638",2012-02-01,"sbpl","transporte regular","voo internacional",4,4,8,0,0,0,0,0,0,0
"639",2012-02-01,"sbpl","transporte não regular","voo doméstico",73,73,146,133,82,215,0,0,0,0
"640",2012-02-01,"sbpl","transporte não regular","voo internacional",0,0,0,0,0,0,0,0,0,0
"641",2012-02-01,"sbpp","transporte regular","voo doméstico",0,0,0,0,0,0,0,0,0,0
"642",2012-02-01,"sbpp","transporte regular","voo internacional",0,0,0,0,0,0,0,0,0,0
"643",2012-02-01,"sbpp","transporte não regular","voo doméstico",34,34,68,77,68,145,0,0,0,0
"644",2012-02-01,"sbpp","transporte não regular","voo internacional",11,11,22,5,5,10,0,0,0,0
"645",2012-02-01,"sbpr","transporte regular","voo doméstico",0,0,0,0,0,0,0,0,0,0
"646",2012-02-01,"sbpr","transporte regular","voo internacional",0,0,0,0,0,0,0,0,0,0
"647",2012-02-01,"sbpr","transporte não regular","voo doméstico",1578,1575,3153,1587,1558,3145,0,0,0,0
"648",2012-02-01,"sbpr","transporte não regular","voo internacional",6,5,11,0,0,0,0,0,0,0
"649",2012-02-01,"sbpv","transporte regular","voo doméstico",569,570,1139,39267,41414,80681,198054,40980,239034,0
"650",2012-02-01,"sbpv","transporte regular","voo internacional",0,0,0,0,0,0,0,0,0,0
"651",2012-02-01,"sbpv","transporte não regular","voo doméstico",292,291,583,378,385,763,0,0,0,0
"652",2012-02-01,"sbpv","transporte não regular","voo internacional",5,5,10,25,25,50,0,0,0,0
"653",2012-02-01,"sbrb","transporte regular","voo doméstico",177,179,356,12947,14958,27905,0,0,0,0
"654",2012-02-01,"sbrb","transporte regular","voo internacional",0,0,0,0,0,0,0,0,0,0
"655",2012-02-01,"sbrb","transporte não regular","voo doméstico",328,320,648,680,501,1181,0,0,0,0
"656",2012-02-01,"sbrb","transporte não regular","voo internacional",0,0,0,0,0,0,0,0,0,0
"657",2012-02-01,"sbrj","transporte regular","voo doméstico",4072,4094,8166,320414,311195,631609,0,0,0,0
"658",2012-02-01,"sbrj","transporte regular","voo internacional",0,0,0,0,0,0,0,0,0,0
"659",2012-02-01,"sbrj","transporte não regular","voo doméstico",1428,1407,2835,868,1568,2436,0,0,0,0
"660",2012-02-01,"sbrj","transporte não regular","voo internacional",16,17,33,0,0,0,0,0,0,0
"661",2012-02-01,"sbsj","transporte regular","voo doméstico",117,118,235,5393,5254,10647,0,0,0,0
"662",2012-02-01,"sbsj","transporte regular","voo internacional",0,0,0,0,0,0,0,0,0,0
"663",2012-02-01,"sbsj","transporte não regular","voo doméstico",548,537,1085,1638,1491,3129,0,0,0,0
"664",2012-02-01,"sbsj","transporte não regular","voo internacional",10,19,29,67,16,83,0,0,0,0
"665",2012-02-01,"sbsl","transporte regular","voo doméstico",868,872,1740,76296,74500,150796,0,476,476,0
"666",2012-02-01,"sbsl","transporte regular","voo internacional",0,0,0,0,0,0,0,0,0,0
"667",2012-02-01,"sbsl","transporte não regular","voo doméstico",450,448,898,1566,1069,2635,63025,190435,253460,0
"668",2012-02-01,"sbsl","transporte não regular","voo internacional",0,0,0,0,0,0,0,0,0,0
"669",2012-02-01,"sbsn","transporte regular","voo doméstico",342,342,684,18232,16344,34576,0,0,0,0
"670",2012-02-01,"sbsn","transporte regular","voo internacional",0,0,0,0,0,0,0,0,0,0
"671",2012-02-01,"sbsn","transporte não regular","voo doméstico",331,330,661,476,352,828,0,0,0,0
"672",2012-02-01,"sbsn","transporte não regular","voo internacional",6,6,12,0,0,0,0,0,0,0
"673",2012-02-01,"sbsp","transporte regular","voo doméstico",6173,6223,12396,581901,573953,1155854,0,0,0,0
"674",2012-02-01,"sbsp","transporte regular","voo internacional",0,0,0,0,0,0,0,0,0,0
"675",2012-02-01,"sbsp","transporte não regular","voo doméstico",2011,1960,3971,8886,7644,16530,0,0,0,0
"676",2012-02-01,"sbsp","transporte não regular","voo internacional",75,66,141,0,0,0,0,0,0,0
"677",2012-02-01,"sbte","transporte regular","voo doméstico",476,482,958,39264,34797,74061,41834,128548,170382,196746
"678",2012-02-01,"sbte","transporte regular","voo internacional",0,0,0,0,0,0,0,0,0,0
"679",2012-02-01,"sbte","transporte não regular","voo doméstico",209,201,410,894,881,1775,0,6639,6639,34895
"680",2012-02-01,"sbte","transporte não regular","voo internacional",1,1,2,0,0,0,0,0,0,0
"681",2012-02-01,"sbtf","transporte regular","voo doméstico",71,71,142,974,1142,2116,0,0,0,0
"682",2012-02-01,"sbtf","transporte regular","voo internacional",0,0,0,0,0,0,0,0,0,0
"683",2012-02-01,"sbtf","transporte não regular","voo doméstico",439,438,877,2481,2425,4906,3247,4358,7605,16558
"684",2012-02-01,"sbtf","transporte não regular","voo internacional",0,0,0,0,0,0,0,0,0,0
"685",2012-02-01,"sbtt","transporte regular","voo doméstico",37,37,74,1153,1678,2831,0,0,0,0
"686",2012-02-01,"sbtt","transporte regular","voo internacional",0,0,0,0,0,0,0,0,0,0
"687",2012-02-01,"sbtt","transporte não regular","voo doméstico",40,41,81,212,209,421,4286,2803,7089,241
"688",2012-02-01,"sbtt","transporte não regular","voo internacional",1,1,2,2,2,4,0,0,0,0
"689",2012-02-01,"sbuf","transporte regular","voo doméstico",0,0,0,0,0,0,0,0,0,0
"690",2012-02-01,"sbuf","transporte regular","voo internacional",0,0,0,0,0,0,0,0,0,0
"691",2012-02-01,"sbuf","transporte não regular","voo doméstico",39,39,78,70,72,142,0,0,0,0
"692",2012-02-01,"sbuf","transporte não regular","voo internacional",0,0,0,0,0,0,0,0,0,0
"693",2012-02-01,"sbug","transporte regular","voo doméstico",17,17,34,106,122,228,0,0,0,0
"694",2012-02-01,"sbug","transporte regular","voo internacional",0,0,0,0,0,0,0,0,0,0
"695",2012-02-01,"sbug","transporte não regular","voo doméstico",6,6,12,27,23,50,0,0,0,0
"696",2012-02-01,"sbug","transporte não regular","voo internacional",3,4,7,0,2,2,0,0,0,0
"697",2012-02-01,"sbul","transporte regular","voo doméstico",574,574,1148,31514,32275,63789,0,0,0,0
"698",2012-02-01,"sbul","transporte regular","voo internacional",0,0,0,0,0,0,0,0,0,0
"699",2012-02-01,"sbul","transporte não regular","voo doméstico",425,427,852,1297,1234,2531,0,0,0,0
"700",2012-02-01,"sbul","transporte não regular","voo internacional",6,5,11,32,34,66,0,0,0,0
"701",2012-02-01,"sbur","transporte regular","voo doméstico",168,166,334,5373,5410,10783,0,0,0,0
"702",2012-02-01,"sbur","transporte regular","voo internacional",0,0,0,0,0,0,0,0,0,0
"703",2012-02-01,"sbur","transporte não regular","voo doméstico",176,180,356,964,769,1733,0,0,0,0
"704",2012-02-01,"sbur","transporte não regular","voo internacional",1,1,2,0,0,0,0,0,0,0
"705",2012-01-01,"sbbe","transporte regular","voo doméstico",1693,1700,3393,137130,135090,272220,107625,369676,477301,0
"706",2012-01-01,"sbbe","transporte regular","voo internacional",21,21,42,2244,1833,4077,0,143,143,0
"707",2012-01-01,"sbbe","transporte não regular","voo doméstico",527,529,1056,2259,2164,4423,0,0,0,0
"708",2012-01-01,"sbbe","transporte não regular","voo internacional",22,22,44,48,28,76,0,0,0,0
"709",2012-01-01,"sbbg","transporte regular","voo doméstico",0,0,0,0,0,0,0,0,0,0
"710",2012-01-01,"sbbg","transporte regular","voo internacional",0,0,0,0,0,0,0,0,0,0
"711",2012-01-01,"sbbg","transporte não regular","voo doméstico",14,15,29,58,54,112,0,0,0,0
"712",2012-01-01,"sbbg","transporte não regular","voo internacional",1,1,2,0,11,11,0,0,0,0
"713",2012-01-01,"sbbh","transporte regular","voo doméstico",726,739,1465,22596,26441,49037,0,0,0,0
"714",2012-01-01,"sbbh","transporte regular","voo internacional",0,0,0,0,0,0,0,0,0,0
"715",2012-01-01,"sbbh","transporte não regular","voo doméstico",1733,1700,3433,7605,7574,15179,0,0,0,0
"716",2012-01-01,"sbbh","transporte não regular","voo internacional",6,9,15,30,22,52,0,0,0,0
"717",2012-01-01,"sbbi","transporte regular","voo doméstico",0,0,0,0,0,0,0,0,0,0
"718",2012-01-01,"sbbi","transporte regular","voo internacional",0,0,0,0,0,0,0,0,0,0
"719",2012-01-01,"sbbi","transporte não regular","voo doméstico",1205,1181,2386,4284,4097,8381,0,0,0,0
"720",2012-01-01,"sbbi","transporte não regular","voo internacional",2,1,3,0,0,0,0,0,0,0
"721",2012-01-01,"sbbv","transporte regular","voo doméstico",123,124,247,15789,17834,33623,0,0,0,0
"722",2012-01-01,"sbbv","transporte regular","voo internacional",0,0,0,0,0,0,0,0,0,0
"723",2012-01-01,"sbbv","transporte não regular","voo doméstico",378,362,740,766,358,1124,0,0,0,0
"724",2012-01-01,"sbbv","transporte não regular","voo internacional",26,22,48,21,18,39,0,0,0,0
"725",2012-01-01,"sbcg","transporte regular","voo doméstico",850,849,1699,65915,69784,135699,52343,143900,196243,0
"726",2012-01-01,"sbcg","transporte regular","voo internacional",59,58,117,1612,1621,3233,0,0,0,0
"727",2012-01-01,"sbcg","transporte não regular","voo doméstico",226,226,452,93,85,178,0,0,0,0
"728",2012-01-01,"sbcg","transporte não regular","voo internacional",12,14,26,0,0,0,0,0,0,0
"729",2012-01-01,"sbcj","transporte regular","voo doméstico",199,199,398,4497,5640,10137,0,0,0,0
"730",2012-01-01,"sbcj","transporte regular","voo internacional",0,0,0,0,0,0,0,0,0,0
"731",2012-01-01,"sbcj","transporte não regular","voo doméstico",62,62,124,128,316,444,0,0,0,0
"732",2012-01-01,"sbcj","transporte não regular","voo internacional",0,0,0,0,0,0,0,0,0,0
"733",2012-01-01,"sbcr","transporte regular","voo doméstico",29,29,58,1003,1060,2063,0,0,0,0
"734",2012-01-01,"sbcr","transporte regular","voo internacional",0,0,0,0,0,0,0,0,0,0
"735",2012-01-01,"sbcr","transporte não regular","voo doméstico",46,45,91,172,164,336,0,0,0,0
"736",2012-01-01,"sbcr","transporte não regular","voo internacional",3,3,6,9,9,18,0,0,0,0
"737",2012-01-01,"sbct","transporte regular","voo doméstico",3209,3199,6408,250961,249851,500812,241820,98859,340679,307984
"738",2012-01-01,"sbct","transporte regular","voo internacional",132,133,265,5066,5083,10149,0,0,0,0
"739",2012-01-01,"sbct","transporte não regular","voo doméstico",324,328,652,7363,8200,15563,0,0,0,0
"740",2012-01-01,"sbct","transporte não regular","voo internacional",35,34,69,31,216,247,0,0,0,0
"741",2012-01-01,"sbcz","transporte regular","voo doméstico",57,57,114,2999,2429,5428,0,0,0,0
"742",2012-01-01,"sbcz","transporte regular","voo internacional",0,0,0,0,0,0,0,0,0,0
"743",2012-01-01,"sbcz","transporte não regular","voo doméstico",178,178,356,659,633,1292,4757,24010,28767,0
"744",2012-01-01,"sbcz","transporte não regular","voo internacional",1,1,2,0,0,0,0,0,0,0
"745",2012-01-01,"sbeg","transporte regular","voo doméstico",1500,1505,3005,129687,139198,268885,0,0,0,0
"746",2012-01-01,"sbeg","transporte regular","voo internacional",73,73,146,7494,8539,16033,0,0,0,0
"747",2012-01-01,"sbeg","transporte não regular","voo doméstico",748,726,1474,5467,5707,11174,0,0,0,0
"748",2012-01-01,"sbeg","transporte não regular","voo internacional",331,337,668,1691,1741,3432,0,0,0,0
"749",2012-01-01,"sbfi","transporte regular","voo doméstico",652,651,1303,73143,68975,142118,0,0,0,0
"750",2012-01-01,"sbfi","transporte regular","voo internacional",32,32,64,3276,3287,6563,0,0,0,0
"751",2012-01-01,"sbfi","transporte não regular","voo doméstico",95,95,190,254,439,693,0,0,0,0
"752",2012-01-01,"sbfi","transporte não regular","voo internacional",56,56,112,392,515,907,0,0,0,0
"753",2012-01-01,"sbgo","transporte regular","voo doméstico",1621,1616,3237,110207,119420,229627,93512,222729,316241,175999
"754",2012-01-01,"sbgo","transporte regular","voo internacional",0,0,0,0,0,0,0,0,0,0
"755",2012-01-01,"sbgo","transporte não regular","voo doméstico",1118,1099,2217,6259,6057,12316,0,0,0,0
"756",2012-01-01,"sbgo","transporte não regular","voo internacional",8,6,14,30,40,70,0,0,0,0
"757",2012-01-01,"sbht","transporte regular","voo doméstico",158,158,316,3784,4680,8464,0,0,0,0
"758",2012-01-01,"sbht","transporte regular","voo internacional",0,0,0,0,0,0,0,0,0,0
"759",2012-01-01,"sbht","transporte não regular","voo doméstico",135,135,270,360,326,686,8350,18909,27259,9220
"760",2012-01-01,"sbht","transporte não regular","voo internacional",1,1,2,0,0,0,0,0,0,0
"761",2012-01-01,"sbiz","transporte regular","voo doméstico",184,184,368,10712,10779,21491,0,0,0,0
"762",2012-01-01,"sbiz","transporte regular","voo internacional",0,0,0,0,0,0,0,0,0,0
"763",2012-01-01,"sbiz","transporte não regular","voo doméstico",160,158,318,370,397,767,0,0,0,0
"764",2012-01-01,"sbiz","transporte não regular","voo internacional",2,1,3,0,0,0,0,0,0,0
"765",2012-01-01,"sbjc","transporte regular","voo doméstico",0,0,0,0,0,0,0,0,0,0
"766",2012-01-01,"sbjc","transporte regular","voo internacional",0,0,0,0,0,0,0,0,0,0
"767",2012-01-01,"sbjc","transporte não regular","voo doméstico",661,650,1311,1149,1271,2420,0,0,0,0
"768",2012-01-01,"sbjc","transporte não regular","voo internacional",2,2,4,0,0,0,0,0,0,0
"769",2012-01-01,"sbjr","transporte regular","voo doméstico",0,0,0,0,0,0,0,0,0,0
"770",2012-01-01,"sbjr","transporte regular","voo internacional",0,0,0,0,0,0,0,0,0,0
"771",2012-01-01,"sbjr","transporte não regular","voo doméstico",3143,3135,6278,9106,5208,14314,0,0,0,0
"772",2012-01-01,"sbjr","transporte não regular","voo internacional",0,0,0,0,0,0,0,0,0,0
"773",2012-01-01,"sbjv","transporte regular","voo doméstico",319,320,639,20468,17514,37982,0,0,0,0
"774",2012-01-01,"sbjv","transporte regular","voo internacional",0,0,0,0,0,0,0,0,0,0
"775",2012-01-01,"sbjv","transporte não regular","voo doméstico",112,110,222,43,182,225,0,0,0,0
"776",2012-01-01,"sbjv","transporte não regular","voo internacional",4,4,8,2,4,6,0,0,0,0
"777",2012-01-01,"sblo","transporte regular","voo doméstico",553,554,1107,41487,39010,80497,0,0,0,0
"778",2012-01-01,"sblo","transporte regular","voo internacional",0,0,0,0,0,0,0,0,0,0
"779",2012-01-01,"sblo","transporte não regular","voo doméstico",602,593,1195,167,458,625,0,0,0,0
"780",2012-01-01,"sblo","transporte não regular","voo internacional",2,2,4,0,0,0,0,0,0,0
"781",2012-01-01,"sbma","transporte regular","voo doméstico",478,478,956,12531,14512,27043,0,0,0,0
"782",2012-01-01,"sbma","transporte regular","voo internacional",0,0,0,0,0,0,0,0,0,0
"783",2012-01-01,"sbma","transporte não regular","voo doméstico",174,171,345,328,310,638,0,0,0,0
"784",2012-01-01,"sbma","transporte não regular","voo internacional",5,4,9,0,0,0,0,0,0,0
"785",2012-01-01,"sbmk","transporte regular","voo doméstico",217,216,433,10933,9759,20692,0,0,0,0
"786",2012-01-01,"sbmk","transporte regular","voo internacional",0,0,0,0,0,0,0,0,0,0
"787",2012-01-01,"sbmk","transporte não regular","voo doméstico",196,196,392,446,411,857,0,0,0,0
"788",2012-01-01,"sbmk","transporte não regular","voo internacional",0,0,0,0,0,0,0,0,0,0
"789",2012-01-01,"sbmq","transporte regular","voo doméstico",215,215,430,23009,25110,48119,19020,30830,49850,0
"790",2012-01-01,"sbmq","transporte regular","voo internacional",0,0,0,0,0,0,0,0,0,0
"791",2012-01-01,"sbmq","transporte não regular","voo doméstico",279,279,558,585,469,1054,0,0,0,0
"792",2012-01-01,"sbmq","transporte não regular","voo internacional",13,16,29,0,0,0,0,0,0,0
"793",2012-01-01,"sbmt","transporte regular","voo doméstico",0,0,0,0,0,0,0,0,0,0
"794",2012-01-01,"sbmt","transporte regular","voo internacional",0,0,0,0,0,0,0,0,0,0
"795",2012-01-01,"sbmt","transporte não regular","voo doméstico",4889,4842,9731,14481,14577,29058,0,0,0,0
"796",2012-01-01,"sbmt","transporte não regular","voo internacional",7,6,13,0,0,0,0,0,0,0
"797",2012-01-01,"sbnf","transporte regular","voo doméstico",608,610,1218,57324,50200,107524,0,0,0,0
"798",2012-01-01,"sbnf","transporte regular","voo internacional",0,0,0,0,0,0,0,0,0,0
"799",2012-01-01,"sbnf","transporte não regular","voo doméstico",397,405,802,1233,1207,2440,0,0,0,0
"800",2012-01-01,"sbnf","transporte não regular","voo internacional",10,16,26,38,27,65,0,0,0,0
"801",2012-01-01,"sbpb","transporte regular","voo doméstico",0,0,0,0,0,0,0,0,0,0
"802",2012-01-01,"sbpb","transporte regular","voo internacional",0,0,0,0,0,0,0,0,0,0
"803",2012-01-01,"sbpb","transporte não regular","voo doméstico",41,47,88,100,69,169,0,0,0,0
"804",2012-01-01,"sbpb","transporte não regular","voo internacional",1,1,2,0,0,0,0,0,0,0
"805",2012-01-01,"sbpj","transporte regular","voo doméstico",393,392,785,21147,27319,48466,0,0,0,0
"806",2012-01-01,"sbpj","transporte regular","voo internacional",0,0,0,0,0,0,0,0,0,0
"807",2012-01-01,"sbpj","transporte não regular","voo doméstico",356,349,705,444,358,802,22040,29857,51897,0
"808",2012-01-01,"sbpj","transporte não regular","voo internacional",5,5,10,0,0,0,0,0,0,0
"809",2012-01-01,"sbpk","transporte regular","voo doméstico",58,58,116,157,152,309,0,0,0,0
"810",2012-01-01,"sbpk","transporte regular","voo internacional",0,0,0,0,0,0,0,0,0,0
"811",2012-01-01,"sbpk","transporte não regular","voo doméstico",77,77,154,189,193,382,0,0,0,0
"812",2012-01-01,"sbpk","transporte não regular","voo internacional",1,1,2,5,8,13,0,0,0,0
"813",2012-01-01,"sbpl","transporte regular","voo doméstico",233,230,463,20827,21043,41870,0,0,0,0
"814",2012-01-01,"sbpl","transporte regular","voo internacional",3,3,6,0,0,0,0,0,0,0
"815",2012-01-01,"sbpl","transporte não regular","voo doméstico",61,61,122,56,53,109,0,0,0,0
"816",2012-01-01,"sbpl","transporte não regular","voo internacional",0,0,0,0,0,0,0,0,0,0
"817",2012-01-01,"sbpp","transporte regular","voo doméstico",0,0,0,0,0,0,0,0,0,0
"818",2012-01-01,"sbpp","transporte regular","voo internacional",0,0,0,0,0,0,0,0,0,0
"819",2012-01-01,"sbpp","transporte não regular","voo doméstico",33,34,67,76,70,146,0,0,0,0
"820",2012-01-01,"sbpp","transporte não regular","voo internacional",7,5,12,2,9,11,0,0,0,0
"821",2012-01-01,"sbpr","transporte regular","voo doméstico",0,0,0,0,0,0,0,0,0,0
"822",2012-01-01,"sbpr","transporte regular","voo internacional",0,0,0,0,0,0,0,0,0,0
"823",2012-01-01,"sbpr","transporte não regular","voo doméstico",1488,1482,2970,1583,1560,3143,0,0,0,0
"824",2012-01-01,"sbpr","transporte não regular","voo internacional",0,0,0,0,0,0,0,0,0,0
"825",2012-01-01,"sbpv","transporte regular","voo doméstico",634,633,1267,47736,52306,100042,49320,220113,269433,0
"826",2012-01-01,"sbpv","transporte regular","voo internacional",0,0,0,0,0,0,0,0,0,0
"827",2012-01-01,"sbpv","transporte não regular","voo doméstico",236,234,470,442,422,864,0,0,0,0
"828",2012-01-01,"sbpv","transporte não regular","voo internacional",0,0,0,0,0,0,0,0,0,0
"829",2012-01-01,"sbrb","transporte regular","voo doméstico",248,248,496,17898,16490,34388,0,0,0,0
"830",2012-01-01,"sbrb","transporte regular","voo internacional",0,0,0,0,0,0,0,0,0,0
"831",2012-01-01,"sbrb","transporte não regular","voo doméstico",375,379,754,716,591,1307,0,0,0,0
"832",2012-01-01,"sbrb","transporte não regular","voo internacional",2,2,4,0,0,0,0,0,0,0
"833",2012-01-01,"sbrj","transporte regular","voo doméstico",4286,4345,8631,369387,321352,690739,0,0,0,0
"834",2012-01-01,"sbrj","transporte regular","voo internacional",0,0,0,0,0,0,0,0,0,0
"835",2012-01-01,"sbrj","transporte não regular","voo doméstico",1210,1162,2372,1466,2010,3476,0,0,0,0
"836",2012-01-01,"sbrj","transporte não regular","voo internacional",22,22,44,0,0,0,0,0,0,0
"837",2012-01-01,"sbsj","transporte regular","voo doméstico",121,122,243,6181,6386,12567,0,0,0,0
"838",2012-01-01,"sbsj","transporte regular","voo internacional",0,0,0,0,0,0,0,0,0,0
"839",2012-01-01,"sbsj","transporte não regular","voo doméstico",437,418,855,1175,1089,2264,0,0,0,0
"840",2012-01-01,"sbsj","transporte não regular","voo internacional",10,14,24,39,28,67,0,0,0,0
"841",2012-01-01,"sbsl","transporte regular","voo doméstico",904,904,1808,95282,90409,185691,0,0,0,0
"842",2012-01-01,"sbsl","transporte regular","voo internacional",0,0,0,0,0,0,0,0,0,0
"843",2012-01-01,"sbsl","transporte não regular","voo doméstico",478,476,954,2206,1210,3416,72061,194461,266522,9887
"844",2012-01-01,"sbsl","transporte não regular","voo internacional",4,4,8,0,0,0,0,0,0,0
"845",2012-01-01,"sbsn","transporte regular","voo doméstico",410,411,821,22789,19774,42563,0,0,0,0
"846",2012-01-01,"sbsn","transporte regular","voo internacional",0,0,0,0,0,0,0,0,0,0
"847",2012-01-01,"sbsn","transporte não regular","voo doméstico",347,343,690,584,466,1050,0,0,0,0
"848",2012-01-01,"sbsn","transporte não regular","voo internacional",1,2,3,0,0,0,0,0,0,0
"849",2012-01-01,"sbsp","transporte regular","voo doméstico",6572,6678,13250,629012,669821,1298833,0,0,0,0
"850",2012-01-01,"sbsp","transporte regular","voo internacional",0,0,0,0,0,0,0,0,0,0
"851",2012-01-01,"sbsp","transporte não regular","voo doméstico",1869,1714,3583,10343,10350,20693,0,0,0,0
"852",2012-01-01,"sbsp","transporte não regular","voo internacional",57,56,113,0,0,0,0,0,0,0
"853",2012-01-01,"sbte","transporte regular","voo doméstico",571,576,1147,53786,47637,101423,52487,145930,198417,219592
"854",2012-01-01,"sbte","transporte regular","voo internacional",0,0,0,35,0,35,0,0,0,0
"855",2012-01-01,"sbte","transporte não regular","voo doméstico",226,222,448,626,446,1072,0,21531,21531,35224
"856",2012-01-01,"sbte","transporte não regular","voo internacional",0,0,0,0,0,0,0,0,0,0
"857",2012-01-01,"sbtf","transporte regular","voo doméstico",74,74,148,1257,1412,2669,0,0,0,0
"858",2012-01-01,"sbtf","transporte regular","voo internacional",0,0,0,0,0,0,0,0,0,0
"859",2012-01-01,"sbtf","transporte não regular","voo doméstico",457,458,915,2846,2780,5626,3018,5498,8516,15931
"860",2012-01-01,"sbtf","transporte não regular","voo internacional",0,0,0,0,0,0,0,0,0,0
"861",2012-01-01,"sbtt","transporte regular","voo doméstico",40,40,80,1465,1718,3183,0,0,0,0
"862",2012-01-01,"sbtt","transporte regular","voo internacional",0,0,0,0,0,0,0,0,0,0
"863",2012-01-01,"sbtt","transporte não regular","voo doméstico",44,43,87,249,241,490,2191,2759,4950,210
"864",2012-01-01,"sbtt","transporte não regular","voo internacional",0,0,0,0,0,0,0,0,0,0
"865",2012-01-01,"sbuf","transporte regular","voo doméstico",0,0,0,0,0,0,0,0,0,0
"866",2012-01-01,"sbuf","transporte regular","voo internacional",0,0,0,0,0,0,0,0,0,0
"867",2012-01-01,"sbuf","transporte não regular","voo doméstico",42,42,84,111,107,218,0,0,0,0
"868",2012-01-01,"sbuf","transporte não regular","voo internacional",0,0,0,0,0,0,0,0,0,0
"869",2012-01-01,"sbug","transporte regular","voo doméstico",13,13,26,49,66,115,0,0,0,0
"870",2012-01-01,"sbug","transporte regular","voo internacional",0,0,0,0,0,0,0,0,0,0
"871",2012-01-01,"sbug","transporte não regular","voo doméstico",6,5,11,13,14,27,0,0,0,0
"872",2012-01-01,"sbug","transporte não regular","voo internacional",2,2,4,0,0,0,0,0,0,0
"873",2012-01-01,"sbul","transporte regular","voo doméstico",638,640,1278,35930,35112,71042,0,0,0,0
"874",2012-01-01,"sbul","transporte regular","voo internacional",0,0,0,0,0,0,0,0,0,0
"875",2012-01-01,"sbul","transporte não regular","voo doméstico",364,368,732,1779,1284,3063,0,0,0,0
"876",2012-01-01,"sbul","transporte não regular","voo internacional",2,2,4,14,14,28,0,0,0,0
"877",2012-01-01,"sbur","transporte regular","voo doméstico",153,154,307,5105,5467,10572,0,0,0,0
"878",2012-01-01,"sbur","transporte regular","voo internacional",0,0,0,0,0,0,0,0,0,0
"879",2012-01-01,"sbur","transporte não regular","voo doméstico",118,118,236,516,568,1084,0,0,0,0
"880",2012-01-01,"sbur","transporte não regular","voo internacional",0,0,0,0,0,0,0,0,0,0
"881",2012-07-01,"sbbe","transporte regular","voo doméstico",1784,1785,3569,168379,165321,333700,106185,327638,433823,0
"882",2012-07-01,"sbbe","transporte regular","voo internacional",26,26,52,1947,3101,5048,0,23,23,0
"883",2012-07-01,"sbbe","transporte não regular","voo doméstico",660,666,1326,3209,2774,5983,0,0,0,0
"884",2012-07-01,"sbbe","transporte não regular","voo internacional",16,18,34,56,32,88,0,0,0,0
"885",2012-07-01,"sbbg","transporte regular","voo doméstico",0,0,0,0,0,0,0,0,0,0
"886",2012-07-01,"sbbg","transporte regular","voo internacional",0,0,0,0,0,0,0,0,0,0
"887",2012-07-01,"sbbg","transporte não regular","voo doméstico",6,6,12,29,19,48,0,0,0,0
"888",2012-07-01,"sbbg","transporte não regular","voo internacional",1,1,2,4,2,6,0,0,0,0
"889",2012-07-01,"sbbh","transporte regular","voo doméstico",657,665,1322,21306,22228,43534,0,0,0,0
"890",2012-07-01,"sbbh","transporte regular","voo internacional",0,0,0,0,0,0,0,0,0,0
"891",2012-07-01,"sbbh","transporte não regular","voo doméstico",2988,2989,5977,11859,11836,23695,0,0,0,0
"892",2012-07-01,"sbbh","transporte não regular","voo internacional",3,3,6,11,11,22,0,0,0,0
"893",2012-07-01,"sbbi","transporte regular","voo doméstico",0,0,0,0,0,0,0,0,0,0
"894",2012-07-01,"sbbi","transporte regular","voo internacional",0,0,0,0,0,0,0,0,0,0
"895",2012-07-01,"sbbi","transporte não regular","voo doméstico",1174,1172,2346,2706,2279,4985,0,0,0,0
"896",2012-07-01,"sbbi","transporte não regular","voo internacional",8,5,13,0,0,0,0,0,0,0
"897",2012-07-01,"sbbv","transporte regular","voo doméstico",93,94,187,14273,14251,28524,0,0,0,0
"898",2012-07-01,"sbbv","transporte regular","voo internacional",0,0,0,0,0,0,0,0,0,0
"899",2012-07-01,"sbbv","transporte não regular","voo doméstico",431,424,855,777,219,996,0,0,0,0
"900",2012-07-01,"sbbv","transporte não regular","voo internacional",34,38,72,26,7,33,0,0,0,0
"901",2012-07-01,"sbcg","transporte regular","voo doméstico",934,932,1866,78721,78833,157554,73390,146422,219812,0
"902",2012-07-01,"sbcg","transporte regular","voo internacional",61,61,122,647,817,1464,0,0,0,0
"903",2012-07-01,"sbcg","transporte não regular","voo doméstico",543,547,1090,606,432,1038,0,0,0,0
"904",2012-07-01,"sbcg","transporte não regular","voo internacional",12,12,24,0,2,2,0,0,0,0
"905",2012-07-01,"sbcj","transporte regular","voo doméstico",203,203,406,5925,6261,12186,0,0,0,0
"906",2012-07-01,"sbcj","transporte regular","voo internacional",0,0,0,0,0,0,0,0,0,0
"907",2012-07-01,"sbcj","transporte não regular","voo doméstico",103,100,203,1501,1323,2824,0,0,0,0
"908",2012-07-01,"sbcj","transporte não regular","voo internacional",1,1,2,0,0,0,0,0,0,0
"909",2012-07-01,"sbcr","transporte regular","voo doméstico",31,31,62,1617,1563,3180,0,0,0,0
"910",2012-07-01,"sbcr","transporte regular","voo internacional",0,0,0,0,0,0,0,0,0,0
"911",2012-07-01,"sbcr","transporte não regular","voo doméstico",67,69,136,282,252,534,0,0,0,0
"912",2012-07-01,"sbcr","transporte não regular","voo internacional",3,3,6,10,7,17,0,0,0,0
"913",2012-07-01,"sbct","transporte regular","voo doméstico",3479,3507,6986,331785,311055,642840,177373,104704,282077,267923
"914",2012-07-01,"sbct","transporte regular","voo internacional",73,70,143,3646,2991,6637,0,0,0,0
"915",2012-07-01,"sbct","transporte não regular","voo doméstico",399,367,766,3554,4553,8107,0,0,0,0
"916",2012-07-01,"sbct","transporte não regular","voo internacional",27,27,54,382,421,803,0,0,0,0
"917",2012-07-01,"sbcz","transporte regular","voo doméstico",31,31,62,2277,2247,4524,0,0,0,0
"918",2012-07-01,"sbcz","transporte regular","voo internacional",0,0,0,0,0,0,0,0,0,0
"919",2012-07-01,"sbcz","transporte não regular","voo doméstico",370,372,742,1035,1044,2079,4022,25000,29022,0
"920",2012-07-01,"sbcz","transporte não regular","voo internacional",1,1,2,0,0,0,0,0,0,0
"921",2012-07-01,"sbeg","transporte regular","voo doméstico",1361,1355,2716,125248,123461,248709,0,0,0,0
"922",2012-07-01,"sbeg","transporte regular","voo internacional",122,115,237,8160,8711,16871,0,0,0,0
"923",2012-07-01,"sbeg","transporte não regular","voo doméstico",762,749,1511,5603,6136,11739,0,0,0,0
"924",2012-07-01,"sbeg","transporte não regular","voo internacional",204,216,420,33,6,39,0,0,0,0
"925",2012-07-01,"sbfi","transporte regular","voo doméstico",663,662,1325,72873,73796,146669,0,0,0,0
"926",2012-07-01,"sbfi","transporte regular","voo internacional",19,19,38,2264,2174,4438,0,0,0,0
"927",2012-07-01,"sbfi","transporte não regular","voo doméstico",169,164,333,1752,2685,4437,0,0,0,0
"928",2012-07-01,"sbfi","transporte não regular","voo internacional",48,51,99,478,424,902,0,0,0,0
"929",2012-07-01,"sbgo","transporte regular","voo doméstico",1572,1568,3140,139870,139909,279779,110793,216729,327522,163548
"930",2012-07-01,"sbgo","transporte regular","voo internacional",0,0,0,0,0,0,0,0,0,0
"931",2012-07-01,"sbgo","transporte não regular","voo doméstico",1515,1491,3006,8340,8279,16619,0,0,0,0
"932",2012-07-01,"sbgo","transporte não regular","voo internacional",14,12,26,60,70,130,0,0,0,0
"933",2012-07-01,"sbht","transporte regular","voo doméstico",285,284,569,7159,7429,14588,0,0,0,0
"934",2012-07-01,"sbht","transporte regular","voo internacional",0,0,0,0,0,0,0,0,0,0
"935",2012-07-01,"sbht","transporte não regular","voo doméstico",213,211,424,169,177,346,9940,21830,31770,7489
"936",2012-07-01,"sbht","transporte não regular","voo internacional",0,0,0,0,0,0,0,0,0,0
"937",2012-07-01,"sbiz","transporte regular","voo doméstico",186,187,373,13922,16879,30801,0,0,0,0
"938",2012-07-01,"sbiz","transporte regular","voo internacional",0,0,0,0,0,0,0,0,0,0
"939",2012-07-01,"sbiz","transporte não regular","voo doméstico",158,162,320,403,451,854,0,0,0,0
"940",2012-07-01,"sbiz","transporte não regular","voo internacional",0,0,0,0,0,0,0,0,0,0
"941",2012-07-01,"sbjc","transporte regular","voo doméstico",0,0,0,0,0,0,0,0,0,0
"942",2012-07-01,"sbjc","transporte regular","voo internacional",0,0,0,0,0,0,0,0,0,0
"943",2012-07-01,"sbjc","transporte não regular","voo doméstico",867,864,1731,1515,1347,2862,0,0,0,0
"944",2012-07-01,"sbjc","transporte não regular","voo internacional",1,0,1,0,0,0,0,0,0,0
"945",2012-07-01,"sbjr","transporte regular","voo doméstico",0,0,0,0,0,0,0,0,0,0
"946",2012-07-01,"sbjr","transporte regular","voo internacional",0,0,0,0,0,0,0,0,0,0
"947",2012-07-01,"sbjr","transporte não regular","voo doméstico",3199,3198,6397,8176,4571,12747,0,0,0,0
"948",2012-07-01,"sbjr","transporte não regular","voo internacional",0,0,0,0,0,0,0,0,0,0
"949",2012-07-01,"sbjv","transporte regular","voo doméstico",275,276,551,17859,17323,35182,0,0,0,0
"950",2012-07-01,"sbjv","transporte regular","voo internacional",0,0,0,0,0,0,0,0,0,0
"951",2012-07-01,"sbjv","transporte não regular","voo doméstico",105,105,210,299,379,678,0,0,0,0
"952",2012-07-01,"sbjv","transporte não regular","voo internacional",0,0,0,0,0,0,0,0,0,0
"953",2012-07-01,"sblo","transporte regular","voo doméstico",641,645,1286,51843,51722,103565,0,0,0,0
"954",2012-07-01,"sblo","transporte regular","voo internacional",0,0,0,0,0,0,0,0,0,0
"955",2012-07-01,"sblo","transporte não regular","voo doméstico",881,885,1766,982,1757,2739,0,0,0,0
"956",2012-07-01,"sblo","transporte não regular","voo internacional",6,6,12,0,0,0,0,0,0,0
"957",2012-07-01,"sbma","transporte regular","voo doméstico",454,454,908,19182,22349,41531,9,0,9,0
"958",2012-07-01,"sbma","transporte regular","voo internacional",0,0,0,0,0,0,0,0,0,0
"959",2012-07-01,"sbma","transporte não regular","voo doméstico",291,295,586,476,327,803,0,0,0,0
"960",2012-07-01,"sbma","transporte não regular","voo internacional",4,4,8,0,0,0,0,0,0,0
"961",2012-07-01,"sbmk","transporte regular","voo doméstico",325,323,648,16466,15950,32416,0,0,0,0
"962",2012-07-01,"sbmk","transporte regular","voo internacional",0,0,0,0,0,0,0,0,0,0
"963",2012-07-01,"sbmk","transporte não regular","voo doméstico",193,198,391,92,63,155,0,0,0,0
"964",2012-07-01,"sbmk","transporte não regular","voo internacional",0,0,0,0,0,0,0,0,0,0
"965",2012-07-01,"sbmq","transporte regular","voo doméstico",231,229,460,27422,26084,53506,30540,35800,66340,0
"966",2012-07-01,"sbmq","transporte regular","voo internacional",0,0,0,0,0,0,0,0,0,0
"967",2012-07-01,"sbmq","transporte não regular","voo doméstico",333,334,667,1573,1352,2925,0,0,0,0
"968",2012-07-01,"sbmq","transporte não regular","voo internacional",9,6,15,0,0,0,0,0,0,0
"969",2012-07-01,"sbmt","transporte regular","voo doméstico",0,0,0,0,0,0,0,0,0,0
"970",2012-07-01,"sbmt","transporte regular","voo internacional",0,0,0,0,0,0,0,0,0,0
"971",2012-07-01,"sbmt","transporte não regular","voo doméstico",5887,5847,11734,17463,17532,34995,0,0,0,0
"972",2012-07-01,"sbmt","transporte não regular","voo internacional",10,4,14,0,0,0,0,0,0,0
"973",2012-07-01,"sbnf","transporte regular","voo doméstico",725,729,1454,60522,57467,117989,0,0,0,0
"974",2012-07-01,"sbnf","transporte regular","voo internacional",0,0,0,0,0,0,0,0,0,0
"975",2012-07-01,"sbnf","transporte não regular","voo doméstico",365,364,729,1493,2171,3664,0,0,0,0
"976",2012-07-01,"sbnf","transporte não regular","voo internacional",8,10,18,5,0,5,0,0,0,0
"977",2012-07-01,"sbpb","transporte regular","voo doméstico",0,0,0,0,0,0,0,0,0,0
"978",2012-07-01,"sbpb","transporte regular","voo internacional",0,0,0,0,0,0,0,0,0,0
"979",2012-07-01,"sbpb","transporte não regular","voo doméstico",83,85,168,194,171,365,0,0,0,0
"980",2012-07-01,"sbpb","transporte não regular","voo internacional",0,0,0,0,0,0,0,0,0,0
"981",2012-07-01,"sbpj","transporte regular","voo doméstico",308,310,618,26710,26294,53004,0,0,0,0
"982",2012-07-01,"sbpj","transporte regular","voo internacional",0,0,0,0,0,0,0,0,0,0
"983",2012-07-01,"sbpj","transporte não regular","voo doméstico",466,464,930,684,559,1243,22020,33161,55181,0
"984",2012-07-01,"sbpj","transporte não regular","voo internacional",2,1,3,0,0,0,0,0,0,0
"985",2012-07-01,"sbpk","transporte regular","voo doméstico",90,90,180,207,256,463,0,0,0,0
"986",2012-07-01,"sbpk","transporte regular","voo internacional",0,0,0,0,0,0,0,0,0,0
"987",2012-07-01,"sbpk","transporte não regular","voo doméstico",98,98,196,208,221,429,0,0,0,0
"988",2012-07-01,"sbpk","transporte não regular","voo internacional",4,3,7,0,8,8,0,0,0,0
"989",2012-07-01,"sbpl","transporte regular","voo doméstico",178,177,355,20906,20042,40948,0,0,0,0
"990",2012-07-01,"sbpl","transporte regular","voo internacional",4,4,8,0,0,0,0,0,0,0
"991",2012-07-01,"sbpl","transporte não regular","voo doméstico",72,77,149,98,60,158,0,0,0,0
"992",2012-07-01,"sbpl","transporte não regular","voo internacional",0,0,0,0,0,0,0,0,0,0
"993",2012-07-01,"sbpp","transporte regular","voo doméstico",0,0,0,0,0,0,0,0,0,0
"994",2012-07-01,"sbpp","transporte regular","voo internacional",0,0,0,0,0,0,0,0,0,0
"995",2012-07-01,"sbpp","transporte não regular","voo doméstico",72,74,146,169,173,342,0,0,0,0
"996",2012-07-01,"sbpp","transporte não regular","voo internacional",9,8,17,13,15,28,0,0,0,0
"997",2012-07-01,"sbpr","transporte regular","voo doméstico",0,0,0,0,0,0,0,0,0,0
"998",2012-07-01,"sbpr","transporte regular","voo internacional",0,0,0,0,0,0,0,0,0,0
"999",2012-07-01,"sbpr","transporte não regular","voo doméstico",1882,1889,3771,1800,1900,3700,0,0,0,0
"1000",2012-07-01,"sbpr","transporte não regular","voo internacional",0,0,0,0,0,0,0,0,0,0
"1001",2012-07-01,"sbpv","transporte regular","voo doméstico",617,617,1234,50698,53840,104538,60225,223509,283734,0
"1002",2012-07-01,"sbpv","transporte regular","voo internacional",0,0,0,0,0,0,0,0,0,0
"1003",2012-07-01,"sbpv","transporte não regular","voo doméstico",274,270,544,0,0,0,0,0,0,0
"1004",2012-07-01,"sbpv","transporte não regular","voo internacional",7,7,14,0,0,0,0,0,0,0
"1005",2012-07-01,"sbrb","transporte regular","voo doméstico",200,201,401,17058,18296,35354,0,0,0,0
"1006",2012-07-01,"sbrb","transporte regular","voo internacional",0,0,0,0,0,0,0,0,0,0
"1007",2012-07-01,"sbrb","transporte não regular","voo doméstico",369,369,738,990,688,1678,0,0,0,0
"1008",2012-07-01,"sbrb","transporte não regular","voo internacional",0,0,0,0,0,0,0,0,0,0
"1009",2012-07-01,"sbrj","transporte regular","voo doméstico",4480,4507,8987,421942,404736,826678,0,0,0,0
"1010",2012-07-01,"sbrj","transporte regular","voo internacional",0,0,0,0,0,0,0,0,0,0
"1011",2012-07-01,"sbrj","transporte não regular","voo doméstico",1263,1234,2497,1036,1595,2631,0,0,0,0
"1012",2012-07-01,"sbrj","transporte não regular","voo internacional",4,4,8,0,0,0,0,0,0,0
"1013",2012-07-01,"sbsj","transporte regular","voo doméstico",158,156,314,8490,8691,17181,0,0,0,0
"1014",2012-07-01,"sbsj","transporte regular","voo internacional",0,0,0,0,0,0,0,0,0,0
"1015",2012-07-01,"sbsj","transporte não regular","voo doméstico",620,601,1221,1276,1155,2431,0,0,0,0
"1016",2012-07-01,"sbsj","transporte não regular","voo internacional",5,17,22,44,5,49,0,0,0,0
"1017",2012-07-01,"sbsl","transporte regular","voo doméstico",796,795,1591,101057,102571,203628,0,0,0,2883
"1018",2012-07-01,"sbsl","transporte regular","voo internacional",0,0,0,0,0,0,0,0,0,0
"1019",2012-07-01,"sbsl","transporte não regular","voo doméstico",486,488,974,967,806,1773,67630,170633,238263,0
"1020",2012-07-01,"sbsl","transporte não regular","voo internacional",0,0,0,0,0,0,0,0,0,0
"1021",2012-07-01,"sbsn","transporte regular","voo doméstico",349,349,698,23923,22874,46797,0,0,0,0
"1022",2012-07-01,"sbsn","transporte regular","voo internacional",0,0,0,0,0,0,0,0,0,0
"1023",2012-07-01,"sbsn","transporte não regular","voo doméstico",449,446,895,873,747,1620,0,0,0,0
"1024",2012-07-01,"sbsn","transporte não regular","voo internacional",3,1,4,0,0,0,0,0,0,0
"1025",2012-07-01,"sbsp","transporte regular","voo doméstico",6809,6911,13720,759456,752723,1512179,0,0,0,0
"1026",2012-07-01,"sbsp","transporte regular","voo internacional",0,0,0,0,0,0,0,0,0,0
"1027",2012-07-01,"sbsp","transporte não regular","voo doméstico",2181,2052,4233,16262,17843,34105,0,0,0,0
"1028",2012-07-01,"sbsp","transporte não regular","voo internacional",7,14,21,0,0,0,0,0,0,0
"1029",2012-07-01,"sbte","transporte regular","voo doméstico",507,505,1012,48881,50225,99106,24915,90756,115671,263755
"1030",2012-07-01,"sbte","transporte regular","voo internacional",0,0,0,0,0,0,0,0,0,0
"1031",2012-07-01,"sbte","transporte não regular","voo doméstico",248,251,499,867,965,1832,0,0,0,0
"1032",2012-07-01,"sbte","transporte não regular","voo internacional",0,0,0,0,0,0,0,0,0,0
"1033",2012-07-01,"sbtf","transporte regular","voo doméstico",73,73,146,1767,1839,3606,0,0,0,0
"1034",2012-07-01,"sbtf","transporte regular","voo internacional",1,1,2,0,0,0,0,0,0,0
"1035",2012-07-01,"sbtf","transporte não regular","voo doméstico",372,371,743,2305,2118,4423,2189,3733,5922,16298
"1036",2012-07-01,"sbtf","transporte não regular","voo internacional",0,0,0,0,0,0,0,0,0,0
"1037",2012-07-01,"sbtt","transporte regular","voo doméstico",61,61,122,1895,2369,4264,0,0,0,0
"1038",2012-07-01,"sbtt","transporte regular","voo internacional",0,0,0,0,0,0,0,0,0,0
"1039",2012-07-01,"sbtt","transporte não regular","voo doméstico",51,51,102,212,215,427,1772,3980,5752,592
"1040",2012-07-01,"sbtt","transporte não regular","voo internacional",0,0,0,0,0,0,0,0,0,0
"1041",2012-07-01,"sbuf","transporte regular","voo doméstico",0,0,0,0,0,0,0,0,0,0
"1042",2012-07-01,"sbuf","transporte regular","voo internacional",0,0,0,0,0,0,0,0,0,0
"1043",2012-07-01,"sbuf","transporte não regular","voo doméstico",30,32,62,89,89,178,0,0,0,0
"1044",2012-07-01,"sbuf","transporte não regular","voo internacional",0,0,0,0,0,0,0,0,0,0
"1045",2012-07-01,"sbug","transporte regular","voo doméstico",21,21,42,105,126,231,0,0,0,0
"1046",2012-07-01,"sbug","transporte regular","voo internacional",0,0,0,0,0,0,0,0,0,0
"1047",2012-07-01,"sbug","transporte não regular","voo doméstico",10,9,19,12,13,25,0,0,0,0
"1048",2012-07-01,"sbug","transporte não regular","voo internacional",1,1,2,0,0,0,0,0,0,0
"1049",2012-07-01,"sbul","transporte regular","voo doméstico",678,682,1360,48201,46520,94721,0,0,0,0
"1050",2012-07-01,"sbul","transporte regular","voo internacional",0,0,0,0,0,0,0,0,0,0
"1051",2012-07-01,"sbul","transporte não regular","voo doméstico",656,652,1308,2164,2101,4265,0,0,0,0
"1052",2012-07-01,"sbul","transporte não regular","voo internacional",1,1,2,4,2,6,0,0,0,0
"1053",2012-07-01,"sbur","transporte regular","voo doméstico",226,226,452,7978,7779,15757,14,0,14,0
"1054",2012-07-01,"sbur","transporte regular","voo internacional",0,0,0,0,0,0,0,0,0,0
"1055",2012-07-01,"sbur","transporte não regular","voo doméstico",228,231,459,989,961,1950,0,0,0,0
"1056",2012-07-01,"sbur","transporte não regular","voo internacional",2,2,4,0,0,0,0,0,0,0
"1057",2012-06-01,"sbbe","transporte regular","voo doméstico",1676,1671,3347,136156,133193,269349,102903,345906,448809,17476
"1058",2012-06-01,"sbbe","transporte regular","voo internacional",25,25,50,1677,1857,3534,0,62,62,0
"1059",2012-06-01,"sbbe","transporte não regular","voo doméstico",591,580,1171,2149,2229,4378,0,0,0,0
"1060",2012-06-01,"sbbe","transporte não regular","voo internacional",23,26,49,64,8,72,0,0,0,0
"1061",2012-06-01,"sbbg","transporte regular","voo doméstico",0,0,0,0,0,0,0,0,0,0
"1062",2012-06-01,"sbbg","transporte regular","voo internacional",0,0,0,0,0,0,0,0,0,0
"1063",2012-06-01,"sbbg","transporte não regular","voo doméstico",12,13,25,69,56,125,0,0,0,0
"1064",2012-06-01,"sbbg","transporte não regular","voo internacional",2,1,3,0,4,4,0,0,0,0
"1065",2012-06-01,"sbbh","transporte regular","voo doméstico",683,674,1357,22070,23408,45478,0,0,0,0
"1066",2012-06-01,"sbbh","transporte regular","voo internacional",0,0,0,0,0,0,0,0,0,0
"1067",2012-06-01,"sbbh","transporte não regular","voo doméstico",2909,2909,5818,11501,11674,23175,0,0,0,0
"1068",2012-06-01,"sbbh","transporte não regular","voo internacional",12,10,22,64,67,131,0,0,0,0
"1069",2012-06-01,"sbbi","transporte regular","voo doméstico",0,0,0,0,0,0,0,0,0,0
"1070",2012-06-01,"sbbi","transporte regular","voo internacional",0,0,0,0,0,0,0,0,0,0
"1071",2012-06-01,"sbbi","transporte não regular","voo doméstico",895,878,1773,3299,2673,5972,0,0,0,0
"1072",2012-06-01,"sbbi","transporte não regular","voo internacional",2,1,3,0,0,0,0,0,0,0
"1073",2012-06-01,"sbbv","transporte regular","voo doméstico",90,90,180,12473,11992,24465,0,0,0,0
"1074",2012-06-01,"sbbv","transporte regular","voo internacional",0,0,0,0,0,0,0,0,0,0
"1075",2012-06-01,"sbbv","transporte não regular","voo doméstico",410,409,819,866,393,1259,0,0,0,0
"1076",2012-06-01,"sbbv","transporte não regular","voo internacional",43,39,82,13,23,36,0,0,0,0
"1077",2012-06-01,"sbcg","transporte regular","voo doméstico",837,841,1678,64071,63095,127166,40997,108960,149957,0
"1078",2012-06-01,"sbcg","transporte regular","voo internacional",49,49,98,443,1857,2300,0,0,0,0
"1079",2012-06-01,"sbcg","transporte não regular","voo doméstico",419,425,844,607,831,1438,0,0,0,0
"1080",2012-06-01,"sbcg","transporte não regular","voo internacional",9,11,20,0,0,0,0,0,0,0
"1081",2012-06-01,"sbcj","transporte regular","voo doméstico",185,185,370,5486,6932,12418,0,0,0,0
"1082",2012-06-01,"sbcj","transporte regular","voo internacional",0,0,0,0,0,0,0,0,0,0
"1083",2012-06-01,"sbcj","transporte não regular","voo doméstico",94,96,190,990,950,1940,0,0,0,0
"1084",2012-06-01,"sbcj","transporte não regular","voo internacional",0,0,0,0,0,0,0,0,0,0
"1085",2012-06-01,"sbcr","transporte regular","voo doméstico",27,27,54,1258,1326,2584,0,0,0,0
"1086",2012-06-01,"sbcr","transporte regular","voo internacional",0,0,0,0,0,0,0,0,0,0
"1087",2012-06-01,"sbcr","transporte não regular","voo doméstico",54,53,107,241,205,446,0,0,0,0
"1088",2012-06-01,"sbcr","transporte não regular","voo internacional",4,4,8,6,8,14,0,0,0,0
"1089",2012-06-01,"sbct","transporte regular","voo doméstico",3086,3129,6215,275204,260787,535991,121392,126306,247698,227485
"1090",2012-06-01,"sbct","transporte regular","voo internacional",93,91,184,5088,5092,10180,0,0,0,0
"1091",2012-06-01,"sbct","transporte não regular","voo doméstico",330,298,628,4495,5096,9591,0,0,0,0
"1092",2012-06-01,"sbct","transporte não regular","voo internacional",27,29,56,276,164,440,0,0,0,0
"1093",2012-06-01,"sbcz","transporte regular","voo doméstico",30,30,60,2021,2171,4192,0,0,0,0
"1094",2012-06-01,"sbcz","transporte regular","voo internacional",0,0,0,0,0,0,0,0,0,0
"1095",2012-06-01,"sbcz","transporte não regular","voo doméstico",271,275,546,887,828,1715,2210,17840,20050,70
"1096",2012-06-01,"sbcz","transporte não regular","voo internacional",4,4,8,0,0,0,0,0,0,0
"1097",2012-06-01,"sbeg","transporte regular","voo doméstico",1267,1259,2526,120468,110443,230911,0,0,0,0
"1098",2012-06-01,"sbeg","transporte regular","voo internacional",97,94,191,6714,6428,13142,0,0,0,0
"1099",2012-06-01,"sbeg","transporte não regular","voo doméstico",817,822,1639,7918,6206,14124,0,0,0,0
"1100",2012-06-01,"sbeg","transporte não regular","voo internacional",194,195,389,0,0,0,0,0,0,0
"1101",2012-06-01,"sbfi","transporte regular","voo doméstico",638,637,1275,65276,65279,130555,0,0,0,0
"1102",2012-06-01,"sbfi","transporte regular","voo internacional",28,28,56,2901,2686,5587,0,0,0,0
"1103",2012-06-01,"sbfi","transporte não regular","voo doméstico",100,102,202,154,1167,1321,0,0,0,0
"1104",2012-06-01,"sbfi","transporte não regular","voo internacional",33,33,66,463,476,939,0,0,0,0
"1105",2012-06-01,"sbgo","transporte regular","voo doméstico",1478,1481,2959,121204,124041,245245,78661,145459,224120,104944
"1106",2012-06-01,"sbgo","transporte regular","voo internacional",0,0,0,0,0,0,0,0,0,0
"1107",2012-06-01,"sbgo","transporte não regular","voo doméstico",1606,1609,3215,8624,8520,17144,0,0,0,0
"1108",2012-06-01,"sbgo","transporte não regular","voo internacional",12,9,21,45,60,105,0,0,0,0
"1109",2012-06-01,"sbht","transporte regular","voo doméstico",267,268,535,6397,6705,13102,0,0,0,0
"1110",2012-06-01,"sbht","transporte regular","voo internacional",0,0,0,0,0,0,0,0,0,0
"1111",2012-06-01,"sbht","transporte não regular","voo doméstico",131,131,262,91,100,191,15926,22385,38311,7363
"1112",2012-06-01,"sbht","transporte não regular","voo internacional",0,0,0,0,0,0,0,0,0,0
"1113",2012-06-01,"sbiz","transporte regular","voo doméstico",177,177,354,13107,14606,27713,0,0,0,344
"1114",2012-06-01,"sbiz","transporte regular","voo internacional",0,0,0,0,0,0,0,0,0,0
"1115",2012-06-01,"sbiz","transporte não regular","voo doméstico",205,207,412,485,560,1045,0,0,0,0
"1116",2012-06-01,"sbiz","transporte não regular","voo internacional",0,0,0,0,0,0,0,0,0,0
"1117",2012-06-01,"sbjc","transporte regular","voo doméstico",0,0,0,0,0,0,0,0,0,0
"1118",2012-06-01,"sbjc","transporte regular","voo internacional",0,0,0,0,0,0,0,0,0,0
"1119",2012-06-01,"sbjc","transporte não regular","voo doméstico",859,866,1725,1494,1371,2865,0,0,0,0
"1120",2012-06-01,"sbjc","transporte não regular","voo internacional",1,1,2,0,0,0,0,0,0,0
"1121",2012-06-01,"sbjr","transporte regular","voo doméstico",0,0,0,0,0,0,0,0,0,0
"1122",2012-06-01,"sbjr","transporte regular","voo internacional",0,0,0,0,0,0,0,0,0,0
"1123",2012-06-01,"sbjr","transporte não regular","voo doméstico",2266,2262,4528,6427,3166,9593,0,0,0,0
"1124",2012-06-01,"sbjr","transporte não regular","voo internacional",0,0,0,0,0,0,0,0,0,0
"1125",2012-06-01,"sbjv","transporte regular","voo doméstico",257,255,512,15585,15696,31281,0,0,0,0
"1126",2012-06-01,"sbjv","transporte regular","voo internacional",0,0,0,0,0,0,0,0,0,0
"1127",2012-06-01,"sbjv","transporte não regular","voo doméstico",143,146,289,152,1005,1157,0,0,0,0
"1128",2012-06-01,"sbjv","transporte não regular","voo internacional",0,0,0,0,0,0,0,0,0,0
"1129",2012-06-01,"sblo","transporte regular","voo doméstico",531,534,1065,39262,38610,77872,0,0,0,0
"1130",2012-06-01,"sblo","transporte regular","voo internacional",0,0,0,0,0,0,0,0,0,0
"1131",2012-06-01,"sblo","transporte não regular","voo doméstico",701,700,1401,1069,2163,3232,0,0,0,0
"1132",2012-06-01,"sblo","transporte não regular","voo internacional",4,0,4,0,0,0,0,0,0,0
"1133",2012-06-01,"sbma","transporte regular","voo doméstico",385,385,770,14893,16248,31141,0,0,0,0
"1134",2012-06-01,"sbma","transporte regular","voo internacional",0,0,0,0,0,0,0,0,0,0
"1135",2012-06-01,"sbma","transporte não regular","voo doméstico",318,313,631,473,560,1033,0,0,0,0
"1136",2012-06-01,"sbma","transporte não regular","voo internacional",7,7,14,0,0,0,0,0,0,0
"1137",2012-06-01,"sbmk","transporte regular","voo doméstico",320,321,641,14711,15278,29989,0,0,0,0
"1138",2012-06-01,"sbmk","transporte regular","voo internacional",0,0,0,0,0,0,0,0,0,0
"1139",2012-06-01,"sbmk","transporte não regular","voo doméstico",221,221,442,62,116,178,0,0,0,0
"1140",2012-06-01,"sbmk","transporte não regular","voo internacional",2,2,4,0,0,0,0,0,0,0
"1141",2012-06-01,"sbmq","transporte regular","voo doméstico",221,221,442,24173,22277,46450,25800,49276,75076,0
"1142",2012-06-01,"sbmq","transporte regular","voo internacional",0,0,0,0,0,0,0,0,0,0
"1143",2012-06-01,"sbmq","transporte não regular","voo doméstico",299,304,603,685,385,1070,0,0,0,0
"1144",2012-06-01,"sbmq","transporte não regular","voo internacional",10,11,21,0,0,0,0,0,0,0
"1145",2012-06-01,"sbmt","transporte regular","voo doméstico",0,0,0,0,0,0,0,0,0,0
"1146",2012-06-01,"sbmt","transporte regular","voo internacional",0,0,0,0,0,0,0,0,0,0
"1147",2012-06-01,"sbmt","transporte não regular","voo doméstico",5088,5112,10200,15399,15259,30658,0,0,0,0
"1148",2012-06-01,"sbmt","transporte não regular","voo internacional",8,8,16,0,0,0,0,0,0,0
"1149",2012-06-01,"sbnf","transporte regular","voo doméstico",677,675,1352,47657,49195,96852,0,0,0,0
"1150",2012-06-01,"sbnf","transporte regular","voo internacional",0,0,0,0,0,0,0,0,0,0
"1151",2012-06-01,"sbnf","transporte não regular","voo doméstico",346,347,693,1450,1789,3239,0,0,0,0
"1152",2012-06-01,"sbnf","transporte não regular","voo internacional",3,2,5,0,0,0,0,0,0,0
"1153",2012-06-01,"sbpb","transporte regular","voo doméstico",0,0,0,0,0,0,0,0,0,0
"1154",2012-06-01,"sbpb","transporte regular","voo internacional",0,0,0,0,0,0,0,0,0,0
"1155",2012-06-01,"sbpb","transporte não regular","voo doméstico",57,56,113,124,131,255,0,0,0,0
"1156",2012-06-01,"sbpb","transporte não regular","voo internacional",0,0,0,0,0,0,0,0,0,0
"1157",2012-06-01,"sbpj","transporte regular","voo doméstico",331,330,661,25248,24926,50174,0,0,0,0
"1158",2012-06-01,"sbpj","transporte regular","voo internacional",0,0,0,0,0,0,0,0,0,0
"1159",2012-06-01,"sbpj","transporte não regular","voo doméstico",506,513,1019,766,699,1465,21630,38521,60151,0
"1160",2012-06-01,"sbpj","transporte não regular","voo internacional",7,4,11,0,0,0,0,0,0,0
"1161",2012-06-01,"sbpk","transporte regular","voo doméstico",80,79,159,251,279,530,0,0,0,0
"1162",2012-06-01,"sbpk","transporte regular","voo internacional",0,0,0,0,0,0,0,0,0,0
"1163",2012-06-01,"sbpk","transporte não regular","voo doméstico",55,56,111,139,146,285,0,0,0,0
"1164",2012-06-01,"sbpk","transporte não regular","voo internacional",2,2,4,6,11,17,0,0,0,0
"1165",2012-06-01,"sbpl","transporte regular","voo doméstico",167,166,333,18422,20567,38989,0,0,0,0
"1166",2012-06-01,"sbpl","transporte regular","voo internacional",4,4,8,0,0,0,0,0,0,0
"1167",2012-06-01,"sbpl","transporte não regular","voo doméstico",131,127,258,180,216,396,0,0,0,0
"1168",2012-06-01,"sbpl","transporte não regular","voo internacional",0,0,0,0,0,0,0,0,0,0
"1169",2012-06-01,"sbpp","transporte regular","voo doméstico",0,0,0,0,0,0,0,0,0,0
"1170",2012-06-01,"sbpp","transporte regular","voo internacional",0,0,0,0,0,0,0,0,0,0
"1171",2012-06-01,"sbpp","transporte não regular","voo doméstico",47,46,93,75,77,152,0,0,0,0
"1172",2012-06-01,"sbpp","transporte não regular","voo internacional",2,2,4,0,1,1,0,0,0,0
"1173",2012-06-01,"sbpr","transporte regular","voo doméstico",0,0,0,0,0,0,0,0,0,0
"1174",2012-06-01,"sbpr","transporte regular","voo internacional",0,0,0,0,0,0,0,0,0,0
"1175",2012-06-01,"sbpr","transporte não regular","voo doméstico",1719,1723,3442,1774,1686,3460,0,0,0,0
"1176",2012-06-01,"sbpr","transporte não regular","voo internacional",0,0,0,0,0,0,0,0,0,0
"1177",2012-06-01,"sbpv","transporte regular","voo doméstico",555,554,1109,41127,41838,82965,0,0,0,0
"1178",2012-06-01,"sbpv","transporte regular","voo internacional",1,0,1,0,0,0,0,0,0,0
"1179",2012-06-01,"sbpv","transporte não regular","voo doméstico",250,250,500,327,213,540,0,0,0,0
"1180",2012-06-01,"sbpv","transporte não regular","voo internacional",2,2,4,0,0,0,0,0,0,0
"1181",2012-06-01,"sbrb","transporte regular","voo doméstico",175,173,348,13529,13850,27379,0,0,0,0
"1182",2012-06-01,"sbrb","transporte regular","voo internacional",0,0,0,0,0,0,0,0,0,0
"1183",2012-06-01,"sbrb","transporte não regular","voo doméstico",331,330,661,937,750,1687,0,0,0,0
"1184",2012-06-01,"sbrb","transporte não regular","voo internacional",1,2,3,0,0,0,0,0,0,0
"1185",2012-06-01,"sbrj","transporte regular","voo doméstico",3986,4020,8006,356078,351595,707673,0,0,0,0
"1186",2012-06-01,"sbrj","transporte regular","voo internacional",0,0,0,0,0,0,0,0,0,0
"1187",2012-06-01,"sbrj","transporte não regular","voo doméstico",1067,1042,2109,1403,1115,2518,0,0,0,0
"1188",2012-06-01,"sbrj","transporte não regular","voo internacional",3,3,6,0,0,0,0,0,0,0
"1189",2012-06-01,"sbsj","transporte regular","voo doméstico",158,160,318,7653,8145,15798,0,0,0,0
"1190",2012-06-01,"sbsj","transporte regular","voo internacional",0,0,0,0,0,0,0,0,0,0
"1191",2012-06-01,"sbsj","transporte não regular","voo doméstico",558,542,1100,1943,1886,3829,0,0,0,0
"1192",2012-06-01,"sbsj","transporte não regular","voo internacional",8,30,38,52,22,74,0,0,0,0
"1193",2012-06-01,"sbsl","transporte regular","voo doméstico",754,753,1507,81398,83192,164590,0,0,0,2154
"1194",2012-06-01,"sbsl","transporte regular","voo internacional",0,0,0,0,0,0,0,0,0,0
"1195",2012-06-01,"sbsl","transporte não regular","voo doméstico",406,412,818,909,663,1572,0,0,0,0
"1196",2012-06-01,"sbsl","transporte não regular","voo internacional",3,3,6,0,0,0,0,0,0,0
"1197",2012-06-01,"sbsn","transporte regular","voo doméstico",322,322,644,18554,18216,36770,0,0,0,0
"1198",2012-06-01,"sbsn","transporte regular","voo internacional",0,0,0,0,0,0,0,0,0,0
"1199",2012-06-01,"sbsn","transporte não regular","voo doméstico",383,385,768,648,648,1296,0,0,0,0
"1200",2012-06-01,"sbsn","transporte não regular","voo internacional",1,1,2,0,0,0,0,0,0,0
"1201",2012-06-01,"sbsp","transporte regular","voo doméstico",6084,6231,12315,681983,632923,1314906,0,0,0,0
"1202",2012-06-01,"sbsp","transporte regular","voo internacional",0,0,0,0,0,0,0,0,0,0
"1203",2012-06-01,"sbsp","transporte não regular","voo doméstico",2182,2050,4232,9722,9085,18807,0,0,0,0
"1204",2012-06-01,"sbsp","transporte não regular","voo internacional",31,28,59,0,0,0,0,0,0,0
"1205",2012-06-01,"sbte","transporte regular","voo doméstico",439,441,880,41136,44890,86026,0,970,970,0
"1206",2012-06-01,"sbte","transporte regular","voo internacional",0,0,0,0,0,0,0,0,0,0
"1207",2012-06-01,"sbte","transporte não regular","voo doméstico",289,293,582,1191,1304,2495,0,0,0,0
"1208",2012-06-01,"sbte","transporte não regular","voo internacional",7,7,14,0,0,0,0,0,0,0
"1209",2012-06-01,"sbtf","transporte regular","voo doméstico",70,70,140,1538,1676,3214,0,0,0,0
"1210",2012-06-01,"sbtf","transporte regular","voo internacional",0,0,0,0,0,0,0,0,0,0
"1211",2012-06-01,"sbtf","transporte não regular","voo doméstico",396,396,792,2412,2329,4741,2556,3940,6496,13586
"1212",2012-06-01,"sbtf","transporte não regular","voo internacional",0,0,0,0,0,0,0,0,0,0
"1213",2012-06-01,"sbtt","transporte regular","voo doméstico",47,47,94,1469,1854,3323,0,0,0,0
"1214",2012-06-01,"sbtt","transporte regular","voo internacional",0,0,0,0,0,0,0,0,0,0
"1215",2012-06-01,"sbtt","transporte não regular","voo doméstico",80,82,162,458,459,917,1603,3508,5111,574
"1216",2012-06-01,"sbtt","transporte não regular","voo internacional",1,1,2,6,5,11,0,0,0,0
"1217",2012-06-01,"sbuf","transporte regular","voo doméstico",0,0,0,0,0,0,0,0,0,0
"1218",2012-06-01,"sbuf","transporte regular","voo internacional",0,0,0,0,0,0,0,0,0,0
"1219",2012-06-01,"sbuf","transporte não regular","voo doméstico",42,39,81,111,142,253,0,0,0,0
"1220",2012-06-01,"sbuf","transporte não regular","voo internacional",0,0,0,0,0,0,0,0,0,0
"1221",2012-06-01,"sbug","transporte regular","voo doméstico",18,18,36,93,85,178,0,0,0,0
"1222",2012-06-01,"sbug","transporte regular","voo internacional",0,0,0,0,0,0,0,0,0,0
"1223",2012-06-01,"sbug","transporte não regular","voo doméstico",13,11,24,20,43,63,0,0,0,0
"1224",2012-06-01,"sbug","transporte não regular","voo internacional",2,3,5,0,0,0,0,0,0,0
"1225",2012-06-01,"sbul","transporte regular","voo doméstico",659,651,1310,42452,43239,85691,0,0,0,0
"1226",2012-06-01,"sbul","transporte regular","voo internacional",0,0,0,0,0,0,0,0,0,0
"1227",2012-06-01,"sbul","transporte não regular","voo doméstico",555,551,1106,2594,2414,5008,0,0,0,0
"1228",2012-06-01,"sbul","transporte não regular","voo internacional",1,1,2,3,3,6,0,0,0,0
"1229",2012-06-01,"sbur","transporte regular","voo doméstico",208,209,417,6692,6902,13594,50,0,50,0
"1230",2012-06-01,"sbur","transporte regular","voo internacional",0,0,0,0,0,0,0,0,0,0
"1231",2012-06-01,"sbur","transporte não regular","voo doméstico",197,198,395,709,785,1494,0,0,0,0
"1232",2012-06-01,"sbur","transporte não regular","voo internacional",0,0,0,0,0,0,0,0,0,0
"1233",2012-05-01,"sbbe","transporte regular","voo doméstico",1751,1754,3505,127804,124171,251975,116775,393778,510553,0
"1234",2012-05-01,"sbbe","transporte regular","voo internacional",26,26,52,2038,1675,3713,0,57,57,0
"1235",2012-05-01,"sbbe","transporte não regular","voo doméstico",546,548,1094,1864,2077,3941,0,0,0,0
"1236",2012-05-01,"sbbe","transporte não regular","voo internacional",19,19,38,191,179,370,0,0,0,0
"1237",2012-05-01,"sbbg","transporte regular","voo doméstico",0,0,0,0,0,0,0,0,0,0
"1238",2012-05-01,"sbbg","transporte regular","voo internacional",0,0,0,0,0,0,0,0,0,0
"1239",2012-05-01,"sbbg","transporte não regular","voo doméstico",18,18,36,90,86,176,0,0,0,0
"1240",2012-05-01,"sbbg","transporte não regular","voo internacional",4,4,8,9,14,23,0,0,0,0
"1241",2012-05-01,"sbbh","transporte regular","voo doméstico",746,751,1497,23706,25776,49482,0,0,0,0
"1242",2012-05-01,"sbbh","transporte regular","voo internacional",0,0,0,0,0,0,0,0,0,0
"1243",2012-05-01,"sbbh","transporte não regular","voo doméstico",2264,2240,4504,10713,9648,20361,0,0,0,0
"1244",2012-05-01,"sbbh","transporte não regular","voo internacional",14,15,29,43,45,88,0,0,0,0
"1245",2012-05-01,"sbbi","transporte regular","voo doméstico",0,0,0,0,0,0,0,0,0,0
"1246",2012-05-01,"sbbi","transporte regular","voo internacional",0,0,0,0,0,0,0,0,0,0
"1247",2012-05-01,"sbbi","transporte não regular","voo doméstico",1298,1290,2588,3142,4105,7247,0,0,0,0
"1248",2012-05-01,"sbbi","transporte não regular","voo internacional",0,0,0,0,0,0,0,0,0,0
"1249",2012-05-01,"sbbv","transporte regular","voo doméstico",93,93,186,12258,14030,26288,0,0,0,0
"1250",2012-05-01,"sbbv","transporte regular","voo internacional",0,0,0,0,0,0,0,0,0,0
"1251",2012-05-01,"sbbv","transporte não regular","voo doméstico",338,338,676,532,210,742,0,0,0,0
"1252",2012-05-01,"sbbv","transporte não regular","voo internacional",33,25,58,6,14,20,0,0,0,0
"1253",2012-05-01,"sbcg","transporte regular","voo doméstico",806,801,1607,60120,59038,119158,72652,164788,237440,0
"1254",2012-05-01,"sbcg","transporte regular","voo internacional",53,53,106,549,738,1287,0,0,0,0
"1255",2012-05-01,"sbcg","transporte não regular","voo doméstico",446,439,885,218,161,379,0,0,0,0
"1256",2012-05-01,"sbcg","transporte não regular","voo internacional",7,5,12,0,0,0,0,0,0,0
"1257",2012-05-01,"sbcj","transporte regular","voo doméstico",206,206,412,5591,6016,11607,0,0,0,0
"1258",2012-05-01,"sbcj","transporte regular","voo internacional",0,0,0,0,0,0,0,0,0,0
"1259",2012-05-01,"sbcj","transporte não regular","voo doméstico",120,118,238,1088,1207,2295,0,0,0,0
"1260",2012-05-01,"sbcj","transporte não regular","voo internacional",1,1,2,0,0,0,0,0,0,0
"1261",2012-05-01,"sbcr","transporte regular","voo doméstico",31,31,62,1404,1337,2741,0,0,0,0
"1262",2012-05-01,"sbcr","transporte regular","voo internacional",0,0,0,0,0,0,0,0,0,0
"1263",2012-05-01,"sbcr","transporte não regular","voo doméstico",73,73,146,200,203,403,0,0,0,0
"1264",2012-05-01,"sbcr","transporte não regular","voo internacional",5,5,10,20,20,40,0,0,0,0
"1265",2012-05-01,"sbct","transporte regular","voo doméstico",3387,3410,6797,294584,276018,570602,155674,63822,219496,256073
"1266",2012-05-01,"sbct","transporte regular","voo internacional",114,116,230,4563,3529,8092,0,0,0,0
"1267",2012-05-01,"sbct","transporte não regular","voo doméstico",281,249,530,2942,3004,5946,0,0,0,0
"1268",2012-05-01,"sbct","transporte não regular","voo internacional",37,33,70,77,168,245,0,0,0,0
"1269",2012-05-01,"sbcz","transporte regular","voo doméstico",31,31,62,2293,2213,4506,0,0,0,0
"1270",2012-05-01,"sbcz","transporte regular","voo internacional",0,0,0,0,0,0,0,0,0,0
"1271",2012-05-01,"sbcz","transporte não regular","voo doméstico",195,192,387,701,754,1455,4705,23525,28230,0
"1272",2012-05-01,"sbcz","transporte não regular","voo internacional",2,2,4,0,0,0,0,0,0,0
"1273",2012-05-01,"sbeg","transporte regular","voo doméstico",1264,1265,2529,106961,108433,215394,0,0,0,0
"1274",2012-05-01,"sbeg","transporte regular","voo internacional",69,71,140,5584,6096,11680,0,0,0,0
"1275",2012-05-01,"sbeg","transporte não regular","voo doméstico",728,731,1459,5546,5690,11236,0,0,0,0
"1276",2012-05-01,"sbeg","transporte não regular","voo internacional",220,213,433,9,0,9,0,0,0,0
"1277",2012-05-01,"sbfi","transporte regular","voo doméstico",665,667,1332,68139,68303,136442,0,0,0,0
"1278",2012-05-01,"sbfi","transporte regular","voo internacional",32,32,64,3117,3090,6207,0,0,0,0
"1279",2012-05-01,"sbfi","transporte não regular","voo doméstico",155,155,310,500,741,1241,0,0,0,0
"1280",2012-05-01,"sbfi","transporte não regular","voo internacional",65,64,129,325,372,697,0,0,0,0
"1281",2012-05-01,"sbgo","transporte regular","voo doméstico",1615,1615,3230,119439,121420,240859,107409,240170,347579,163375
"1282",2012-05-01,"sbgo","transporte regular","voo internacional",0,0,0,0,0,0,0,0,0,0
"1283",2012-05-01,"sbgo","transporte não regular","voo doméstico",1723,1717,3440,8777,8571,17348,0,0,0,0
"1284",2012-05-01,"sbgo","transporte não regular","voo internacional",14,11,25,55,70,125,0,0,0,0
"1285",2012-05-01,"sbht","transporte regular","voo doméstico",283,282,565,6343,6607,12950,0,0,0,0
"1286",2012-05-01,"sbht","transporte regular","voo internacional",0,0,0,0,0,0,0,0,0,0
"1287",2012-05-01,"sbht","transporte não regular","voo doméstico",194,198,392,184,184,368,16765,25808,42573,9618
"1288",2012-05-01,"sbht","transporte não regular","voo internacional",1,1,2,0,0,0,0,0,0,0
"1289",2012-05-01,"sbiz","transporte regular","voo doméstico",176,176,352,12609,12473,25082,0,0,0,0
"1290",2012-05-01,"sbiz","transporte regular","voo internacional",0,0,0,0,0,0,0,0,0,0
"1291",2012-05-01,"sbiz","transporte não regular","voo doméstico",168,168,336,410,458,868,0,0,0,0
"1292",2012-05-01,"sbiz","transporte não regular","voo internacional",1,0,1,0,0,0,0,0,0,0
"1293",2012-05-01,"sbjc","transporte regular","voo doméstico",0,0,0,0,0,0,0,0,0,0
"1294",2012-05-01,"sbjc","transporte regular","voo internacional",0,0,0,0,0,0,0,0,0,0
"1295",2012-05-01,"sbjc","transporte não regular","voo doméstico",750,743,1493,1418,1321,2739,0,0,0,0
"1296",2012-05-01,"sbjc","transporte não regular","voo internacional",3,2,5,0,0,0,0,0,0,0
"1297",2012-05-01,"sbjr","transporte regular","voo doméstico",0,0,0,0,0,0,0,0,0,0
"1298",2012-05-01,"sbjr","transporte regular","voo internacional",0,0,0,0,0,0,0,0,0,0
"1299",2012-05-01,"sbjr","transporte não regular","voo doméstico",3274,3290,6564,8662,4000,12662,0,0,0,0
"1300",2012-05-01,"sbjr","transporte não regular","voo internacional",0,0,0,0,0,0,0,0,0,0
"1301",2012-05-01,"sbjv","transporte regular","voo doméstico",297,298,595,18956,18009,36965,0,0,0,0
"1302",2012-05-01,"sbjv","transporte regular","voo internacional",0,0,0,0,0,0,0,0,0,0
"1303",2012-05-01,"sbjv","transporte não regular","voo doméstico",133,131,264,94,311,405,0,0,0,0
"1304",2012-05-01,"sbjv","transporte não regular","voo internacional",2,2,4,0,6,6,0,0,0,0
"1305",2012-05-01,"sblo","transporte regular","voo doméstico",652,656,1308,47180,44686,91866,0,0,0,0
"1306",2012-05-01,"sblo","transporte regular","voo internacional",0,0,0,0,0,0,0,0,0,0
"1307",2012-05-01,"sblo","transporte não regular","voo doméstico",880,872,1752,418,452,870,0,0,0,0
"1308",2012-05-01,"sblo","transporte não regular","voo internacional",6,6,12,0,0,0,0,0,0,0
"1309",2012-05-01,"sbma","transporte regular","voo doméstico",409,408,817,14964,14378,29342,0,0,0,0
"1310",2012-05-01,"sbma","transporte regular","voo internacional",0,0,0,0,0,0,0,0,0,0
"1311",2012-05-01,"sbma","transporte não regular","voo doméstico",249,249,498,359,455,814,0,0,0,0
"1312",2012-05-01,"sbma","transporte não regular","voo internacional",8,8,16,0,0,0,0,0,0,0
"1313",2012-05-01,"sbmk","transporte regular","voo doméstico",349,346,695,15050,15103,30153,0,0,0,0
"1314",2012-05-01,"sbmk","transporte regular","voo internacional",0,0,0,0,0,0,0,0,0,0
"1315",2012-05-01,"sbmk","transporte não regular","voo doméstico",237,235,472,124,168,292,0,0,0,0
"1316",2012-05-01,"sbmk","transporte não regular","voo internacional",0,0,0,0,0,0,0,0,0,0
"1317",2012-05-01,"sbmq","transporte regular","voo doméstico",221,221,442,21612,21977,43589,34905,37530,72435,0
"1318",2012-05-01,"sbmq","transporte regular","voo internacional",0,0,0,0,0,0,0,0,0,0
"1319",2012-05-01,"sbmq","transporte não regular","voo doméstico",304,302,606,546,326,872,0,0,0,0
"1320",2012-05-01,"sbmq","transporte não regular","voo internacional",20,24,44,0,0,0,0,0,0,0
"1321",2012-05-01,"sbmt","transporte regular","voo doméstico",0,0,0,0,0,0,0,0,0,0
"1322",2012-05-01,"sbmt","transporte regular","voo internacional",0,0,0,0,0,0,0,0,0,0
"1323",2012-05-01,"sbmt","transporte não regular","voo doméstico",6572,6552,13124,19635,19650,39285,0,0,0,0
"1324",2012-05-01,"sbmt","transporte não regular","voo internacional",8,9,17,0,12,12,0,0,0,0
"1325",2012-05-01,"sbnf","transporte regular","voo doméstico",714,713,1427,51551,48775,100326,0,0,0,0
"1326",2012-05-01,"sbnf","transporte regular","voo internacional",0,0,0,0,0,0,0,0,0,0
"1327",2012-05-01,"sbnf","transporte não regular","voo doméstico",354,353,707,1428,1376,2804,0,0,0,0
"1328",2012-05-01,"sbnf","transporte não regular","voo internacional",6,7,13,4,2,6,0,0,0,0
"1329",2012-05-01,"sbpb","transporte regular","voo doméstico",0,0,0,0,0,0,0,0,0,0
"1330",2012-05-01,"sbpb","transporte regular","voo internacional",0,0,0,0,0,0,0,0,0,0
"1331",2012-05-01,"sbpb","transporte não regular","voo doméstico",38,38,76,68,63,131,0,0,0,0
"1332",2012-05-01,"sbpb","transporte não regular","voo internacional",1,1,2,0,0,0,0,0,0,0
"1333",2012-05-01,"sbpj","transporte regular","voo doméstico",377,377,754,25326,25335,50661,0,0,0,0
"1334",2012-05-01,"sbpj","transporte regular","voo internacional",0,0,0,0,0,0,0,0,0,0
"1335",2012-05-01,"sbpj","transporte não regular","voo doméstico",467,461,928,735,701,1436,18170,33834,52004,0
"1336",2012-05-01,"sbpj","transporte não regular","voo internacional",5,5,10,0,0,0,0,0,0,0
"1337",2012-05-01,"sbpk","transporte regular","voo doméstico",90,89,179,261,280,541,0,0,0,0
"1338",2012-05-01,"sbpk","transporte regular","voo internacional",0,0,0,0,0,0,0,0,0,0
"1339",2012-05-01,"sbpk","transporte não regular","voo doméstico",72,74,146,180,172,352,0,0,0,0
"1340",2012-05-01,"sbpk","transporte não regular","voo internacional",3,3,6,6,6,12,0,0,0,0
"1341",2012-05-01,"sbpl","transporte regular","voo doméstico",175,176,351,19666,19842,39508,0,0,0,0
"1342",2012-05-01,"sbpl","transporte regular","voo internacional",5,5,10,0,0,0,0,0,0,0
"1343",2012-05-01,"sbpl","transporte não regular","voo doméstico",79,78,157,112,108,220,0,0,0,0
"1344",2012-05-01,"sbpl","transporte não regular","voo internacional",1,1,2,0,0,0,0,0,0,0
"1345",2012-05-01,"sbpp","transporte regular","voo doméstico",0,0,0,0,0,0,0,0,0,0
"1346",2012-05-01,"sbpp","transporte regular","voo internacional",0,0,0,0,0,0,0,0,0,0
"1347",2012-05-01,"sbpp","transporte não regular","voo doméstico",74,75,149,140,147,287,0,0,0,0
"1348",2012-05-01,"sbpp","transporte não regular","voo internacional",13,12,25,11,20,31,0,0,0,0
"1349",2012-05-01,"sbpr","transporte regular","voo doméstico",0,0,0,0,0,0,0,0,0,0
"1350",2012-05-01,"sbpr","transporte regular","voo internacional",0,0,0,0,0,0,0,0,0,0
"1351",2012-05-01,"sbpr","transporte não regular","voo doméstico",1915,1906,3821,1981,1949,3930,0,0,0,0
"1352",2012-05-01,"sbpr","transporte não regular","voo internacional",3,2,5,0,0,0,0,0,0,0
"1353",2012-05-01,"sbpv","transporte regular","voo doméstico",548,546,1094,39813,40342,80155,0,0,0,0
"1354",2012-05-01,"sbpv","transporte regular","voo internacional",0,0,0,0,0,0,0,0,0,0
"1355",2012-05-01,"sbpv","transporte não regular","voo doméstico",296,301,597,188,214,402,0,0,0,0
"1356",2012-05-01,"sbpv","transporte não regular","voo internacional",0,0,0,0,0,0,0,0,0,0
"1357",2012-05-01,"sbrb","transporte regular","voo doméstico",176,177,353,13379,14779,28158,0,0,0,0
"1358",2012-05-01,"sbrb","transporte regular","voo internacional",0,0,0,0,0,0,0,0,0,0
"1359",2012-05-01,"sbrb","transporte não regular","voo doméstico",373,377,750,742,660,1402,0,0,0,0
"1360",2012-05-01,"sbrb","transporte não regular","voo internacional",0,0,0,0,0,0,0,0,0,0
"1361",2012-05-01,"sbrj","transporte regular","voo doméstico",4484,4515,8999,393092,377896,770988,0,0,0,0
"1362",2012-05-01,"sbrj","transporte regular","voo internacional",0,0,0,0,0,0,0,0,0,0
"1363",2012-05-01,"sbrj","transporte não regular","voo doméstico",1438,1406,2844,353,148,501,0,0,0,0
"1364",2012-05-01,"sbrj","transporte não regular","voo internacional",15,15,30,0,0,0,0,0,0,0
"1365",2012-05-01,"sbsj","transporte regular","voo doméstico",156,156,312,7385,7476,14861,0,0,0,0
"1366",2012-05-01,"sbsj","transporte regular","voo internacional",0,0,0,0,0,0,0,0,0,0
"1367",2012-05-01,"sbsj","transporte não regular","voo doméstico",674,650,1324,1647,1720,3367,0,0,0,0
"1368",2012-05-01,"sbsj","transporte não regular","voo internacional",10,20,30,54,18,72,0,0,0,0
"1369",2012-05-01,"sbsl","transporte regular","voo doméstico",755,756,1511,74100,73946,148046,0,0,0,0
"1370",2012-05-01,"sbsl","transporte regular","voo internacional",0,0,0,0,0,0,0,0,0,0
"1371",2012-05-01,"sbsl","transporte não regular","voo doméstico",354,346,700,915,522,1437,0,0,0,0
"1372",2012-05-01,"sbsl","transporte não regular","voo internacional",1,0,1,0,0,0,0,0,0,0
"1373",2012-05-01,"sbsn","transporte regular","voo doméstico",341,341,682,17845,17413,35258,0,0,0,0
"1374",2012-05-01,"sbsn","transporte regular","voo internacional",0,0,0,0,0,0,0,0,0,0
"1375",2012-05-01,"sbsn","transporte não regular","voo doméstico",369,366,735,785,885,1670,0,0,0,0
"1376",2012-05-01,"sbsn","transporte não regular","voo internacional",1,1,2,0,0,0,0,0,0,0
"1377",2012-05-01,"sbsp","transporte regular","voo doméstico",6839,6896,13735,706966,705369,1412335,0,0,0,0
"1378",2012-05-01,"sbsp","transporte regular","voo internacional",0,0,0,0,0,0,0,0,0,0
"1379",2012-05-01,"sbsp","transporte não regular","voo doméstico",2297,2218,4515,8194,8287,16481,0,0,0,0
"1380",2012-05-01,"sbsp","transporte não regular","voo internacional",59,51,110,0,0,0,0,0,0,0
"1381",2012-05-01,"sbte","transporte regular","voo doméstico",463,461,924,40841,41659,82500,0,0,0,0
"1382",2012-05-01,"sbte","transporte regular","voo internacional",0,0,0,0,0,0,0,0,0,0
"1383",2012-05-01,"sbte","transporte não regular","voo doméstico",221,223,444,1222,1010,2232,0,0,0,0
"1384",2012-05-01,"sbte","transporte não regular","voo internacional",0,0,0,0,0,0,0,0,0,0
"1385",2012-05-01,"sbtf","transporte regular","voo doméstico",75,75,150,1322,1454,2776,0,0,0,0
"1386",2012-05-01,"sbtf","transporte regular","voo internacional",0,0,0,0,0,0,0,0,0,0
"1387",2012-05-01,"sbtf","transporte não regular","voo doméstico",406,407,813,2715,2488,5203,3036,6360,9396,12732
"1388",2012-05-01,"sbtf","transporte não regular","voo internacional",0,0,0,0,0,0,0,0,0,0
"1389",2012-05-01,"sbtt","transporte regular","voo doméstico",40,40,80,1543,1697,3240,0,0,0,0
"1390",2012-05-01,"sbtt","transporte regular","voo internacional",0,0,0,0,0,0,0,0,0,0
"1391",2012-05-01,"sbtt","transporte não regular","voo doméstico",75,73,148,377,378,755,1929,5197,7126,720
"1392",2012-05-01,"sbtt","transporte não regular","voo internacional",2,2,4,4,9,13,0,0,0,0
"1393",2012-05-01,"sbuf","transporte regular","voo doméstico",0,0,0,0,0,0,0,0,0,0
"1394",2012-05-01,"sbuf","transporte regular","voo internacional",0,0,0,0,0,0,0,0,0,0
"1395",2012-05-01,"sbuf","transporte não regular","voo doméstico",44,46,90,135,111,246,0,0,0,0
"1396",2012-05-01,"sbuf","transporte não regular","voo internacional",0,0,0,0,0,0,0,0,0,0
"1397",2012-05-01,"sbug","transporte regular","voo doméstico",22,22,44,124,152,276,0,0,0,0
"1398",2012-05-01,"sbug","transporte regular","voo internacional",0,0,0,0,0,0,0,0,0,0
"1399",2012-05-01,"sbug","transporte não regular","voo doméstico",12,12,24,32,36,68,0,0,0,0
"1400",2012-05-01,"sbug","transporte não regular","voo internacional",0,0,0,0,0,0,0,0,0,0
"1401",2012-05-01,"sbul","transporte regular","voo doméstico",685,681,1366,40922,40518,81440,0,0,0,0
"1402",2012-05-01,"sbul","transporte regular","voo internacional",0,0,0,0,0,0,0,0,0,0
"1403",2012-05-01,"sbul","transporte não regular","voo doméstico",507,512,1019,1963,1946,3909,0,0,0,0
"1404",2012-05-01,"sbul","transporte não regular","voo internacional",0,0,0,0,0,0,0,0,0,0
"1405",2012-05-01,"sbur","transporte regular","voo doméstico",235,234,469,8098,8259,16357,0,0,0,0
"1406",2012-05-01,"sbur","transporte regular","voo internacional",0,0,0,0,0,0,0,0,0,0
"1407",2012-05-01,"sbur","transporte não regular","voo doméstico",349,354,703,1975,1845,3820,0,0,0,0
"1408",2012-05-01,"sbur","transporte não regular","voo internacional",0,0,0,0,0,0,0,0,0,0
"1409",2012-03-01,"sbbe","transporte regular","voo doméstico",1710,1712,3422,120297,116888,237185,109135,412481,521616,0
"1410",2012-03-01,"sbbe","transporte regular","voo internacional",22,22,44,2071,1562,3633,0,44,44,0
"1411",2012-03-01,"sbbe","transporte não regular","voo doméstico",621,612,1233,2652,3150,5802,0,19298,19298,0
"1412",2012-03-01,"sbbe","transporte não regular","voo internacional",19,21,40,64,20,84,0,0,0,0
"1413",2012-03-01,"sbbg","transporte regular","voo doméstico",0,0,0,0,0,0,0,0,0,0
"1414",2012-03-01,"sbbg","transporte regular","voo internacional",0,0,0,0,0,0,0,0,0,0
"1415",2012-03-01,"sbbg","transporte não regular","voo doméstico",17,16,33,70,81,151,0,0,0,0
"1416",2012-03-01,"sbbg","transporte não regular","voo internacional",2,2,4,16,16,32,0,0,0,0
"1417",2012-03-01,"sbbh","transporte regular","voo doméstico",711,711,1422,21463,23733,45196,0,0,0,0
"1418",2012-03-01,"sbbh","transporte regular","voo internacional",0,0,0,0,0,0,0,0,0,0
"1419",2012-03-01,"sbbh","transporte não regular","voo doméstico",2141,2128,4269,9175,10070,19245,0,0,0,0
"1420",2012-03-01,"sbbh","transporte não regular","voo internacional",6,5,11,23,28,51,0,0,0,0
"1421",2012-03-01,"sbbi","transporte regular","voo doméstico",0,0,0,0,0,0,0,0,0,0
"1422",2012-03-01,"sbbi","transporte regular","voo internacional",0,0,0,0,0,0,0,0,0,0
"1423",2012-03-01,"sbbi","transporte não regular","voo doméstico",1429,1430,2859,6010,4350,10360,0,0,0,0
"1424",2012-03-01,"sbbi","transporte não regular","voo internacional",2,2,4,0,0,0,0,0,0,0
"1425",2012-03-01,"sbbv","transporte regular","voo doméstico",94,94,188,12663,14617,27280,0,0,0,0
"1426",2012-03-01,"sbbv","transporte regular","voo internacional",0,0,0,0,0,0,0,0,0,0
"1427",2012-03-01,"sbbv","transporte não regular","voo doméstico",530,517,1047,1022,482,1504,0,0,0,0
"1428",2012-03-01,"sbbv","transporte não regular","voo internacional",43,44,87,17,25,42,0,0,0,0
"1429",2012-03-01,"sbcg","transporte regular","voo doméstico",879,877,1756,59762,58228,117990,61505,151294,212799,0
"1430",2012-03-01,"sbcg","transporte regular","voo internacional",56,56,112,1836,1280,3116,0,0,0,0
"1431",2012-03-01,"sbcg","transporte não regular","voo doméstico",349,346,695,170,140,310,0,16778,16778,0
"1432",2012-03-01,"sbcg","transporte não regular","voo internacional",13,15,28,0,0,0,0,0,0,0
"1433",2012-03-01,"sbcj","transporte regular","voo doméstico",188,184,372,4795,5320,10115,0,0,0,0
"1434",2012-03-01,"sbcj","transporte regular","voo internacional",0,0,0,0,0,0,0,0,0,0
"1435",2012-03-01,"sbcj","transporte não regular","voo doméstico",129,133,262,1230,1444,2674,0,0,0,0
"1436",2012-03-01,"sbcj","transporte não regular","voo internacional",0,0,0,0,0,0,0,0,0,0
"1437",2012-03-01,"sbcr","transporte regular","voo doméstico",29,29,58,991,979,1970,0,0,0,0
"1438",2012-03-01,"sbcr","transporte regular","voo internacional",0,0,0,0,0,0,0,0,0,0
"1439",2012-03-01,"sbcr","transporte não regular","voo doméstico",72,72,144,272,289,561,0,0,0,0
"1440",2012-03-01,"sbcr","transporte não regular","voo internacional",3,3,6,3,6,9,0,0,0,0
"1441",2012-03-01,"sbct","transporte regular","voo doméstico",3365,3383,6748,284501,276762,561263,185525,108111,293636,313266
"1442",2012-03-01,"sbct","transporte regular","voo internacional",139,137,276,5256,4889,10145,0,0,0,0
"1443",2012-03-01,"sbct","transporte não regular","voo doméstico",380,375,755,1874,2558,4432,0,0,0,0
"1444",2012-03-01,"sbct","transporte não regular","voo internacional",41,40,81,65,61,126,0,0,0,0
"1445",2012-03-01,"sbcz","transporte regular","voo doméstico",31,31,62,2316,2182,4498,0,0,0,0
"1446",2012-03-01,"sbcz","transporte regular","voo internacional",0,0,0,0,0,0,0,0,0,0
"1447",2012-03-01,"sbcz","transporte não regular","voo doméstico",173,170,343,565,529,1094,5550,21835,27385,0
"1448",2012-03-01,"sbcz","transporte não regular","voo internacional",4,4,8,5,9,14,0,0,0,0
"1449",2012-03-01,"sbeg","transporte regular","voo doméstico",1439,1432,2871,106795,104786,211581,0,0,0,0
"1450",2012-03-01,"sbeg","transporte regular","voo internacional",78,76,154,5783,5478,11261,0,0,0,0
"1451",2012-03-01,"sbeg","transporte não regular","voo doméstico",760,759,1519,5270,5968,11238,0,0,0,0
"1452",2012-03-01,"sbeg","transporte não regular","voo internacional",211,218,429,2227,2195,4422,0,0,0,0
"1453",2012-03-01,"sbfi","transporte regular","voo doméstico",634,636,1270,68691,69080,137771,0,0,0,0
"1454",2012-03-01,"sbfi","transporte regular","voo internacional",30,30,60,2852,2838,5690,0,0,0,0
"1455",2012-03-01,"sbfi","transporte não regular","voo doméstico",119,114,233,280,458,738,0,0,0,0
"1456",2012-03-01,"sbfi","transporte não regular","voo internacional",50,52,102,128,156,284,0,0,0,0
"1457",2012-03-01,"sbgo","transporte regular","voo doméstico",1606,1605,3211,111535,111545,223080,115934,223519,339453,166876
"1458",2012-03-01,"sbgo","transporte regular","voo internacional",0,0,0,0,0,0,0,0,0,0
"1459",2012-03-01,"sbgo","transporte não regular","voo doméstico",1720,1736,3456,9018,8812,17830,0,0,0,0
"1460",2012-03-01,"sbgo","transporte não regular","voo internacional",15,8,23,40,75,115,0,0,0,0
"1461",2012-03-01,"sbht","transporte regular","voo doméstico",185,185,370,5134,5277,10411,0,0,0,0
"1462",2012-03-01,"sbht","transporte regular","voo internacional",0,0,0,0,0,0,0,0,0,0
"1463",2012-03-01,"sbht","transporte não regular","voo doméstico",186,183,369,147,140,287,11657,20858,32515,13336
"1464",2012-03-01,"sbht","transporte não regular","voo internacional",1,1,2,0,0,0,0,0,0,0
"1465",2012-03-01,"sbiz","transporte regular","voo doméstico",187,187,374,14210,11954,26164,0,0,0,0
"1466",2012-03-01,"sbiz","transporte regular","voo internacional",0,0,0,0,0,0,0,0,0,0
"1467",2012-03-01,"sbiz","transporte não regular","voo doméstico",180,180,360,289,359,648,0,0,0,0
"1468",2012-03-01,"sbiz","transporte não regular","voo internacional",5,3,8,0,0,0,0,0,0,0
"1469",2012-03-01,"sbjc","transporte regular","voo doméstico",0,0,0,0,0,0,0,0,0,0
"1470",2012-03-01,"sbjc","transporte regular","voo internacional",0,0,0,0,0,0,0,0,0,0
"1471",2012-03-01,"sbjc","transporte não regular","voo doméstico",633,627,1260,1110,1163,2273,0,0,0,0
"1472",2012-03-01,"sbjc","transporte não regular","voo internacional",4,2,6,0,0,0,0,0,0,0
"1473",2012-03-01,"sbjr","transporte regular","voo doméstico",0,0,0,0,0,0,0,0,0,0
"1474",2012-03-01,"sbjr","transporte regular","voo internacional",0,0,0,0,0,0,0,0,0,0
"1475",2012-03-01,"sbjr","transporte não regular","voo doméstico",3179,3160,6339,8609,5249,13858,0,0,0,0
"1476",2012-03-01,"sbjr","transporte não regular","voo internacional",0,0,0,0,0,0,0,0,0,0
"1477",2012-03-01,"sbjv","transporte regular","voo doméstico",307,305,612,19336,19332,38668,0,0,0,0
"1478",2012-03-01,"sbjv","transporte regular","voo internacional",0,0,0,0,0,0,0,0,0,0
"1479",2012-03-01,"sbjv","transporte não regular","voo doméstico",181,184,365,372,124,496,0,0,0,0
"1480",2012-03-01,"sbjv","transporte não regular","voo internacional",1,1,2,6,2,8,0,0,0,0
"1481",2012-03-01,"sblo","transporte regular","voo doméstico",640,639,1279,43301,43110,86411,0,0,0,0
"1482",2012-03-01,"sblo","transporte regular","voo internacional",0,0,0,0,0,0,0,0,0,0
"1483",2012-03-01,"sblo","transporte não regular","voo doméstico",859,861,1720,1039,1202,2241,0,0,0,0
"1484",2012-03-01,"sblo","transporte não regular","voo internacional",3,2,5,0,0,0,0,0,0,0
"1485",2012-03-01,"sbma","transporte regular","voo doméstico",427,427,854,12233,13290,25523,0,0,0,0
"1486",2012-03-01,"sbma","transporte regular","voo internacional",0,0,0,0,0,0,0,0,0,0
"1487",2012-03-01,"sbma","transporte não regular","voo doméstico",232,233,465,467,467,934,0,0,0,0
"1488",2012-03-01,"sbma","transporte não regular","voo internacional",1,1,2,0,0,0,0,0,0,0
"1489",2012-03-01,"sbmk","transporte regular","voo doméstico",311,312,623,13418,12883,26301,0,0,0,0
"1490",2012-03-01,"sbmk","transporte regular","voo internacional",0,0,0,0,0,0,0,0,0,0
"1491",2012-03-01,"sbmk","transporte não regular","voo doméstico",207,209,416,384,219,603,0,0,0,0
"1492",2012-03-01,"sbmk","transporte não regular","voo internacional",0,0,0,0,0,0,0,0,0,0
"1493",2012-03-01,"sbmq","transporte regular","voo doméstico",230,229,459,20571,20788,41359,26370,36890,63260,0
"1494",2012-03-01,"sbmq","transporte regular","voo internacional",0,0,0,0,0,0,0,0,0,0
"1495",2012-03-01,"sbmq","transporte não regular","voo doméstico",268,269,537,642,580,1222,0,0,0,0
"1496",2012-03-01,"sbmq","transporte não regular","voo internacional",17,18,35,6,0,6,0,0,0,0
"1497",2012-03-01,"sbmt","transporte regular","voo doméstico",0,0,0,0,0,0,0,0,0,0
"1498",2012-03-01,"sbmt","transporte regular","voo internacional",0,0,0,0,0,0,0,0,0,0
"1499",2012-03-01,"sbmt","transporte não regular","voo doméstico",6677,6714,13391,20009,19758,39767,0,0,0,0
"1500",2012-03-01,"sbmt","transporte não regular","voo internacional",7,6,13,0,6,6,0,0,0,0
"1501",2012-03-01,"sbnf","transporte regular","voo doméstico",614,612,1226,50413,50989,101402,0,0,0,0
"1502",2012-03-01,"sbnf","transporte regular","voo internacional",0,0,0,0,0,0,0,0,0,0
"1503",2012-03-01,"sbnf","transporte não regular","voo doméstico",396,394,790,1246,1541,2787,0,0,0,0
"1504",2012-03-01,"sbnf","transporte não regular","voo internacional",8,6,14,9,10,19,0,0,0,0
"1505",2012-03-01,"sbpb","transporte regular","voo doméstico",0,0,0,0,0,0,0,0,0,0
"1506",2012-03-01,"sbpb","transporte regular","voo internacional",0,0,0,0,0,0,0,0,0,0
"1507",2012-03-01,"sbpb","transporte não regular","voo doméstico",30,29,59,67,73,140,0,0,0,0
"1508",2012-03-01,"sbpb","transporte não regular","voo internacional",1,1,2,3,0,3,0,0,0,0
"1509",2012-03-01,"sbpj","transporte regular","voo doméstico",383,382,765,25497,24165,49662,0,0,0,0
"1510",2012-03-01,"sbpj","transporte regular","voo internacional",0,0,0,0,0,0,0,0,0,0
"1511",2012-03-01,"sbpj","transporte não regular","voo doméstico",494,492,986,1211,550,1761,20800,35780,56580,0
"1512",2012-03-01,"sbpj","transporte não regular","voo internacional",3,3,6,1,0,1,0,0,0,0
"1513",2012-03-01,"sbpk","transporte regular","voo doméstico",90,91,181,265,296,561,0,0,0,0
"1514",2012-03-01,"sbpk","transporte regular","voo internacional",0,0,0,0,0,0,0,0,0,0
"1515",2012-03-01,"sbpk","transporte não regular","voo doméstico",75,77,152,244,240,484,0,0,0,0
"1516",2012-03-01,"sbpk","transporte não regular","voo internacional",6,4,10,9,37,46,0,0,0,0
"1517",2012-03-01,"sbpl","transporte regular","voo doméstico",229,226,455,19370,19487,38857,0,0,0,0
"1518",2012-03-01,"sbpl","transporte regular","voo internacional",2,2,4,0,0,0,0,0,0,0
"1519",2012-03-01,"sbpl","transporte não regular","voo doméstico",61,62,123,68,52,120,0,0,0,0
"1520",2012-03-01,"sbpl","transporte não regular","voo internacional",2,2,4,0,0,0,0,0,0,0
"1521",2012-03-01,"sbpp","transporte regular","voo doméstico",0,0,0,0,0,0,0,0,0,0
"1522",2012-03-01,"sbpp","transporte regular","voo internacional",0,0,0,0,0,0,0,0,0,0
"1523",2012-03-01,"sbpp","transporte não regular","voo doméstico",46,44,90,87,79,166,0,0,0,0
"1524",2012-03-01,"sbpp","transporte não regular","voo internacional",6,6,12,4,3,7,0,0,0,0
"1525",2012-03-01,"sbpr","transporte regular","voo doméstico",0,0,0,0,0,0,0,0,0,0
"1526",2012-03-01,"sbpr","transporte regular","voo internacional",0,0,0,0,0,0,0,0,0,0
"1527",2012-03-01,"sbpr","transporte não regular","voo doméstico",1983,1987,3970,2043,1971,4014,0,0,0,0
"1528",2012-03-01,"sbpr","transporte não regular","voo internacional",4,3,7,0,0,0,0,0,0,0
"1529",2012-03-01,"sbpv","transporte regular","voo doméstico",613,614,1227,41684,39994,81678,0,0,0,0
"1530",2012-03-01,"sbpv","transporte regular","voo internacional",0,0,0,0,0,0,0,0,0,0
"1531",2012-03-01,"sbpv","transporte não regular","voo doméstico",336,337,673,165,35,200,0,0,0,0
"1532",2012-03-01,"sbpv","transporte não regular","voo internacional",1,1,2,0,0,0,0,0,0,0
"1533",2012-03-01,"sbrb","transporte regular","voo doméstico",202,201,403,13935,13788,27723,0,0,0,0
"1534",2012-03-01,"sbrb","transporte regular","voo internacional",0,0,0,0,0,0,0,0,0,0
"1535",2012-03-01,"sbrb","transporte não regular","voo doméstico",408,412,820,770,629,1399,0,0,0,0
"1536",2012-03-01,"sbrb","transporte não regular","voo internacional",0,0,0,0,0,0,0,0,0,0
"1537",2012-03-01,"sbrj","transporte regular","voo doméstico",4521,4534,9055,359584,356852,716436,0,0,0,0
"1538",2012-03-01,"sbrj","transporte regular","voo internacional",0,0,0,0,0,0,0,0,0,0
"1539",2012-03-01,"sbrj","transporte não regular","voo doméstico",1728,1702,3430,948,1066,2014,0,0,0,0
"1540",2012-03-01,"sbrj","transporte não regular","voo internacional",21,21,42,0,0,0,0,0,0,0
"1541",2012-03-01,"sbsj","transporte regular","voo doméstico",134,135,269,6655,6592,13247,0,0,0,0
"1542",2012-03-01,"sbsj","transporte regular","voo internacional",0,0,0,0,0,0,0,0,0,0
"1543",2012-03-01,"sbsj","transporte não regular","voo doméstico",565,543,1108,1611,1631,3242,0,0,0,0
"1544",2012-03-01,"sbsj","transporte não regular","voo internacional",14,29,43,57,16,73,0,0,0,0
"1545",2012-03-01,"sbsl","transporte regular","voo doméstico",929,928,1857,75448,74064,149512,0,124,124,0
"1546",2012-03-01,"sbsl","transporte regular","voo internacional",0,0,0,0,0,0,0,0,0,0
"1547",2012-03-01,"sbsl","transporte não regular","voo doméstico",468,471,939,1180,982,2162,27327,116225,143552,16585
"1548",2012-03-01,"sbsl","transporte não regular","voo internacional",2,1,3,0,0,0,0,0,0,0
"1549",2012-03-01,"sbsn","transporte regular","voo doméstico",387,387,774,17678,16550,34228,0,0,0,0
"1550",2012-03-01,"sbsn","transporte regular","voo internacional",0,0,0,0,0,0,0,0,0,0
"1551",2012-03-01,"sbsn","transporte não regular","voo doméstico",375,374,749,632,660,1292,0,0,0,0
"1552",2012-03-01,"sbsn","transporte não regular","voo internacional",1,1,2,0,0,0,0,0,0,0
"1553",2012-03-01,"sbsp","transporte regular","voo doméstico",6700,6754,13454,690540,683313,1373853,0,0,0,0
"1554",2012-03-01,"sbsp","transporte regular","voo internacional",0,0,0,0,0,0,0,0,0,0
"1555",2012-03-01,"sbsp","transporte não regular","voo doméstico",2380,2347,4727,9296,7512,16808,0,0,0,0
"1556",2012-03-01,"sbsp","transporte não regular","voo internacional",80,87,167,0,0,0,0,0,0,0
"1557",2012-03-01,"sbte","transporte regular","voo doméstico",443,448,891,36598,36237,72835,28499,55192,83691,138707
"1558",2012-03-01,"sbte","transporte regular","voo internacional",0,0,0,0,0,0,0,0,0,0
"1559",2012-03-01,"sbte","transporte não regular","voo doméstico",249,240,489,1003,1109,2112,0,23071,23071,39001
"1560",2012-03-01,"sbte","transporte não regular","voo internacional",0,0,0,0,0,0,0,0,0,0
"1561",2012-03-01,"sbtf","transporte regular","voo doméstico",76,76,152,1192,1181,2373,0,0,0,0
"1562",2012-03-01,"sbtf","transporte regular","voo internacional",0,0,0,0,0,0,0,0,0,0
"1563",2012-03-01,"sbtf","transporte não regular","voo doméstico",474,475,949,2551,2518,5069,3076,6361,9437,17112
"1564",2012-03-01,"sbtf","transporte não regular","voo internacional",0,0,0,0,0,0,0,0,0,0
"1565",2012-03-01,"sbtt","transporte regular","voo doméstico",37,37,74,1153,1446,2599,0,0,0,0
"1566",2012-03-01,"sbtt","transporte regular","voo internacional",0,0,0,0,0,0,0,0,0,0
"1567",2012-03-01,"sbtt","transporte não regular","voo doméstico",46,46,92,240,248,488,1817,3171,4988,495
"1568",2012-03-01,"sbtt","transporte não regular","voo internacional",1,0,1,0,2,2,0,0,0,0
"1569",2012-03-01,"sbuf","transporte regular","voo doméstico",0,0,0,0,0,0,0,0,0,0
"1570",2012-03-01,"sbuf","transporte regular","voo internacional",0,0,0,0,0,0,0,0,0,0
"1571",2012-03-01,"sbuf","transporte não regular","voo doméstico",54,55,109,148,161,309,0,0,0,0
"1572",2012-03-01,"sbuf","transporte não regular","voo internacional",0,0,0,0,0,0,0,0,0,0
"1573",2012-03-01,"sbug","transporte regular","voo doméstico",22,22,44,125,134,259,0,0,0,0
"1574",2012-03-01,"sbug","transporte regular","voo internacional",0,0,0,0,0,0,0,0,0,0
"1575",2012-03-01,"sbug","transporte não regular","voo doméstico",22,20,42,47,47,94,0,0,0,0
"1576",2012-03-01,"sbug","transporte não regular","voo internacional",7,9,16,3,0,3,0,0,0,0
"1577",2012-03-01,"sbul","transporte regular","voo doméstico",632,628,1260,37879,37220,75099,0,0,0,0
"1578",2012-03-01,"sbul","transporte regular","voo internacional",0,0,0,0,0,0,0,0,0,0
"1579",2012-03-01,"sbul","transporte não regular","voo doméstico",519,517,1036,1741,1584,3325,0,0,0,0
"1580",2012-03-01,"sbul","transporte não regular","voo internacional",3,3,6,11,7,18,0,0,0,0
"1581",2012-03-01,"sbur","transporte regular","voo doméstico",222,223,445,7371,7337,14708,0,0,0,0
"1582",2012-03-01,"sbur","transporte regular","voo internacional",0,0,0,0,0,0,0,0,0,0
"1583",2012-03-01,"sbur","transporte não regular","voo doméstico",196,195,391,1003,925,1928,0,0,0,0
"1584",2012-03-01,"sbur","transporte não regular","voo internacional",1,1,2,0,0,0,0,0,0,0
"1585",2012-11-01,"sbbe","transporte regular","voo doméstico",1503,1502,3005,129249,127841,257090,19916,36967,56883,0
"1586",2012-11-01,"sbbe","transporte regular","voo internacional",17,17,34,1922,1794,3716,0,38,38,0
"1587",2012-11-01,"sbbe","transporte não regular","voo doméstico",604,601,1205,2316,2390,4706,63760,219097,282857,0
"1588",2012-11-01,"sbbe","transporte não regular","voo internacional",13,14,27,56,12,68,0,0,0,0
"1589",2012-11-01,"sbbg","transporte regular","voo doméstico",0,0,0,0,0,0,0,0,0,0
"1590",2012-11-01,"sbbg","transporte regular","voo internacional",0,0,0,0,0,0,0,0,0,0
"1591",2012-11-01,"sbbg","transporte não regular","voo doméstico",11,11,22,54,43,97,0,0,0,0
"1592",2012-11-01,"sbbg","transporte não regular","voo internacional",0,0,0,0,0,0,0,0,0,0
"1593",2012-11-01,"sbbh","transporte regular","voo doméstico",633,642,1275,21306,23250,44556,0,0,0,0
"1594",2012-11-01,"sbbh","transporte regular","voo internacional",0,0,0,0,0,0,0,0,0,0
"1595",2012-11-01,"sbbh","transporte não regular","voo doméstico",1898,1898,3796,8763,8669,17432,0,0,0,0
"1596",2012-11-01,"sbbh","transporte não regular","voo internacional",1,1,2,5,5,10,0,0,0,0
"1597",2012-11-01,"sbbi","transporte regular","voo doméstico",0,0,0,0,0,0,0,0,0,0
"1598",2012-11-01,"sbbi","transporte regular","voo internacional",0,0,0,0,0,0,0,0,0,0
"1599",2012-11-01,"sbbi","transporte não regular","voo doméstico",1117,1112,2229,3068,4116,7184,0,0,0,0
"1600",2012-11-01,"sbbi","transporte não regular","voo internacional",2,2,4,0,0,0,0,0,0,0
"1601",2012-11-01,"sbbv","transporte regular","voo doméstico",90,90,180,13015,12898,25913,0,0,0,0
"1602",2012-11-01,"sbbv","transporte regular","voo internacional",0,0,0,0,0,0,0,0,0,0
"1603",2012-11-01,"sbbv","transporte não regular","voo doméstico",342,350,692,894,476,1370,0,0,0,0
"1604",2012-11-01,"sbbv","transporte não regular","voo internacional",42,37,79,2,14,16,0,0,0,0
"1605",2012-11-01,"sbcg","transporte regular","voo doméstico",806,804,1610,72306,72762,145068,13138,18068,31206,0
"1606",2012-11-01,"sbcg","transporte regular","voo internacional",0,0,0,0,0,0,0,0,0,0
"1607",2012-11-01,"sbcg","transporte não regular","voo doméstico",322,329,651,488,292,780,64901,132120,197021,0
"1608",2012-11-01,"sbcg","transporte não regular","voo internacional",9,10,19,0,0,0,0,0,0,0
"1609",2012-11-01,"sbcj","transporte regular","voo doméstico",224,226,450,4345,4602,8947,0,0,0,0
"1610",2012-11-01,"sbcj","transporte regular","voo internacional",0,0,0,0,0,0,0,0,0,0
"1611",2012-11-01,"sbcj","transporte não regular","voo doméstico",91,93,184,1493,1392,2885,0,0,0,0
"1612",2012-11-01,"sbcj","transporte não regular","voo internacional",1,1,2,0,0,0,0,0,0,0
"1613",2012-11-01,"sbcr","transporte regular","voo doméstico",30,30,60,1035,1026,2061,0,0,0,0
"1614",2012-11-01,"sbcr","transporte regular","voo internacional",0,0,0,0,0,0,0,0,0,0
"1615",2012-11-01,"sbcr","transporte não regular","voo doméstico",99,100,199,247,202,449,0,0,0,0
"1616",2012-11-01,"sbcr","transporte não regular","voo internacional",5,5,10,8,7,15,0,0,0,0
"1617",2012-11-01,"sbct","transporte regular","voo doméstico",3043,3050,6093,280961,259257,540218,185758,106649,292407,398831
"1618",2012-11-01,"sbct","transporte regular","voo internacional",90,90,180,2478,1904,4382,0,0,0,0
"1619",2012-11-01,"sbct","transporte não regular","voo doméstico",324,322,646,1419,1670,3089,0,0,0,0
"1620",2012-11-01,"sbct","transporte não regular","voo internacional",35,35,70,52,194,246,0,0,0,0
"1621",2012-11-01,"sbcz","transporte regular","voo doméstico",30,30,60,1713,1674,3387,0,0,0,0
"1622",2012-11-01,"sbcz","transporte regular","voo internacional",0,0,0,0,0,0,0,0,0,0
"1623",2012-11-01,"sbcz","transporte não regular","voo doméstico",205,205,410,813,807,1620,0,0,0,0
"1624",2012-11-01,"sbcz","transporte não regular","voo internacional",1,0,1,0,0,0,0,0,0,0
"1625",2012-11-01,"sbeg","transporte regular","voo doméstico",1263,1270,2533,116843,117114,233957,0,0,0,0
"1626",2012-11-01,"sbeg","transporte regular","voo internacional",115,111,226,10015,9547,19562,0,0,0,0
"1627",2012-11-01,"sbeg","transporte não regular","voo doméstico",741,736,1477,5711,5660,11371,0,0,0,0
"1628",2012-11-01,"sbeg","transporte não regular","voo internacional",178,179,357,1253,1160,2413,0,0,0,0
"1629",2012-11-01,"sbfi","transporte regular","voo doméstico",572,571,1143,69485,70414,139899,1135,141,1276,0
"1630",2012-11-01,"sbfi","transporte regular","voo internacional",17,17,34,2127,2102,4229,0,0,0,0
"1631",2012-11-01,"sbfi","transporte não regular","voo doméstico",145,149,294,1111,690,1801,0,0,0,0
"1632",2012-11-01,"sbfi","transporte não regular","voo internacional",78,74,152,659,705,1364,0,0,0,0
"1633",2012-11-01,"sbgo","transporte regular","voo doméstico",1344,1344,2688,121498,118395,239893,127947,218716,346663,170359
"1634",2012-11-01,"sbgo","transporte regular","voo internacional",0,0,0,0,0,0,0,0,0,0
"1635",2012-11-01,"sbgo","transporte não regular","voo doméstico",1155,1164,2319,5710,5694,11404,4154,15907,20061,8768
"1636",2012-11-01,"sbgo","transporte não regular","voo internacional",11,10,21,50,55,105,0,0,0,0
"1637",2012-11-01,"sbht","transporte regular","voo doméstico",206,206,412,6439,6398,12837,0,3,3,0
"1638",2012-11-01,"sbht","transporte regular","voo internacional",0,0,0,0,0,0,0,0,0,0
"1639",2012-11-01,"sbht","transporte não regular","voo doméstico",119,114,233,240,216,456,13685,24016,37701,8494
"1640",2012-11-01,"sbht","transporte não regular","voo internacional",0,0,0,0,0,0,0,0,0,0
"1641",2012-11-01,"sbiz","transporte regular","voo doméstico",179,179,358,11553,11527,23080,0,0,0,0
"1642",2012-11-01,"sbiz","transporte regular","voo internacional",0,0,0,0,0,0,0,0,0,0
"1643",2012-11-01,"sbiz","transporte não regular","voo doméstico",130,126,256,612,577,1189,0,0,0,0
"1644",2012-11-01,"sbiz","transporte não regular","voo internacional",3,3,6,0,0,0,0,0,0,0
"1645",2012-11-01,"sbjc","transporte regular","voo doméstico",0,0,0,0,0,0,0,0,0,0
"1646",2012-11-01,"sbjc","transporte regular","voo internacional",0,0,0,0,0,0,0,0,0,0
"1647",2012-11-01,"sbjc","transporte não regular","voo doméstico",648,656,1304,1144,1066,2210,0,0,0,0
"1648",2012-11-01,"sbjc","transporte não regular","voo internacional",1,0,1,0,0,0,0,0,0,0
"1649",2012-11-01,"sbjr","transporte regular","voo doméstico",0,0,0,0,0,0,0,0,0,0
"1650",2012-11-01,"sbjr","transporte regular","voo internacional",0,0,0,0,0,0,0,0,0,0
"1651",2012-11-01,"sbjr","transporte não regular","voo doméstico",2659,2629,5288,7503,4123,11626,0,0,0,0
"1652",2012-11-01,"sbjr","transporte não regular","voo internacional",0,0,0,0,0,0,0,0,0,0
"1653",2012-11-01,"sbjv","transporte regular","voo doméstico",275,276,551,17646,17160,34806,0,0,0,0
"1654",2012-11-01,"sbjv","transporte regular","voo internacional",0,0,0,0,0,0,0,0,0,0
"1655",2012-11-01,"sbjv","transporte não regular","voo doméstico",122,124,246,55,235,290,0,0,0,0
"1656",2012-11-01,"sbjv","transporte não regular","voo internacional",0,0,0,0,0,0,0,0,0,0
"1657",2012-11-01,"sblo","transporte regular","voo doméstico",639,639,1278,45023,45155,90178,0,0,0,0
"1658",2012-11-01,"sblo","transporte regular","voo internacional",0,0,0,0,0,0,0,0,0,0
"1659",2012-11-01,"sblo","transporte não regular","voo doméstico",944,937,1881,436,745,1181,0,0,0,0
"1660",2012-11-01,"sblo","transporte não regular","voo internacional",0,1,1,0,0,0,0,0,0,0
"1661",2012-11-01,"sbma","transporte regular","voo doméstico",417,417,834,15666,15331,30997,2,122,124,0
"1662",2012-11-01,"sbma","transporte regular","voo internacional",0,0,0,0,0,0,0,0,0,0
"1663",2012-11-01,"sbma","transporte não regular","voo doméstico",270,267,537,370,335,705,0,0,0,0
"1664",2012-11-01,"sbma","transporte não regular","voo internacional",7,7,14,0,0,0,0,0,0,0
"1665",2012-11-01,"sbmk","transporte regular","voo doméstico",271,269,540,12044,11660,23704,0,0,0,0
"1666",2012-11-01,"sbmk","transporte regular","voo internacional",0,0,0,0,0,0,0,0,0,0
"1667",2012-11-01,"sbmk","transporte não regular","voo doméstico",125,125,250,33,49,82,0,0,0,0
"1668",2012-11-01,"sbmk","transporte não regular","voo internacional",3,3,6,0,0,0,0,0,0,0
"1669",2012-11-01,"sbmq","transporte regular","voo doméstico",225,232,457,23237,22212,45449,19520,25018,44538,0
"1670",2012-11-01,"sbmq","transporte regular","voo internacional",0,0,0,0,0,0,0,0,0,0
"1671",2012-11-01,"sbmq","transporte não regular","voo doméstico",261,253,514,330,153,483,3500,9800,13300,0
"1672",2012-11-01,"sbmq","transporte não regular","voo internacional",21,15,36,0,0,0,0,0,0,0
"1673",2012-11-01,"sbmt","transporte regular","voo doméstico",0,0,0,0,0,0,0,0,0,0
"1674",2012-11-01,"sbmt","transporte regular","voo internacional",0,0,0,0,0,0,0,0,0,0
"1675",2012-11-01,"sbmt","transporte não regular","voo doméstico",5741,5731,11472,17172,15717,32889,0,0,0,0
"1676",2012-11-01,"sbmt","transporte não regular","voo internacional",8,7,15,0,0,0,0,0,0,0
"1677",2012-11-01,"sbnf","transporte regular","voo doméstico",571,572,1143,50140,50255,100395,0,0,0,0
"1678",2012-11-01,"sbnf","transporte regular","voo internacional",0,0,0,0,0,0,0,0,0,0
"1679",2012-11-01,"sbnf","transporte não regular","voo doméstico",362,359,721,1124,1246,2370,0,0,0,0
"1680",2012-11-01,"sbnf","transporte não regular","voo internacional",5,5,10,1,0,1,0,0,0,0
"1681",2012-11-01,"sbpb","transporte regular","voo doméstico",0,0,0,0,0,0,0,0,0,0
"1682",2012-11-01,"sbpb","transporte regular","voo internacional",0,0,0,0,0,0,0,0,0,0
"1683",2012-11-01,"sbpb","transporte não regular","voo doméstico",49,49,98,120,108,228,0,0,0,0
"1684",2012-11-01,"sbpb","transporte não regular","voo internacional",0,0,0,0,0,0,0,0,0,0
"1685",2012-11-01,"sbpj","transporte regular","voo doméstico",259,259,518,20674,22755,43429,0,0,0,0
"1686",2012-11-01,"sbpj","transporte regular","voo internacional",0,0,0,0,0,0,0,0,0,0
"1687",2012-11-01,"sbpj","transporte não regular","voo doméstico",310,304,614,388,291,679,19430,31842,51272,0
"1688",2012-11-01,"sbpj","transporte não regular","voo internacional",6,6,12,0,0,0,0,0,0,0
"1689",2012-11-01,"sbpk","transporte regular","voo doméstico",60,60,120,151,129,280,0,0,0,0
"1690",2012-11-01,"sbpk","transporte regular","voo internacional",0,0,0,0,0,0,0,0,0,0
"1691",2012-11-01,"sbpk","transporte não regular","voo doméstico",113,115,228,285,265,550,0,0,0,0
"1692",2012-11-01,"sbpk","transporte não regular","voo internacional",3,2,5,5,11,16,0,0,0,0
"1693",2012-11-01,"sbpl","transporte regular","voo doméstico",187,185,372,16406,16525,32931,0,0,0,0
"1694",2012-11-01,"sbpl","transporte regular","voo internacional",4,4,8,0,0,0,0,0,0,0
"1695",2012-11-01,"sbpl","transporte não regular","voo doméstico",66,68,134,56,55,111,0,0,0,0
"1696",2012-11-01,"sbpl","transporte não regular","voo internacional",5,5,10,1,1,2,0,0,0,0
"1697",2012-11-01,"sbpp","transporte regular","voo doméstico",0,0,0,0,0,0,0,0,0,0
"1698",2012-11-01,"sbpp","transporte regular","voo internacional",0,0,0,0,0,0,0,0,0,0
"1699",2012-11-01,"sbpp","transporte não regular","voo doméstico",87,85,172,148,153,301,0,0,0,0
"1700",2012-11-01,"sbpp","transporte não regular","voo internacional",5,5,10,4,9,13,0,0,0,0
"1701",2012-11-01,"sbpr","transporte regular","voo doméstico",0,0,0,0,0,0,0,0,0,0
"1702",2012-11-01,"sbpr","transporte regular","voo internacional",0,0,0,0,0,0,0,0,0,0
"1703",2012-11-01,"sbpr","transporte não regular","voo doméstico",1152,1158,2310,1190,1139,2329,0,0,0,0
"1704",2012-11-01,"sbpr","transporte não regular","voo internacional",0,0,0,0,0,0,0,0,0,0
"1705",2012-11-01,"sbpv","transporte regular","voo doméstico",552,550,1102,39974,37987,77961,62829,257915,320744,0
"1706",2012-11-01,"sbpv","transporte regular","voo internacional",0,0,0,0,0,0,0,0,0,0
"1707",2012-11-01,"sbpv","transporte não regular","voo doméstico",238,235,473,0,0,0,0,0,0,0
"1708",2012-11-01,"sbpv","transporte não regular","voo internacional",0,0,0,0,0,0,0,0,0,0
"1709",2012-11-01,"sbrb","transporte regular","voo doméstico",212,212,424,15928,14731,30659,0,0,0,0
"1710",2012-11-01,"sbrb","transporte regular","voo internacional",0,0,0,0,0,0,0,0,0,0
"1711",2012-11-01,"sbrb","transporte não regular","voo doméstico",241,242,483,897,745,1642,0,0,0,0
"1712",2012-11-01,"sbrb","transporte não regular","voo internacional",0,0,0,0,0,0,0,0,0,0
"1713",2012-11-01,"sbrj","transporte regular","voo doméstico",3971,3999,7970,374206,362861,737067,0,0,0,0
"1714",2012-11-01,"sbrj","transporte regular","voo internacional",0,0,0,0,0,0,0,0,0,0
"1715",2012-11-01,"sbrj","transporte não regular","voo doméstico",1113,1090,2203,1244,1448,2692,0,0,0,0
"1716",2012-11-01,"sbrj","transporte não regular","voo internacional",7,6,13,0,0,0,0,0,0,0
"1717",2012-11-01,"sbsj","transporte regular","voo doméstico",161,162,323,6987,6820,13807,0,0,0,0
"1718",2012-11-01,"sbsj","transporte regular","voo internacional",0,0,0,0,0,0,0,0,0,0
"1719",2012-11-01,"sbsj","transporte não regular","voo doméstico",562,551,1113,1759,1570,3329,0,0,0,0
"1720",2012-11-01,"sbsj","transporte não regular","voo internacional",5,25,30,37,7,44,0,0,0,0
"1721",2012-11-01,"sbsl","transporte regular","voo doméstico",684,684,1368,70027,71881,141908,0,0,0,0
"1722",2012-11-01,"sbsl","transporte regular","voo internacional",0,0,0,0,0,0,0,0,0,0
"1723",2012-11-01,"sbsl","transporte não regular","voo doméstico",524,517,1041,1032,681,1713,77977,187653,265630,0
"1724",2012-11-01,"sbsl","transporte não regular","voo internacional",4,3,7,0,0,0,0,0,0,0
"1725",2012-11-01,"sbsn","transporte regular","voo doméstico",311,311,622,19660,18262,37922,0,0,0,0
"1726",2012-11-01,"sbsn","transporte regular","voo internacional",0,0,0,0,0,0,0,0,0,0
"1727",2012-11-01,"sbsn","transporte não regular","voo doméstico",312,316,628,731,735,1466,0,0,0,0
"1728",2012-11-01,"sbsn","transporte não regular","voo internacional",0,2,2,0,0,0,0,0,0,0
"1729",2012-11-01,"sbsp","transporte regular","voo doméstico",6492,6562,13054,711014,688097,1399111,0,0,0,0
"1730",2012-11-01,"sbsp","transporte regular","voo internacional",0,0,0,0,0,0,0,0,0,0
"1731",2012-11-01,"sbsp","transporte não regular","voo doméstico",2422,2383,4805,11202,9659,20861,0,0,0,0
"1732",2012-11-01,"sbsp","transporte não regular","voo internacional",22,22,44,0,0,0,0,0,0,0
"1733",2012-11-01,"sbte","transporte regular","voo doméstico",420,420,840,37948,37948,75896,29771,87660,117431,266224
"1734",2012-11-01,"sbte","transporte regular","voo internacional",0,0,0,0,0,0,0,0,0,0
"1735",2012-11-01,"sbte","transporte não regular","voo doméstico",190,188,378,896,882,1778,0,0,0,0
"1736",2012-11-01,"sbte","transporte não regular","voo internacional",0,0,0,0,0,0,0,0,0,0
"1737",2012-11-01,"sbtf","transporte regular","voo doméstico",74,74,148,1602,1657,3259,0,0,0,0
"1738",2012-11-01,"sbtf","transporte regular","voo internacional",0,0,0,0,0,0,0,0,0,0
"1739",2012-11-01,"sbtf","transporte não regular","voo doméstico",222,222,444,544,476,1020,2919,2783,5702,11059
"1740",2012-11-01,"sbtf","transporte não regular","voo internacional",0,0,0,0,0,0,0,0,0,0
"1741",2012-11-01,"sbtt","transporte regular","voo doméstico",58,58,116,1896,2134,4030,0,0,0,0
"1742",2012-11-01,"sbtt","transporte regular","voo internacional",0,0,0,0,0,0,0,0,0,0
"1743",2012-11-01,"sbtt","transporte não regular","voo doméstico",30,30,60,136,155,291,1825,3981,5806,872
"1744",2012-11-01,"sbtt","transporte não regular","voo internacional",1,2,3,5,3,8,0,0,0,0
"1745",2012-11-01,"sbuf","transporte regular","voo doméstico",0,0,0,0,0,0,0,0,0,0
"1746",2012-11-01,"sbuf","transporte regular","voo internacional",0,0,0,0,0,0,0,0,0,0
"1747",2012-11-01,"sbuf","transporte não regular","voo doméstico",39,38,77,82,93,175,0,0,0,0
"1748",2012-11-01,"sbuf","transporte não regular","voo internacional",0,0,0,0,0,0,0,0,0,0
"1749",2012-11-01,"sbug","transporte regular","voo doméstico",16,16,32,96,83,179,0,0,0,0
"1750",2012-11-01,"sbug","transporte regular","voo internacional",0,0,0,0,0,0,0,0,0,0
"1751",2012-11-01,"sbug","transporte não regular","voo doméstico",21,20,41,32,29,61,0,0,0,0
"1752",2012-11-01,"sbug","transporte não regular","voo internacional",0,3,3,0,0,0,0,0,0,0
"1753",2012-11-01,"sbul","transporte regular","voo doméstico",603,599,1202,39599,39046,78645,0,0,0,0
"1754",2012-11-01,"sbul","transporte regular","voo internacional",0,0,0,0,0,0,0,0,0,0
"1755",2012-11-01,"sbul","transporte não regular","voo doméstico",571,578,1149,1783,1577,3360,0,0,0,0
"1756",2012-11-01,"sbul","transporte não regular","voo internacional",1,1,2,8,8,16,0,0,0,0
"1757",2012-11-01,"sbur","transporte regular","voo doméstico",143,144,287,5455,5297,10752,0,0,0,0
"1758",2012-11-01,"sbur","transporte regular","voo internacional",0,0,0,0,0,0,0,0,0,0
"1759",2012-11-01,"sbur","transporte não regular","voo doméstico",163,163,326,569,651,1220,0,0,0,0
"1760",2012-11-01,"sbur","transporte não regular","voo internacional",2,2,4,0,0,0,0,0,0,0
"1761",2012-10-01,"sbbe","transporte regular","voo doméstico",1618,1623,3241,138274,135007,273281,113137,336675,449812,19088
"1762",2012-10-01,"sbbe","transporte regular","voo internacional",16,17,33,1638,1531,3169,0,46,46,0
"1763",2012-10-01,"sbbe","transporte não regular","voo doméstico",752,751,1503,4840,4972,9812,0,0,0,0
"1764",2012-10-01,"sbbe","transporte não regular","voo internacional",15,15,30,120,109,229,0,0,0,0
"1765",2012-10-01,"sbbg","transporte regular","voo doméstico",0,0,0,0,0,0,0,0,0,0
"1766",2012-10-01,"sbbg","transporte regular","voo internacional",0,0,0,0,0,0,0,0,0,0
"1767",2012-10-01,"sbbg","transporte não regular","voo doméstico",20,20,40,98,88,186,0,0,0,0
"1768",2012-10-01,"sbbg","transporte não regular","voo internacional",1,1,2,5,5,10,0,0,0,0
"1769",2012-10-01,"sbbh","transporte regular","voo doméstico",707,717,1424,23331,23760,47091,0,0,0,0
"1770",2012-10-01,"sbbh","transporte regular","voo internacional",0,0,0,0,0,0,0,0,0,0
"1771",2012-10-01,"sbbh","transporte não regular","voo doméstico",2293,2293,4586,10108,9786,19894,0,0,0,0
"1772",2012-10-01,"sbbh","transporte não regular","voo internacional",8,8,16,65,65,130,0,0,0,0
"1773",2012-10-01,"sbbi","transporte regular","voo doméstico",0,0,0,0,0,0,0,0,0,0
"1774",2012-10-01,"sbbi","transporte regular","voo internacional",0,0,0,0,0,0,0,0,0,0
"1775",2012-10-01,"sbbi","transporte não regular","voo doméstico",1321,1305,2626,4060,3787,7847,0,0,0,0
"1776",2012-10-01,"sbbi","transporte não regular","voo internacional",0,0,0,0,0,0,0,0,0,0
"1777",2012-10-01,"sbbv","transporte regular","voo doméstico",89,91,180,12537,12381,24918,0,0,0,0
"1778",2012-10-01,"sbbv","transporte regular","voo internacional",0,0,0,0,0,0,0,0,0,0
"1779",2012-10-01,"sbbv","transporte não regular","voo doméstico",399,407,806,919,343,1262,0,0,0,0
"1780",2012-10-01,"sbbv","transporte não regular","voo internacional",29,26,55,15,2,17,0,0,0,0
"1781",2012-10-01,"sbcg","transporte regular","voo doméstico",831,836,1667,71684,72592,144276,72869,116217,189086,0
"1782",2012-10-01,"sbcg","transporte regular","voo internacional",0,0,0,0,0,0,0,0,0,0
"1783",2012-10-01,"sbcg","transporte não regular","voo doméstico",371,365,736,526,131,657,0,0,0,0
"1784",2012-10-01,"sbcg","transporte não regular","voo internacional",13,14,27,0,0,0,0,0,0,0
"1785",2012-10-01,"sbcj","transporte regular","voo doméstico",143,143,286,4390,4405,8795,0,0,0,0
"1786",2012-10-01,"sbcj","transporte regular","voo internacional",0,0,0,0,0,0,0,0,0,0
"1787",2012-10-01,"sbcj","transporte não regular","voo doméstico",125,122,247,832,982,1814,0,0,0,0
"1788",2012-10-01,"sbcj","transporte não regular","voo internacional",0,0,0,0,0,0,0,0,0,0
"1789",2012-10-01,"sbcr","transporte regular","voo doméstico",30,30,60,1314,1240,2554,0,0,0,0
"1790",2012-10-01,"sbcr","transporte regular","voo internacional",0,0,0,0,0,0,0,0,0,0
"1791",2012-10-01,"sbcr","transporte não regular","voo doméstico",97,97,194,302,313,615,0,0,0,0
"1792",2012-10-01,"sbcr","transporte não regular","voo internacional",2,1,3,3,12,15,0,0,0,0
"1793",2012-10-01,"sbct","transporte regular","voo doméstico",3234,3242,6476,292143,272697,564840,163270,114834,278104,348492
"1794",2012-10-01,"sbct","transporte regular","voo internacional",87,89,176,2777,1849,4626,0,0,0,0
"1795",2012-10-01,"sbct","transporte não regular","voo doméstico",439,436,875,1849,1797,3646,0,0,0,0
"1796",2012-10-01,"sbct","transporte não regular","voo internacional",31,29,60,49,65,114,0,0,0,0
"1797",2012-10-01,"sbcz","transporte regular","voo doméstico",31,31,62,2144,1928,4072,0,0,0,0
"1798",2012-10-01,"sbcz","transporte regular","voo internacional",0,0,0,0,0,0,0,0,0,0
"1799",2012-10-01,"sbcz","transporte não regular","voo doméstico",280,272,552,974,1036,2010,0,0,0,0
"1800",2012-10-01,"sbcz","transporte não regular","voo internacional",4,3,7,0,0,0,0,0,0,0
"1801",2012-10-01,"sbeg","transporte regular","voo doméstico",1318,1320,2638,118800,117333,236133,0,0,0,0
"1802",2012-10-01,"sbeg","transporte regular","voo internacional",116,120,236,9243,9467,18710,0,0,0,0
"1803",2012-10-01,"sbeg","transporte não regular","voo doméstico",884,878,1762,7589,7422,15011,0,0,0,0
"1804",2012-10-01,"sbeg","transporte não regular","voo internacional",157,154,311,616,511,1127,0,0,0,0
"1805",2012-10-01,"sbfi","transporte regular","voo doméstico",651,651,1302,73880,73542,147422,182,0,182,0
"1806",2012-10-01,"sbfi","transporte regular","voo internacional",18,18,36,2368,2300,4668,0,0,0,0
"1807",2012-10-01,"sbfi","transporte não regular","voo doméstico",160,164,324,1049,1442,2491,0,0,0,0
"1808",2012-10-01,"sbfi","transporte não regular","voo internacional",56,47,103,406,473,879,0,0,0,0
"1809",2012-10-01,"sbgo","transporte regular","voo doméstico",1452,1449,2901,121813,123101,244914,99559,192114,291673,159830
"1810",2012-10-01,"sbgo","transporte regular","voo internacional",0,0,0,0,0,0,0,0,0,0
"1811",2012-10-01,"sbgo","transporte não regular","voo doméstico",1353,1352,2705,6917,6984,13901,0,0,0,0
"1812",2012-10-01,"sbgo","transporte não regular","voo internacional",11,5,16,25,55,80,0,0,0,0
"1813",2012-10-01,"sbht","transporte regular","voo doméstico",219,216,435,6732,6332,13064,0,0,0,0
"1814",2012-10-01,"sbht","transporte regular","voo internacional",0,0,0,0,0,0,0,0,0,0
"1815",2012-10-01,"sbht","transporte não regular","voo doméstico",137,139,276,471,356,827,21593,19651,41244,10244
"1816",2012-10-01,"sbht","transporte não regular","voo internacional",0,0,0,0,0,0,0,0,0,0
"1817",2012-10-01,"sbiz","transporte regular","voo doméstico",183,183,366,14590,14470,29060,0,0,0,0
"1818",2012-10-01,"sbiz","transporte regular","voo internacional",0,0,0,0,0,0,0,0,0,0
"1819",2012-10-01,"sbiz","transporte não regular","voo doméstico",188,189,377,628,622,1250,0,0,0,0
"1820",2012-10-01,"sbiz","transporte não regular","voo internacional",0,0,0,0,0,0,0,0,0,0
"1821",2012-10-01,"sbjc","transporte regular","voo doméstico",0,0,0,0,0,0,0,0,0,0
"1822",2012-10-01,"sbjc","transporte regular","voo internacional",0,0,0,0,0,0,0,0,0,0
"1823",2012-10-01,"sbjc","transporte não regular","voo doméstico",869,865,1734,1596,1529,3125,0,0,0,0
"1824",2012-10-01,"sbjc","transporte não regular","voo internacional",0,0,0,0,0,0,0,0,0,0
"1825",2012-10-01,"sbjr","transporte regular","voo doméstico",0,0,0,0,0,0,0,0,0,0
"1826",2012-10-01,"sbjr","transporte regular","voo internacional",0,0,0,0,0,0,0,0,0,0
"1827",2012-10-01,"sbjr","transporte não regular","voo doméstico",3288,3301,6589,7928,3781,11709,0,0,0,0
"1828",2012-10-01,"sbjr","transporte não regular","voo internacional",0,0,0,0,0,0,0,0,0,0
"1829",2012-10-01,"sbjv","transporte regular","voo doméstico",281,282,563,16365,16276,32641,0,0,0,0
"1830",2012-10-01,"sbjv","transporte regular","voo internacional",0,0,0,0,0,0,0,0,0,0
"1831",2012-10-01,"sbjv","transporte não regular","voo doméstico",115,113,228,133,479,612,0,0,0,0
"1832",2012-10-01,"sbjv","transporte não regular","voo internacional",1,1,2,4,2,6,0,0,0,0
"1833",2012-10-01,"sblo","transporte regular","voo doméstico",670,669,1339,47651,47752,95403,0,0,0,0
"1834",2012-10-01,"sblo","transporte regular","voo internacional",0,0,0,0,0,0,0,0,0,0
"1835",2012-10-01,"sblo","transporte não regular","voo doméstico",761,758,1519,775,1198,1973,0,0,0,0
"1836",2012-10-01,"sblo","transporte não regular","voo internacional",2,1,3,0,0,0,0,0,0,0
"1837",2012-10-01,"sbma","transporte regular","voo doméstico",450,450,900,16180,15770,31950,0,0,0,0
"1838",2012-10-01,"sbma","transporte regular","voo internacional",0,0,0,0,0,0,0,0,0,0
"1839",2012-10-01,"sbma","transporte não regular","voo doméstico",291,289,580,436,356,792,0,0,0,0
"1840",2012-10-01,"sbma","transporte não regular","voo internacional",3,3,6,0,0,0,0,0,0,0
"1841",2012-10-01,"sbmk","transporte regular","voo doméstico",283,283,566,13413,13008,26421,0,0,0,0
"1842",2012-10-01,"sbmk","transporte regular","voo internacional",0,0,0,0,0,0,0,0,0,0
"1843",2012-10-01,"sbmk","transporte não regular","voo doméstico",212,217,429,231,208,439,0,0,0,0
"1844",2012-10-01,"sbmk","transporte não regular","voo internacional",1,1,2,0,0,0,0,0,0,0
"1845",2012-10-01,"sbmq","transporte regular","voo doméstico",266,263,529,24231,25223,49454,25600,42600,68200,0
"1846",2012-10-01,"sbmq","transporte regular","voo internacional",0,0,0,0,0,0,0,0,0,0
"1847",2012-10-01,"sbmq","transporte não regular","voo doméstico",277,278,555,693,410,1103,0,0,0,0
"1848",2012-10-01,"sbmq","transporte não regular","voo internacional",5,10,15,0,0,0,0,0,0,0
"1849",2012-10-01,"sbmt","transporte regular","voo doméstico",0,0,0,0,0,0,0,0,0,0
"1850",2012-10-01,"sbmt","transporte regular","voo internacional",0,0,0,0,0,0,0,0,0,0
"1851",2012-10-01,"sbmt","transporte não regular","voo doméstico",6210,6221,12431,18615,18473,37088,0,0,0,0
"1852",2012-10-01,"sbmt","transporte não regular","voo internacional",7,7,14,0,0,0,0,0,0,0
"1853",2012-10-01,"sbnf","transporte regular","voo doméstico",657,658,1315,55866,56898,112764,0,0,0,0
"1854",2012-10-01,"sbnf","transporte regular","voo internacional",0,0,0,0,0,0,0,0,0,0
"1855",2012-10-01,"sbnf","transporte não regular","voo doméstico",399,401,800,1695,1942,3637,0,0,0,0
"1856",2012-10-01,"sbnf","transporte não regular","voo internacional",3,3,6,0,0,0,0,0,0,0
"1857",2012-10-01,"sbpb","transporte regular","voo doméstico",0,0,0,0,0,0,0,0,0,0
"1858",2012-10-01,"sbpb","transporte regular","voo internacional",0,0,0,0,0,0,0,0,0,0
"1859",2012-10-01,"sbpb","transporte não regular","voo doméstico",57,58,115,130,122,252,0,0,0,0
"1860",2012-10-01,"sbpb","transporte não regular","voo internacional",0,0,0,0,0,0,0,0,0,0
"1861",2012-10-01,"sbpj","transporte regular","voo doméstico",272,272,544,21427,21342,42769,0,0,0,0
"1862",2012-10-01,"sbpj","transporte regular","voo internacional",0,0,0,0,0,0,0,0,0,0
"1863",2012-10-01,"sbpj","transporte não regular","voo doméstico",447,450,897,699,488,1187,24514,36969,61483,0
"1864",2012-10-01,"sbpj","transporte não regular","voo internacional",5,6,11,0,0,0,0,0,0,0
"1865",2012-10-01,"sbpk","transporte regular","voo doméstico",66,67,133,239,225,464,0,0,0,0
"1866",2012-10-01,"sbpk","transporte regular","voo internacional",0,0,0,0,0,0,0,0,0,0
"1867",2012-10-01,"sbpk","transporte não regular","voo doméstico",140,139,279,327,335,662,0,0,0,0
"1868",2012-10-01,"sbpk","transporte não regular","voo internacional",7,8,15,15,19,34,0,0,0,0
"1869",2012-10-01,"sbpl","transporte regular","voo doméstico",174,176,350,17454,16855,34309,0,0,0,0
"1870",2012-10-01,"sbpl","transporte regular","voo internacional",5,5,10,0,0,0,0,0,0,0
"1871",2012-10-01,"sbpl","transporte não regular","voo doméstico",85,83,168,99,214,313,0,0,0,0
"1872",2012-10-01,"sbpl","transporte não regular","voo internacional",3,3,6,0,0,0,0,0,0,0
"1873",2012-10-01,"sbpp","transporte regular","voo doméstico",0,0,0,0,0,0,0,0,0,0
"1874",2012-10-01,"sbpp","transporte regular","voo internacional",0,0,0,0,0,0,0,0,0,0
"1875",2012-10-01,"sbpp","transporte não regular","voo doméstico",74,74,148,120,120,240,0,0,0,0
"1876",2012-10-01,"sbpp","transporte não regular","voo internacional",9,9,18,17,16,33,0,0,0,0
"1877",2012-10-01,"sbpr","transporte regular","voo doméstico",0,0,0,0,0,0,0,0,0,0
"1878",2012-10-01,"sbpr","transporte regular","voo internacional",0,0,0,0,0,0,0,0,0,0
"1879",2012-10-01,"sbpr","transporte não regular","voo doméstico",1561,1560,3121,1640,1547,3187,0,0,0,0
"1880",2012-10-01,"sbpr","transporte não regular","voo internacional",0,0,0,0,0,0,0,0,0,0
"1881",2012-10-01,"sbpv","transporte regular","voo doméstico",622,625,1247,42171,43619,85790,267755,65224,332979,0
"1882",2012-10-01,"sbpv","transporte regular","voo internacional",0,0,0,0,0,0,0,0,0,0
"1883",2012-10-01,"sbpv","transporte não regular","voo doméstico",300,302,602,0,0,0,0,0,0,0
"1884",2012-10-01,"sbpv","transporte não regular","voo internacional",5,6,11,12,12,24,0,0,0,0
"1885",2012-10-01,"sbrb","transporte regular","voo doméstico",211,210,421,14330,14124,28454,0,0,0,0
"1886",2012-10-01,"sbrb","transporte regular","voo internacional",0,0,0,0,0,0,0,0,0,0
"1887",2012-10-01,"sbrb","transporte não regular","voo doméstico",308,304,612,927,879,1806,0,0,0,0
"1888",2012-10-01,"sbrb","transporte não regular","voo internacional",0,0,0,0,0,0,0,0,0,0
"1889",2012-10-01,"sbrj","transporte regular","voo doméstico",4538,4548,9086,410117,401678,811795,0,0,0,0
"1890",2012-10-01,"sbrj","transporte regular","voo internacional",0,0,0,0,0,0,0,0,0,0
"1891",2012-10-01,"sbrj","transporte não regular","voo doméstico",1329,1314,2643,760,420,1180,0,0,0,0
"1892",2012-10-01,"sbrj","transporte não regular","voo internacional",5,5,10,0,0,0,0,0,0,0
"1893",2012-10-01,"sbsj","transporte regular","voo doméstico",177,176,353,7961,8218,16179,0,0,0,0
"1894",2012-10-01,"sbsj","transporte regular","voo internacional",0,0,0,0,0,0,0,0,0,0
"1895",2012-10-01,"sbsj","transporte não regular","voo doméstico",631,593,1224,1918,1992,3910,0,0,0,0
"1896",2012-10-01,"sbsj","transporte não regular","voo internacional",5,17,22,57,15,72,0,0,0,0
"1897",2012-10-01,"sbsl","transporte regular","voo doméstico",719,719,1438,78266,77674,155940,0,0,0,0
"1898",2012-10-01,"sbsl","transporte regular","voo internacional",0,0,0,0,0,0,0,0,0,0
"1899",2012-10-01,"sbsl","transporte não regular","voo doméstico",514,511,1025,968,757,1725,87847,216344,304191,0
"1900",2012-10-01,"sbsl","transporte não regular","voo internacional",1,1,2,0,0,0,0,0,0,0
"1901",2012-10-01,"sbsn","transporte regular","voo doméstico",327,326,653,22425,21276,43701,0,0,0,0
"1902",2012-10-01,"sbsn","transporte regular","voo internacional",0,0,0,0,0,0,0,0,0,0
"1903",2012-10-01,"sbsn","transporte não regular","voo doméstico",384,387,771,927,706,1633,0,0,0,0
"1904",2012-10-01,"sbsn","transporte não regular","voo internacional",1,1,2,0,0,0,0,0,0,0
"1905",2012-10-01,"sbsp","transporte regular","voo doméstico",6847,6925,13772,723894,702236,1426130,0,0,0,0
"1906",2012-10-01,"sbsp","transporte regular","voo internacional",0,0,0,0,0,0,0,0,0,0
"1907",2012-10-01,"sbsp","transporte não regular","voo doméstico",2333,2264,4597,11793,14025,25818,0,0,0,0
"1908",2012-10-01,"sbsp","transporte não regular","voo internacional",25,22,47,0,0,0,0,0,0,0
"1909",2012-10-01,"sbte","transporte regular","voo doméstico",436,433,869,43012,41588,84600,28092,98440,126532,253056
"1910",2012-10-01,"sbte","transporte regular","voo internacional",0,0,0,0,0,0,0,0,0,0
"1911",2012-10-01,"sbte","transporte não regular","voo doméstico",231,228,459,1104,1116,2220,0,0,0,0
"1912",2012-10-01,"sbte","transporte não regular","voo internacional",2,2,4,0,0,0,0,0,0,0
"1913",2012-10-01,"sbtf","transporte regular","voo doméstico",75,75,150,1753,1858,3611,0,0,0,0
"1914",2012-10-01,"sbtf","transporte regular","voo internacional",0,0,0,0,0,0,0,0,0,0
"1915",2012-10-01,"sbtf","transporte não regular","voo doméstico",342,341,683,861,793,1654,2976,4802,7778,11856
"1916",2012-10-01,"sbtf","transporte não regular","voo internacional",0,0,0,0,0,0,0,0,0,0
"1917",2012-10-01,"sbtt","transporte regular","voo doméstico",61,61,122,2184,2364,4548,0,0,0,0
"1918",2012-10-01,"sbtt","transporte regular","voo internacional",0,0,0,0,0,0,0,0,0,0
"1919",2012-10-01,"sbtt","transporte não regular","voo doméstico",54,54,108,238,247,485,1850,3529,5379,547
"1920",2012-10-01,"sbtt","transporte não regular","voo internacional",2,2,4,2,6,8,0,0,0,0
"1921",2012-10-01,"sbuf","transporte regular","voo doméstico",0,0,0,0,0,0,0,0,0,0
"1922",2012-10-01,"sbuf","transporte regular","voo internacional",0,0,0,0,0,0,0,0,0,0
"1923",2012-10-01,"sbuf","transporte não regular","voo doméstico",33,33,66,70,76,146,0,0,0,0
"1924",2012-10-01,"sbuf","transporte não regular","voo internacional",0,0,0,0,0,0,0,0,0,0
"1925",2012-10-01,"sbug","transporte regular","voo doméstico",21,21,42,135,131,266,0,0,0,0
"1926",2012-10-01,"sbug","transporte regular","voo internacional",0,0,0,0,0,0,0,0,0,0
"1927",2012-10-01,"sbug","transporte não regular","voo doméstico",15,18,33,19,37,56,0,0,0,0
"1928",2012-10-01,"sbug","transporte não regular","voo internacional",4,0,4,0,0,0,0,0,0,0
"1929",2012-10-01,"sbul","transporte regular","voo doméstico",568,567,1135,41510,41605,83115,0,0,0,0
"1930",2012-10-01,"sbul","transporte regular","voo internacional",0,0,0,0,0,0,0,0,0,0
"1931",2012-10-01,"sbul","transporte não regular","voo doméstico",631,629,1260,2828,2535,5363,0,0,0,0
"1932",2012-10-01,"sbul","transporte não regular","voo internacional",2,2,4,7,7,14,0,0,0,0
"1933",2012-10-01,"sbur","transporte regular","voo doméstico",149,148,297,5230,5451,10681,0,0,0,0
"1934",2012-10-01,"sbur","transporte regular","voo internacional",0,0,0,0,0,0,0,0,0,0
"1935",2012-10-01,"sbur","transporte não regular","voo doméstico",212,215,427,824,767,1591,0,0,0,0
"1936",2012-10-01,"sbur","transporte não regular","voo internacional",1,1,2,0,0,0,0,0,0,0
"1937",2012-09-01,"sbbe","transporte regular","voo doméstico",1592,1617,3209,140340,135997,276337,92287,347103,439390,0
"1938",2012-09-01,"sbbe","transporte regular","voo internacional",20,20,40,1686,1908,3594,0,40,40,0
"1939",2012-09-01,"sbbe","transporte não regular","voo doméstico",619,585,1204,2093,5495,7588,0,0,0,0
"1940",2012-09-01,"sbbe","transporte não regular","voo internacional",14,17,31,52,32,84,0,0,0,0
"1941",2012-09-01,"sbbg","transporte regular","voo doméstico",0,0,0,0,0,0,0,0,0,0
"1942",2012-09-01,"sbbg","transporte regular","voo internacional",0,0,0,0,0,0,0,0,0,0
"1943",2012-09-01,"sbbg","transporte não regular","voo doméstico",3,3,6,25,19,44,0,0,0,0
"1944",2012-09-01,"sbbg","transporte não regular","voo internacional",1,1,2,4,4,8,0,0,0,0
"1945",2012-09-01,"sbbh","transporte regular","voo doméstico",619,621,1240,19289,20113,39402,0,0,0,0
"1946",2012-09-01,"sbbh","transporte regular","voo internacional",0,0,0,0,0,0,0,0,0,0
"1947",2012-09-01,"sbbh","transporte não regular","voo doméstico",2794,2797,5591,11250,11079,22329,0,0,0,0
"1948",2012-09-01,"sbbh","transporte não regular","voo internacional",13,11,24,67,77,144,0,0,0,0
"1949",2012-09-01,"sbbi","transporte regular","voo doméstico",0,0,0,0,0,0,0,0,0,0
"1950",2012-09-01,"sbbi","transporte regular","voo internacional",0,0,0,0,0,0,0,0,0,0
"1951",2012-09-01,"sbbi","transporte não regular","voo doméstico",1382,1371,2753,4280,4884,9164,0,0,0,0
"1952",2012-09-01,"sbbi","transporte não regular","voo internacional",3,1,4,0,0,0,0,0,0,0
"1953",2012-09-01,"sbbv","transporte regular","voo doméstico",89,89,178,12217,14295,26512,0,0,0,0
"1954",2012-09-01,"sbbv","transporte regular","voo internacional",0,0,0,0,0,0,0,0,0,0
"1955",2012-09-01,"sbbv","transporte não regular","voo doméstico",415,407,822,948,436,1384,0,0,0,0
"1956",2012-09-01,"sbbv","transporte não regular","voo internacional",41,30,71,6,7,13,0,0,0,0
"1957",2012-09-01,"sbcg","transporte regular","voo doméstico",839,837,1676,69497,70421,139918,62605,145835,208440,0
"1958",2012-09-01,"sbcg","transporte regular","voo internacional",1,1,2,0,0,0,0,0,0,0
"1959",2012-09-01,"sbcg","transporte não regular","voo doméstico",385,388,773,585,280,865,0,0,0,0
"1960",2012-09-01,"sbcg","transporte não regular","voo internacional",11,10,21,0,0,0,0,0,0,0
"1961",2012-09-01,"sbcj","transporte regular","voo doméstico",173,164,337,4674,4940,9614,0,0,0,0
"1962",2012-09-01,"sbcj","transporte regular","voo internacional",1,1,2,0,0,0,0,0,0,0
"1963",2012-09-01,"sbcj","transporte não regular","voo doméstico",92,100,192,1796,1525,3321,0,0,0,0
"1964",2012-09-01,"sbcj","transporte não regular","voo internacional",0,0,0,0,0,0,0,0,0,0
"1965",2012-09-01,"sbcr","transporte regular","voo doméstico",30,30,60,1328,1355,2683,0,0,0,0
"1966",2012-09-01,"sbcr","transporte regular","voo internacional",0,0,0,0,0,0,0,0,0,0
"1967",2012-09-01,"sbcr","transporte não regular","voo doméstico",60,57,117,180,182,362,0,0,0,0
"1968",2012-09-01,"sbcr","transporte não regular","voo internacional",0,1,1,8,0,8,0,0,0,0
"1969",2012-09-01,"sbct","transporte regular","voo doméstico",3136,3148,6284,283526,274178,557704,173704,112815,286519,296020
"1970",2012-09-01,"sbct","transporte regular","voo internacional",98,97,195,2863,1934,4797,0,0,0,0
"1971",2012-09-01,"sbct","transporte não regular","voo doméstico",378,360,738,1572,2032,3604,0,0,0,0
"1972",2012-09-01,"sbct","transporte não regular","voo internacional",17,17,34,20,26,46,0,0,0,0
"1973",2012-09-01,"sbcz","transporte regular","voo doméstico",30,30,60,2416,2406,4822,0,0,0,0
"1974",2012-09-01,"sbcz","transporte regular","voo internacional",0,0,0,0,0,0,0,0,0,0
"1975",2012-09-01,"sbcz","transporte não regular","voo doméstico",249,252,501,1084,1002,2086,0,0,0,0
"1976",2012-09-01,"sbcz","transporte não regular","voo internacional",2,2,4,0,0,0,0,0,0,0
"1977",2012-09-01,"sbeg","transporte regular","voo doméstico",1257,1242,2499,118514,117706,236220,0,0,0,0
"1978",2012-09-01,"sbeg","transporte regular","voo internacional",115,114,229,8863,8947,17810,0,0,0,0
"1979",2012-09-01,"sbeg","transporte não regular","voo doméstico",770,788,1558,6822,4875,11697,0,0,0,0
"1980",2012-09-01,"sbeg","transporte não regular","voo internacional",185,174,359,123,117,240,0,0,0,0
"1981",2012-09-01,"sbfi","transporte regular","voo doméstico",604,604,1208,70530,70471,141001,0,0,0,0
"1982",2012-09-01,"sbfi","transporte regular","voo internacional",17,17,34,2141,1965,4106,0,0,0,0
"1983",2012-09-01,"sbfi","transporte não regular","voo doméstico",156,155,311,841,497,1338,0,0,0,0
"1984",2012-09-01,"sbfi","transporte não regular","voo internacional",55,61,116,565,599,1164,0,0,0,0
"1985",2012-09-01,"sbgo","transporte regular","voo doméstico",1490,1495,2985,128301,126232,254533,85028,177280,262308,161156
"1986",2012-09-01,"sbgo","transporte regular","voo internacional",0,0,0,0,0,0,0,0,0,0
"1987",2012-09-01,"sbgo","transporte não regular","voo doméstico",1432,1419,2851,7303,7277,14580,0,0,0,0
"1988",2012-09-01,"sbgo","transporte não regular","voo internacional",6,6,12,73,73,146,0,0,0,0
"1989",2012-09-01,"sbht","transporte regular","voo doméstico",206,207,413,5956,6423,12379,0,0,0,0
"1990",2012-09-01,"sbht","transporte regular","voo internacional",0,0,0,0,0,0,0,0,0,0
"1991",2012-09-01,"sbht","transporte não regular","voo doméstico",106,107,213,234,213,447,9700,19284,28984,12046
"1992",2012-09-01,"sbht","transporte não regular","voo internacional",0,0,0,0,0,0,0,0,0,0
"1993",2012-09-01,"sbiz","transporte regular","voo doméstico",177,178,355,13948,13828,27776,0,0,0,0
"1994",2012-09-01,"sbiz","transporte regular","voo internacional",0,0,0,0,0,0,0,0,0,0
"1995",2012-09-01,"sbiz","transporte não regular","voo doméstico",185,184,369,499,547,1046,0,0,0,0
"1996",2012-09-01,"sbiz","transporte não regular","voo internacional",1,1,2,0,0,0,0,0,0,0
"1997",2012-09-01,"sbjc","transporte regular","voo doméstico",0,0,0,0,0,0,0,0,0,0
"1998",2012-09-01,"sbjc","transporte regular","voo internacional",0,0,0,0,0,0,0,0,0,0
"1999",2012-09-01,"sbjc","transporte não regular","voo doméstico",884,877,1761,1600,1464,3064,0,0,0,0
"2000",2012-09-01,"sbjc","transporte não regular","voo internacional",1,0,1,0,0,0,0,0,0,0
"2001",2012-09-01,"sbjr","transporte regular","voo doméstico",0,0,0,0,0,0,0,0,0,0
"2002",2012-09-01,"sbjr","transporte regular","voo internacional",0,0,0,0,0,0,0,0,0,0
"2003",2012-09-01,"sbjr","transporte não regular","voo doméstico",3210,3212,6422,8376,3895,12271,0,0,0,0
"2004",2012-09-01,"sbjr","transporte não regular","voo internacional",0,0,0,0,0,0,0,0,0,0
"2005",2012-09-01,"sbjv","transporte regular","voo doméstico",275,275,550,16105,15913,32018,0,0,0,0
"2006",2012-09-01,"sbjv","transporte regular","voo internacional",0,0,0,0,0,0,0,0,0,0
"2007",2012-09-01,"sbjv","transporte não regular","voo doméstico",127,128,255,130,379,509,0,0,0,0
"2008",2012-09-01,"sbjv","transporte não regular","voo internacional",0,0,0,0,0,0,0,0,0,0
"2009",2012-09-01,"sblo","transporte regular","voo doméstico",630,632,1262,48752,47478,96230,0,0,0,0
"2010",2012-09-01,"sblo","transporte regular","voo internacional",0,0,0,0,0,0,0,0,0,0
"2011",2012-09-01,"sblo","transporte não regular","voo doméstico",862,864,1726,463,1011,1474,0,0,0,0
"2012",2012-09-01,"sblo","transporte não regular","voo internacional",1,3,4,0,0,0,0,0,0,0
"2013",2012-09-01,"sbma","transporte regular","voo doméstico",400,397,797,16149,15180,31329,0,0,0,0
"2014",2012-09-01,"sbma","transporte regular","voo internacional",0,0,0,0,0,0,0,0,0,0
"2015",2012-09-01,"sbma","transporte não regular","voo doméstico",279,281,560,529,473,1002,0,0,0,0
"2016",2012-09-01,"sbma","transporte não regular","voo internacional",5,5,10,0,0,0,0,0,0,0
"2017",2012-09-01,"sbmk","transporte regular","voo doméstico",290,290,580,14263,13621,27884,0,0,0,0
"2018",2012-09-01,"sbmk","transporte regular","voo internacional",0,0,0,0,0,0,0,0,0,0
"2019",2012-09-01,"sbmk","transporte não regular","voo doméstico",229,224,453,87,151,238,0,0,0,0
"2020",2012-09-01,"sbmk","transporte não regular","voo internacional",0,0,0,0,0,0,0,0,0,0
"2021",2012-09-01,"sbmq","transporte regular","voo doméstico",213,211,424,23474,25491,48965,22578,34850,57428,0
"2022",2012-09-01,"sbmq","transporte regular","voo internacional",0,0,0,0,0,0,0,0,0,0
"2023",2012-09-01,"sbmq","transporte não regular","voo doméstico",312,315,627,624,299,923,0,0,0,0
"2024",2012-09-01,"sbmq","transporte não regular","voo internacional",19,15,34,0,0,0,0,0,0,0
"2025",2012-09-01,"sbmt","transporte regular","voo doméstico",0,0,0,0,0,0,0,0,0,0
"2026",2012-09-01,"sbmt","transporte regular","voo internacional",0,0,0,0,0,0,0,0,0,0
"2027",2012-09-01,"sbmt","transporte não regular","voo doméstico",5792,5768,11560,17246,17265,34511,0,0,0,0
"2028",2012-09-01,"sbmt","transporte não regular","voo internacional",1,1,2,0,0,0,0,0,0,0
"2029",2012-09-01,"sbnf","transporte regular","voo doméstico",654,656,1310,52489,51508,103997,0,0,0,0
"2030",2012-09-01,"sbnf","transporte regular","voo internacional",0,0,0,0,0,0,0,0,0,0
"2031",2012-09-01,"sbnf","transporte não regular","voo doméstico",375,381,756,1261,1719,2980,0,0,0,0
"2032",2012-09-01,"sbnf","transporte não regular","voo internacional",4,4,8,0,0,0,0,0,0,0
"2033",2012-09-01,"sbpb","transporte regular","voo doméstico",0,0,0,0,0,0,0,0,0,0
"2034",2012-09-01,"sbpb","transporte regular","voo internacional",0,0,0,0,0,0,0,0,0,0
"2035",2012-09-01,"sbpb","transporte não regular","voo doméstico",61,60,121,116,114,230,0,0,0,0
"2036",2012-09-01,"sbpb","transporte não regular","voo internacional",0,0,0,0,0,0,0,0,0,0
"2037",2012-09-01,"sbpj","transporte regular","voo doméstico",252,253,505,22147,21402,43549,0,0,0,0
"2038",2012-09-01,"sbpj","transporte regular","voo internacional",0,0,0,0,0,0,0,0,0,0
"2039",2012-09-01,"sbpj","transporte não regular","voo doméstico",488,492,980,982,713,1695,22980,35690,58670,0
"2040",2012-09-01,"sbpj","transporte não regular","voo internacional",12,11,23,0,0,0,0,0,0,0
"2041",2012-09-01,"sbpk","transporte regular","voo doméstico",53,53,106,124,115,239,0,0,0,0
"2042",2012-09-01,"sbpk","transporte regular","voo internacional",0,0,0,0,0,0,0,0,0,0
"2043",2012-09-01,"sbpk","transporte não regular","voo doméstico",58,57,115,164,212,376,0,0,0,0
"2044",2012-09-01,"sbpk","transporte não regular","voo internacional",1,3,4,1,2,3,0,0,0,0
"2045",2012-09-01,"sbpl","transporte regular","voo doméstico",168,168,336,17699,18009,35708,0,0,0,0
"2046",2012-09-01,"sbpl","transporte regular","voo internacional",4,4,8,0,0,0,0,0,0,0
"2047",2012-09-01,"sbpl","transporte não regular","voo doméstico",82,82,164,73,68,141,0,0,0,0
"2048",2012-09-01,"sbpl","transporte não regular","voo internacional",0,0,0,0,0,0,0,0,0,0
"2049",2012-09-01,"sbpp","transporte regular","voo doméstico",0,0,0,0,0,0,0,0,0,0
"2050",2012-09-01,"sbpp","transporte regular","voo internacional",0,0,0,0,0,0,0,0,0,0
"2051",2012-09-01,"sbpp","transporte não regular","voo doméstico",96,100,196,204,208,412,0,0,0,0
"2052",2012-09-01,"sbpp","transporte não regular","voo internacional",8,3,11,7,21,28,0,0,0,0
"2053",2012-09-01,"sbpr","transporte regular","voo doméstico",0,0,0,0,0,0,0,0,0,0
"2054",2012-09-01,"sbpr","transporte regular","voo internacional",0,0,0,0,0,0,0,0,0,0
"2055",2012-09-01,"sbpr","transporte não regular","voo doméstico",1724,1716,3440,1807,1754,3561,0,0,0,0
"2056",2012-09-01,"sbpr","transporte não regular","voo internacional",0,0,0,0,0,0,0,0,0,0
"2057",2012-09-01,"sbpv","transporte regular","voo doméstico",589,589,1178,42175,41024,83199,54343,225325,279668,0
"2058",2012-09-01,"sbpv","transporte regular","voo internacional",0,0,0,0,0,0,0,0,0,0
"2059",2012-09-01,"sbpv","transporte não regular","voo doméstico",247,275,522,0,0,0,0,0,0,0
"2060",2012-09-01,"sbpv","transporte não regular","voo internacional",16,16,32,0,0,0,0,0,0,0
"2061",2012-09-01,"sbrb","transporte regular","voo doméstico",198,199,397,15106,15255,30361,0,0,0,0
"2062",2012-09-01,"sbrb","transporte regular","voo internacional",0,0,0,0,0,0,0,0,0,0
"2063",2012-09-01,"sbrb","transporte não regular","voo doméstico",273,278,551,1055,657,1712,0,0,0,0
"2064",2012-09-01,"sbrb","transporte não regular","voo internacional",3,3,6,0,0,0,0,0,0,0
"2065",2012-09-01,"sbrj","transporte regular","voo doméstico",4292,4326,8618,404961,395414,800375,0,0,0,0
"2066",2012-09-01,"sbrj","transporte regular","voo internacional",0,0,0,0,0,0,0,0,0,0
"2067",2012-09-01,"sbrj","transporte não regular","voo doméstico",1210,1186,2396,230,161,391,0,0,0,0
"2068",2012-09-01,"sbrj","transporte não regular","voo internacional",1,1,2,0,0,0,0,0,0,0
"2069",2012-09-01,"sbsj","transporte regular","voo doméstico",145,145,290,7084,6932,14016,0,0,0,0
"2070",2012-09-01,"sbsj","transporte regular","voo internacional",0,0,0,0,0,0,0,0,0,0
"2071",2012-09-01,"sbsj","transporte não regular","voo doméstico",558,556,1114,1903,1906,3809,0,0,0,0
"2072",2012-09-01,"sbsj","transporte não regular","voo internacional",3,17,20,56,5,61,0,0,0,0
"2073",2012-09-01,"sbsl","transporte regular","voo doméstico",777,778,1555,79794,81976,161770,0,0,0,0
"2074",2012-09-01,"sbsl","transporte regular","voo internacional",0,0,0,0,0,0,0,0,0,0
"2075",2012-09-01,"sbsl","transporte não regular","voo doméstico",556,552,1108,1206,867,2073,55315,170210,225525,0
"2076",2012-09-01,"sbsl","transporte não regular","voo internacional",1,1,2,0,0,0,0,0,0,0
"2077",2012-09-01,"sbsn","transporte regular","voo doméstico",332,332,664,21403,20695,42098,0,0,0,0
"2078",2012-09-01,"sbsn","transporte regular","voo internacional",0,0,0,0,0,0,0,0,0,0
"2079",2012-09-01,"sbsn","transporte não regular","voo doméstico",445,443,888,878,679,1557,0,0,0,0
"2080",2012-09-01,"sbsn","transporte não regular","voo internacional",0,0,0,0,0,0,0,0,0,0
"2081",2012-09-01,"sbsp","transporte regular","voo doméstico",6494,6556,13050,701081,682673,1383754,0,0,0,0
"2082",2012-09-01,"sbsp","transporte regular","voo internacional",0,0,0,0,0,0,0,0,0,0
"2083",2012-09-01,"sbsp","transporte não regular","voo doméstico",2354,2272,4626,12531,11946,24477,0,0,0,0
"2084",2012-09-01,"sbsp","transporte não regular","voo internacional",8,10,18,0,0,0,0,0,0,0
"2085",2012-09-01,"sbte","transporte regular","voo doméstico",420,419,839,40786,44177,84963,21659,85685,107344,237209
"2086",2012-09-01,"sbte","transporte regular","voo internacional",0,0,0,0,0,0,0,0,0,0
"2087",2012-09-01,"sbte","transporte não regular","voo doméstico",303,309,612,1530,1478,3008,0,0,0,0
"2088",2012-09-01,"sbte","transporte não regular","voo internacional",1,1,2,0,0,0,0,0,0,0
"2089",2012-09-01,"sbtf","transporte regular","voo doméstico",71,72,143,1362,1615,2977,0,0,0,0
"2090",2012-09-01,"sbtf","transporte regular","voo internacional",0,0,0,0,0,0,0,0,0,0
"2091",2012-09-01,"sbtf","transporte não regular","voo doméstico",337,336,673,1009,1025,2034,2252,3716,5968,9530
"2092",2012-09-01,"sbtf","transporte não regular","voo internacional",0,0,0,0,0,0,0,0,0,0
"2093",2012-09-01,"sbtt","transporte regular","voo doméstico",55,55,110,1619,2060,3679,0,0,0,0
"2094",2012-09-01,"sbtt","transporte regular","voo internacional",0,0,0,0,0,0,0,0,0,0
"2095",2012-09-01,"sbtt","transporte não regular","voo doméstico",38,37,75,170,182,352,1706,3223,4929,588
"2096",2012-09-01,"sbtt","transporte não regular","voo internacional",1,1,2,4,7,11,0,0,0,0
"2097",2012-09-01,"sbuf","transporte regular","voo doméstico",0,0,0,0,0,0,0,0,0,0
"2098",2012-09-01,"sbuf","transporte regular","voo internacional",0,0,0,0,0,0,0,0,0,0
"2099",2012-09-01,"sbuf","transporte não regular","voo doméstico",63,63,126,180,172,352,0,0,0,0
"2100",2012-09-01,"sbuf","transporte não regular","voo internacional",0,0,0,0,0,0,0,0,0,0
"2101",2012-09-01,"sbug","transporte regular","voo doméstico",17,17,34,71,61,132,0,0,0,0
"2102",2012-09-01,"sbug","transporte regular","voo internacional",0,0,0,0,0,0,0,0,0,0
"2103",2012-09-01,"sbug","transporte não regular","voo doméstico",15,15,30,48,33,81,0,0,0,0
"2104",2012-09-01,"sbug","transporte não regular","voo internacional",0,0,0,0,0,0,0,0,0,0
"2105",2012-09-01,"sbul","transporte regular","voo doméstico",616,619,1235,42426,43102,85528,0,0,0,0
"2106",2012-09-01,"sbul","transporte regular","voo internacional",0,0,0,0,0,0,0,0,0,0
"2107",2012-09-01,"sbul","transporte não regular","voo doméstico",639,630,1269,1740,1784,3524,0,0,0,0
"2108",2012-09-01,"sbul","transporte não regular","voo internacional",3,3,6,14,14,28,0,0,0,0
"2109",2012-09-01,"sbur","transporte regular","voo doméstico",191,191,382,6475,6390,12865,0,0,0,0
"2110",2012-09-01,"sbur","transporte regular","voo internacional",0,0,0,0,0,0,0,0,0,0
"2111",2012-09-01,"sbur","transporte não regular","voo doméstico",233,238,471,1225,1053,2278,0,0,0,0
"2112",2012-09-01,"sbur","transporte não regular","voo internacional",1,1,2,0,0,0,0,0,0,0
"2113",2013-04-01,"sbbe","transporte regular","voo doméstico",1641,1644,3285,131140,128963,260103,0,0,0,0
"2114",2013-04-01,"sbbe","transporte regular","voo internacional",17,17,34,2019,1568,3587,0,9,9,0
"2115",2013-04-01,"sbbe","transporte não regular","voo doméstico",518,517,1035,2373,2578,4951,113044,395703,508747,0
"2116",2013-04-01,"sbbe","transporte não regular","voo internacional",7,10,17,28,8,36,0,0,0,0
"2117",2013-04-01,"sbbg","transporte regular","voo doméstico",0,0,0,0,0,0,0,0,0,0
"2118",2013-04-01,"sbbg","transporte regular","voo internacional",0,0,0,0,0,0,0,0,0,0
"2119",2013-04-01,"sbbg","transporte não regular","voo doméstico",10,10,20,66,41,107,0,0,0,0
"2120",2013-04-01,"sbbg","transporte não regular","voo internacional",0,0,0,0,0,0,0,0,0,0
"2121",2013-04-01,"sbbh","transporte regular","voo doméstico",767,778,1545,31541,35906,67447,0,0,0,0
"2122",2013-04-01,"sbbh","transporte regular","voo internacional",0,0,0,0,0,0,0,0,0,0
"2123",2013-04-01,"sbbh","transporte não regular","voo doméstico",2201,2191,4392,9724,9885,19609,0,0,0,0
"2124",2013-04-01,"sbbh","transporte não regular","voo internacional",6,5,11,25,25,50,0,0,0,0
"2125",2013-04-01,"sbbi","transporte regular","voo doméstico",0,0,0,0,0,0,0,0,0,0
"2126",2013-04-01,"sbbi","transporte regular","voo internacional",0,0,0,0,0,0,0,0,0,0
"2127",2013-04-01,"sbbi","transporte não regular","voo doméstico",1275,1270,2545,2053,2939,4992,0,0,0,0
"2128",2013-04-01,"sbbi","transporte não regular","voo internacional",0,0,0,0,0,0,0,0,0,0
"2129",2013-04-01,"sbbv","transporte regular","voo doméstico",134,134,268,15050,14103,29153,0,0,0,0
"2130",2013-04-01,"sbbv","transporte regular","voo internacional",0,0,0,0,0,0,0,0,0,0
"2131",2013-04-01,"sbbv","transporte não regular","voo doméstico",168,168,336,393,157,550,0,0,0,0
"2132",2013-04-01,"sbbv","transporte não regular","voo internacional",30,29,59,10,9,19,0,0,0,0
"2133",2013-04-01,"sbcg","transporte regular","voo doméstico",749,755,1504,65767,63836,129603,26116,70802,96918,0
"2134",2013-04-01,"sbcg","transporte regular","voo internacional",0,0,0,0,0,0,0,0,0,0
"2135",2013-04-01,"sbcg","transporte não regular","voo doméstico",332,336,668,186,436,622,18434,40414,58848,0
"2136",2013-04-01,"sbcg","transporte não regular","voo internacional",13,12,25,0,0,0,0,0,0,0
"2137",2013-04-01,"sbcj","transporte regular","voo doméstico",108,108,216,3524,3862,7386,0,0,0,0
"2138",2013-04-01,"sbcj","transporte regular","voo internacional",0,0,0,0,0,0,0,0,0,0
"2139",2013-04-01,"sbcj","transporte não regular","voo doméstico",110,110,220,985,1311,2296,0,0,0,0
"2140",2013-04-01,"sbcj","transporte não regular","voo internacional",3,3,6,0,0,0,0,0,0,0
"2141",2013-04-01,"sbcr","transporte regular","voo doméstico",27,27,54,1221,1352,2573,0,0,0,0
"2142",2013-04-01,"sbcr","transporte regular","voo internacional",0,0,0,0,0,0,0,0,0,0
"2143",2013-04-01,"sbcr","transporte não regular","voo doméstico",31,30,61,70,71,141,0,0,0,0
"2144",2013-04-01,"sbcr","transporte não regular","voo internacional",6,6,12,8,3,11,0,0,0,0
"2145",2013-04-01,"sbct","transporte regular","voo doméstico",2958,2967,5925,265320,252844,518164,184848,109155,294003,356052
"2146",2013-04-01,"sbct","transporte regular","voo internacional",94,93,187,2291,1620,3911,0,0,0,0
"2147",2013-04-01,"sbct","transporte não regular","voo doméstico",591,586,1177,11775,14146,25921,0,0,0,0
"2148",2013-04-01,"sbct","transporte não regular","voo internacional",14,15,29,38,23,61,0,0,0,0
"2149",2013-04-01,"sbcz","transporte regular","voo doméstico",30,30,60,2982,2895,5877,0,0,0,0
"2150",2013-04-01,"sbcz","transporte regular","voo internacional",0,0,0,0,0,0,0,0,0,0
"2151",2013-04-01,"sbcz","transporte não regular","voo doméstico",164,164,328,678,636,1314,0,0,0,0
"2152",2013-04-01,"sbcz","transporte não regular","voo internacional",0,0,0,0,0,0,0,0,0,0
"2153",2013-04-01,"sbeg","transporte regular","voo doméstico",1247,1252,2499,108148,105172,213320,0,0,0,0
"2154",2013-04-01,"sbeg","transporte regular","voo internacional",116,120,236,8069,7848,15917,0,0,0,0
"2155",2013-04-01,"sbeg","transporte não regular","voo doméstico",690,674,1364,5959,6733,12692,0,0,0,0
"2156",2013-04-01,"sbeg","transporte não regular","voo internacional",148,151,299,4,4,8,0,0,0,0
"2157",2013-04-01,"sbfi","transporte regular","voo doméstico",580,579,1159,64041,65899,129940,0,194,194,0
"2158",2013-04-01,"sbfi","transporte regular","voo internacional",17,17,34,2352,2311,4663,0,0,0,0
"2159",2013-04-01,"sbfi","transporte não regular","voo doméstico",199,198,397,2112,2027,4139,0,0,0,0
"2160",2013-04-01,"sbfi","transporte não regular","voo internacional",61,60,121,403,562,965,0,0,0,0
"2161",2013-04-01,"sbgo","transporte regular","voo doméstico",1162,1162,2324,105776,107729,213505,8208,128642,136850,0
"2162",2013-04-01,"sbgo","transporte regular","voo internacional",0,0,0,0,0,0,0,0,0,0
"2163",2013-04-01,"sbgo","transporte não regular","voo doméstico",1250,1253,2503,6205,6185,12390,0,0,0,0
"2164",2013-04-01,"sbgo","transporte não regular","voo internacional",7,5,12,25,35,60,0,0,0,0
"2165",2013-04-01,"sbht","transporte regular","voo doméstico",165,167,332,7674,7681,15355,0,290,290,0
"2166",2013-04-01,"sbht","transporte regular","voo internacional",0,0,0,0,0,0,0,0,0,0
"2167",2013-04-01,"sbht","transporte não regular","voo doméstico",173,170,343,334,352,686,8110,18788,26898,11874
"2168",2013-04-01,"sbht","transporte não regular","voo internacional",2,2,4,0,0,0,0,0,0,0
"2169",2013-04-01,"sbiz","transporte regular","voo doméstico",180,180,360,12362,12509,24871,0,0,0,0
"2170",2013-04-01,"sbiz","transporte regular","voo internacional",0,0,0,0,0,0,0,0,0,0
"2171",2013-04-01,"sbiz","transporte não regular","voo doméstico",184,191,375,1177,1270,2447,0,0,0,0
"2172",2013-04-01,"sbiz","transporte não regular","voo internacional",0,0,0,0,0,0,0,0,0,0
"2173",2013-04-01,"sbjc","transporte regular","voo doméstico",0,0,0,0,0,0,0,0,0,0
"2174",2013-04-01,"sbjc","transporte regular","voo internacional",0,0,0,0,0,0,0,0,0,0
"2175",2013-04-01,"sbjc","transporte não regular","voo doméstico",602,610,1212,1377,1129,2506,0,0,0,0
"2176",2013-04-01,"sbjc","transporte não regular","voo internacional",2,0,2,0,0,0,0,0,0,0
"2177",2013-04-01,"sbjr","transporte regular","voo doméstico",0,0,0,0,0,0,0,0,0,0
"2178",2013-04-01,"sbjr","transporte regular","voo internacional",0,0,0,0,0,0,0,0,0,0
"2179",2013-04-01,"sbjr","transporte não regular","voo doméstico",3482,3474,6956,9480,4305,13785,0,0,0,0
"2180",2013-04-01,"sbjr","transporte não regular","voo internacional",0,0,0,0,0,0,0,0,0,0
"2181",2013-04-01,"sbjv","transporte regular","voo doméstico",189,191,380,14949,14474,29423,0,0,0,0
"2182",2013-04-01,"sbjv","transporte regular","voo internacional",0,0,0,0,0,0,0,0,0,0
"2183",2013-04-01,"sbjv","transporte não regular","voo doméstico",262,261,523,135,273,408,0,0,0,0
"2184",2013-04-01,"sbjv","transporte não regular","voo internacional",0,0,0,0,0,0,0,0,0,0
"2185",2013-04-01,"sblo","transporte regular","voo doméstico",533,534,1067,41136,39112,80248,0,0,0,0
"2186",2013-04-01,"sblo","transporte regular","voo internacional",0,0,0,0,0,0,0,0,0,0
"2187",2013-04-01,"sblo","transporte não regular","voo doméstico",985,977,1962,295,748,1043,0,0,0,0
"2188",2013-04-01,"sblo","transporte não regular","voo internacional",1,2,3,0,0,0,0,0,0,0
"2189",2013-04-01,"sbma","transporte regular","voo doméstico",457,457,914,19398,19774,39172,0,0,0,0
"2190",2013-04-01,"sbma","transporte regular","voo internacional",0,0,0,0,0,0,0,0,0,0
"2191",2013-04-01,"sbma","transporte não regular","voo doméstico",252,251,503,809,809,1618,0,0,0,0
"2192",2013-04-01,"sbma","transporte não regular","voo internacional",3,3,6,0,0,0,0,0,0,0
"2193",2013-04-01,"sbmk","transporte regular","voo doméstico",207,206,413,13434,13015,26449,0,0,0,0
"2194",2013-04-01,"sbmk","transporte regular","voo internacional",0,0,0,0,0,0,0,0,0,0
"2195",2013-04-01,"sbmk","transporte não regular","voo doméstico",205,205,410,90,103,193,0,0,0,0
"2196",2013-04-01,"sbmk","transporte não regular","voo internacional",0,0,0,0,0,0,0,0,0,0
"2197",2013-04-01,"sbmq","transporte regular","voo doméstico",353,351,704,25772,26761,52533,9600,19400,29000,0
"2198",2013-04-01,"sbmq","transporte regular","voo internacional",0,0,0,0,0,0,0,0,0,0
"2199",2013-04-01,"sbmq","transporte não regular","voo doméstico",267,280,547,522,185,707,0,0,0,0
"2200",2013-04-01,"sbmq","transporte não regular","voo internacional",23,12,35,0,0,0,0,0,0,0
"2201",2013-04-01,"sbmt","transporte regular","voo doméstico",0,0,0,0,0,0,0,0,0,0
"2202",2013-04-01,"sbmt","transporte regular","voo internacional",0,0,0,0,0,0,0,0,0,0
"2203",2013-04-01,"sbmt","transporte não regular","voo doméstico",6017,6018,12035,11996,12038,24034,0,0,0,0
"2204",2013-04-01,"sbmt","transporte não regular","voo internacional",3,3,6,0,6,6,0,0,0,0
"2205",2013-04-01,"sbnf","transporte regular","voo doméstico",541,540,1081,48169,47792,95961,0,0,0,0
"2206",2013-04-01,"sbnf","transporte regular","voo internacional",0,0,0,0,0,0,0,0,0,0
"2207",2013-04-01,"sbnf","transporte não regular","voo doméstico",510,505,1015,1755,1789,3544,0,0,0,0
"2208",2013-04-01,"sbnf","transporte não regular","voo internacional",3,4,7,0,0,0,0,0,0,0
"2209",2013-04-01,"sbpb","transporte regular","voo doméstico",0,0,0,0,0,0,0,0,0,0
"2210",2013-04-01,"sbpb","transporte regular","voo internacional",0,0,0,0,0,0,0,0,0,0
"2211",2013-04-01,"sbpb","transporte não regular","voo doméstico",32,30,62,56,79,135,0,0,0,0
"2212",2013-04-01,"sbpb","transporte não regular","voo internacional",0,0,0,0,0,0,0,0,0,0
"2213",2013-04-01,"sbpj","transporte regular","voo doméstico",358,352,710,20492,20940,41432,0,0,0,0
"2214",2013-04-01,"sbpj","transporte regular","voo internacional",0,0,0,0,0,0,0,0,0,0
"2215",2013-04-01,"sbpj","transporte não regular","voo doméstico",479,477,956,3415,1918,5333,33450,38050,71500,0
"2216",2013-04-01,"sbpj","transporte não regular","voo internacional",1,1,2,0,0,0,0,0,0,0
"2217",2013-04-01,"sbpk","transporte regular","voo doméstico",80,81,161,1450,1380,2830,0,0,0,0
"2218",2013-04-01,"sbpk","transporte regular","voo internacional",0,0,0,0,0,0,0,0,0,0
"2219",2013-04-01,"sbpk","transporte não regular","voo doméstico",75,74,149,279,246,525,0,0,0,0
"2220",2013-04-01,"sbpk","transporte não regular","voo internacional",3,4,7,15,9,24,0,0,0,0
"2221",2013-04-01,"sbpl","transporte regular","voo doméstico",223,223,446,19976,19234,39210,0,0,0,0
"2222",2013-04-01,"sbpl","transporte regular","voo internacional",4,4,8,0,0,0,0,0,0,0
"2223",2013-04-01,"sbpl","transporte não regular","voo doméstico",91,90,181,168,146,314,0,0,0,0
"2224",2013-04-01,"sbpl","transporte não regular","voo internacional",1,1,2,1,1,2,0,0,0,0
"2225",2013-04-01,"sbpp","transporte regular","voo doméstico",0,0,0,0,0,0,0,0,0,0
"2226",2013-04-01,"sbpp","transporte regular","voo internacional",0,0,0,0,0,0,0,0,0,0
"2227",2013-04-01,"sbpp","transporte não regular","voo doméstico",83,80,163,105,117,222,0,0,0,0
"2228",2013-04-01,"sbpp","transporte não regular","voo internacional",3,5,8,2,1,3,0,0,0,0
"2229",2013-04-01,"sbpr","transporte regular","voo doméstico",0,0,0,0,0,0,0,0,0,0
"2230",2013-04-01,"sbpr","transporte regular","voo internacional",0,0,0,0,0,0,0,0,0,0
"2231",2013-04-01,"sbpr","transporte não regular","voo doméstico",1454,1464,2918,1564,1481,3045,0,0,0,0
"2232",2013-04-01,"sbpr","transporte não regular","voo internacional",0,0,0,0,0,0,0,0,0,0
"2233",2013-04-01,"sbpv","transporte regular","voo doméstico",479,483,962,34712,34287,68999,55909,207783,263692,0
"2234",2013-04-01,"sbpv","transporte regular","voo internacional",0,0,0,0,0,0,0,0,0,0
"2235",2013-04-01,"sbpv","transporte não regular","voo doméstico",294,295,589,385,161,546,0,0,0,0
"2236",2013-04-01,"sbpv","transporte não regular","voo internacional",0,0,0,0,0,0,0,0,0,0
"2237",2013-04-01,"sbrb","transporte regular","voo doméstico",152,152,304,14180,14079,28259,0,0,0,0
"2238",2013-04-01,"sbrb","transporte regular","voo internacional",0,0,0,0,0,0,0,0,0,0
"2239",2013-04-01,"sbrb","transporte não regular","voo doméstico",278,278,556,842,473,1315,0,0,0,0
"2240",2013-04-01,"sbrb","transporte não regular","voo internacional",0,0,0,0,0,0,0,0,0,0
"2241",2013-04-01,"sbrj","transporte regular","voo doméstico",4120,4141,8261,387922,384631,772553,0,0,0,0
"2242",2013-04-01,"sbrj","transporte regular","voo internacional",0,0,0,0,0,0,0,0,0,0
"2243",2013-04-01,"sbrj","transporte não regular","voo doméstico",1325,1298,2623,10216,10301,20517,0,0,0,0
"2244",2013-04-01,"sbrj","transporte não regular","voo internacional",3,3,6,0,0,0,0,0,0,0
"2245",2013-04-01,"sbsj","transporte regular","voo doméstico",150,150,300,7095,6834,13929,0,0,0,0
"2246",2013-04-01,"sbsj","transporte regular","voo internacional",0,0,0,0,0,0,0,0,0,0
"2247",2013-04-01,"sbsj","transporte não regular","voo doméstico",595,582,1177,1315,1429,2744,0,0,0,0
"2248",2013-04-01,"sbsj","transporte não regular","voo internacional",8,10,18,36,37,73,0,0,0,0
"2249",2013-04-01,"sbsl","transporte regular","voo doméstico",671,672,1343,63750,64108,127858,3,0,3,0
"2250",2013-04-01,"sbsl","transporte regular","voo internacional",0,0,0,0,0,0,0,0,0,0
"2251",2013-04-01,"sbsl","transporte não regular","voo doméstico",464,460,924,1144,865,2009,85572,191323,276895,0
"2252",2013-04-01,"sbsl","transporte não regular","voo internacional",2,2,4,0,0,0,0,0,0,0
"2253",2013-04-01,"sbsn","transporte regular","voo doméstico",347,347,694,17938,16559,34497,0,0,0,0
"2254",2013-04-01,"sbsn","transporte regular","voo internacional",0,0,0,0,0,0,0,0,0,0
"2255",2013-04-01,"sbsn","transporte não regular","voo doméstico",309,306,615,854,505,1359,0,0,0,0
"2256",2013-04-01,"sbsn","transporte não regular","voo internacional",0,0,0,0,0,0,0,0,0,0
"2257",2013-04-01,"sbsp","transporte regular","voo doméstico",6525,6568,13093,686580,673373,1359953,0,0,0,0
"2258",2013-04-01,"sbsp","transporte regular","voo internacional",0,0,0,0,0,0,0,0,0,0
"2259",2013-04-01,"sbsp","transporte não regular","voo doméstico",2280,2234,4514,9633,8369,18002,0,0,0,0
"2260",2013-04-01,"sbsp","transporte não regular","voo internacional",0,0,0,0,0,0,0,0,0,0
"2261",2013-04-01,"sbte","transporte regular","voo doméstico",425,425,850,41072,37708,78780,31257,72890,104147,260751
"2262",2013-04-01,"sbte","transporte regular","voo internacional",0,0,0,0,0,0,0,0,0,0
"2263",2013-04-01,"sbte","transporte não regular","voo doméstico",229,230,459,1048,1124,2172,0,0,0,0
"2264",2013-04-01,"sbte","transporte não regular","voo internacional",0,0,0,0,0,0,0,0,0,0
"2265",2013-04-01,"sbtf","transporte regular","voo doméstico",72,72,144,1639,1822,3461,0,0,0,0
"2266",2013-04-01,"sbtf","transporte regular","voo internacional",0,0,0,0,0,0,0,0,0,0
"2267",2013-04-01,"sbtf","transporte não regular","voo doméstico",249,248,497,763,764,1527,2329,6287,8616,20578
"2268",2013-04-01,"sbtf","transporte não regular","voo internacional",0,0,0,0,0,0,0,0,0,0
"2269",2013-04-01,"sbtt","transporte regular","voo doméstico",51,51,102,1713,1958,3671,0,0,0,0
"2270",2013-04-01,"sbtt","transporte regular","voo internacional",0,0,0,0,0,0,0,0,0,0
"2271",2013-04-01,"sbtt","transporte não regular","voo doméstico",48,50,98,235,191,426,2460,4135,6595,1002
"2272",2013-04-01,"sbtt","transporte não regular","voo internacional",2,0,2,0,9,9,0,0,0,0
"2273",2013-04-01,"sbuf","transporte regular","voo doméstico",0,0,0,0,0,0,0,0,0,0
"2274",2013-04-01,"sbuf","transporte regular","voo internacional",0,0,0,0,0,0,0,0,0,0
"2275",2013-04-01,"sbuf","transporte não regular","voo doméstico",35,36,71,67,73,140,0,0,0,0
"2276",2013-04-01,"sbuf","transporte não regular","voo internacional",0,0,0,0,0,0,0,0,0,0
"2277",2013-04-01,"sbug","transporte regular","voo doméstico",21,21,42,116,115,231,0,0,0,0
"2278",2013-04-01,"sbug","transporte regular","voo internacional",0,0,0,0,0,0,0,0,0,0
"2279",2013-04-01,"sbug","transporte não regular","voo doméstico",23,23,46,43,33,76,0,0,0,0
"2280",2013-04-01,"sbug","transporte não regular","voo internacional",2,1,3,0,0,0,0,0,0,0
"2281",2013-04-01,"sbul","transporte regular","voo doméstico",617,615,1232,46142,44164,90306,0,0,0,0
"2282",2013-04-01,"sbul","transporte regular","voo internacional",0,0,0,0,0,0,0,0,0,0
"2283",2013-04-01,"sbul","transporte não regular","voo doméstico",683,691,1374,1721,1604,3325,0,0,0,0
"2284",2013-04-01,"sbul","transporte não regular","voo internacional",1,0,1,0,5,5,0,0,0,0
"2285",2013-04-01,"sbur","transporte regular","voo doméstico",130,129,259,6279,6235,12514,0,0,0,0
"2286",2013-04-01,"sbur","transporte regular","voo internacional",0,0,0,0,0,0,0,0,0,0
"2287",2013-04-01,"sbur","transporte não regular","voo doméstico",187,189,376,554,697,1251,0,0,0,0
"2288",2013-04-01,"sbur","transporte não regular","voo internacional",0,0,0,0,0,0,0,0,0,0
"2289",2013-08-01,"sbbe","transporte regular","voo doméstico",1769,1772,3541,146686,144413,291099,0,18955,18955,0
"2290",2013-08-01,"sbbe","transporte regular","voo internacional",22,22,44,2121,2117,4238,0,4,4,0
"2291",2013-08-01,"sbbe","transporte não regular","voo doméstico",543,537,1080,2630,2623,5253,105148,346858,452006,0
"2292",2013-08-01,"sbbe","transporte não regular","voo internacional",24,23,47,44,48,92,0,0,0,0
"2293",2013-08-01,"sbbg","transporte regular","voo doméstico",0,0,0,0,0,0,0,0,0,0
"2294",2013-08-01,"sbbg","transporte regular","voo internacional",0,0,0,0,0,0,0,0,0,0
"2295",2013-08-01,"sbbg","transporte não regular","voo doméstico",11,10,21,46,52,98,0,0,0,0
"2296",2013-08-01,"sbbg","transporte não regular","voo internacional",1,1,2,2,0,2,0,0,0,0
"2297",2013-08-01,"sbbh","transporte regular","voo doméstico",715,720,1435,33191,39751,72942,0,0,0,0
"2298",2013-08-01,"sbbh","transporte regular","voo internacional",0,0,0,0,0,0,0,0,0,0
"2299",2013-08-01,"sbbh","transporte não regular","voo doméstico",2245,2232,4477,8211,8231,16442,0,0,0,0
"2300",2013-08-01,"sbbh","transporte não regular","voo internacional",11,12,23,34,28,62,0,0,0,0
"2301",2013-08-01,"sbbi","transporte regular","voo doméstico",0,0,0,0,0,0,0,0,0,0
"2302",2013-08-01,"sbbi","transporte regular","voo internacional",0,0,0,0,0,0,0,0,0,0
"2303",2013-08-01,"sbbi","transporte não regular","voo doméstico",1101,1098,2199,2455,2391,4846,0,0,0,0
"2304",2013-08-01,"sbbi","transporte não regular","voo internacional",3,2,5,0,0,0,0,0,0,0
"2305",2013-08-01,"sbbv","transporte regular","voo doméstico",130,129,259,15110,15525,30635,0,0,0,0
"2306",2013-08-01,"sbbv","transporte regular","voo internacional",0,0,0,0,0,0,0,0,0,0
"2307",2013-08-01,"sbbv","transporte não regular","voo doméstico",96,97,193,102,55,157,0,0,0,0
"2308",2013-08-01,"sbbv","transporte não regular","voo internacional",37,37,74,2,0,2,0,0,0,0
"2309",2013-08-01,"sbcg","transporte regular","voo doméstico",685,691,1376,67036,62065,129101,0,7748,7748,0
"2310",2013-08-01,"sbcg","transporte regular","voo internacional",0,0,0,0,0,0,0,0,0,0
"2311",2013-08-01,"sbcg","transporte não regular","voo doméstico",417,413,830,611,913,1524,0,0,0,0
"2312",2013-08-01,"sbcg","transporte não regular","voo internacional",7,7,14,0,1,1,0,0,0,0
"2313",2013-08-01,"sbcj","transporte regular","voo doméstico",116,116,232,5385,6017,11402,0,0,0,0
"2314",2013-08-01,"sbcj","transporte regular","voo internacional",0,0,0,0,0,0,0,0,0,0
"2315",2013-08-01,"sbcj","transporte não regular","voo doméstico",123,122,245,831,869,1700,0,0,0,0
"2316",2013-08-01,"sbcj","transporte não regular","voo internacional",1,1,2,0,0,0,0,0,0,0
"2317",2013-08-01,"sbcr","transporte regular","voo doméstico",22,22,44,978,1143,2121,0,0,0,0
"2318",2013-08-01,"sbcr","transporte regular","voo internacional",0,0,0,0,0,0,0,0,0,0
"2319",2013-08-01,"sbcr","transporte não regular","voo doméstico",55,53,108,329,331,660,0,0,0,0
"2320",2013-08-01,"sbcr","transporte não regular","voo internacional",1,1,2,1,1,2,0,0,0,0
"2321",2013-08-01,"sbct","transporte regular","voo doméstico",3031,3074,6105,286906,275467,562373,173758,0,173758,189502
"2322",2013-08-01,"sbct","transporte regular","voo internacional",66,67,133,1832,1699,3531,0,5764,5764,0
"2323",2013-08-01,"sbct","transporte não regular","voo doméstico",295,255,550,852,2855,3707,0,0,0,0
"2324",2013-08-01,"sbct","transporte não regular","voo internacional",10,10,20,23,10,33,0,0,0,0
"2325",2013-08-01,"sbcz","transporte regular","voo doméstico",31,31,62,2196,2169,4365,0,0,0,0
"2326",2013-08-01,"sbcz","transporte regular","voo internacional",0,0,0,0,0,0,0,0,0,0
"2327",2013-08-01,"sbcz","transporte não regular","voo doméstico",156,155,311,623,627,1250,200,900,1100,0
"2328",2013-08-01,"sbcz","transporte não regular","voo internacional",2,2,4,6,0,6,0,0,0,0
"2329",2013-08-01,"sbeg","transporte regular","voo doméstico",1321,1313,2634,117829,112939,230768,0,0,0,0
"2330",2013-08-01,"sbeg","transporte regular","voo internacional",126,128,254,8113,7328,15441,0,0,0,0
"2331",2013-08-01,"sbeg","transporte não regular","voo doméstico",682,684,1366,7221,6831,14052,0,0,0,0
"2332",2013-08-01,"sbeg","transporte não regular","voo internacional",135,135,270,0,0,0,0,0,0,0
"2333",2013-08-01,"sbfi","transporte regular","voo doméstico",603,607,1210,66053,67260,133313,0,0,0,0
"2334",2013-08-01,"sbfi","transporte regular","voo internacional",25,25,50,2503,2307,4810,0,0,0,0
"2335",2013-08-01,"sbfi","transporte não regular","voo doméstico",158,149,307,389,974,1363,0,0,0,0
"2336",2013-08-01,"sbfi","transporte não regular","voo internacional",63,64,127,235,125,360,0,0,0,0
"2337",2013-08-01,"sbgo","transporte regular","voo doméstico",1403,1401,2804,121383,118631,240014,145092,204030,349122,228017
"2338",2013-08-01,"sbgo","transporte regular","voo internacional",0,0,0,0,0,0,0,0,0,0
"2339",2013-08-01,"sbgo","transporte não regular","voo doméstico",1422,1445,2867,7967,7220,15187,0,0,0,0
"2340",2013-08-01,"sbgo","transporte não regular","voo internacional",12,10,22,50,60,110,0,0,0,0
"2341",2013-08-01,"sbht","transporte regular","voo doméstico",212,212,424,9472,8745,18217,0,0,0,0
"2342",2013-08-01,"sbht","transporte regular","voo internacional",0,0,0,0,0,0,0,0,0,0
"2343",2013-08-01,"sbht","transporte não regular","voo doméstico",152,155,307,527,479,1006,5450,8407,13857,266
"2344",2013-08-01,"sbht","transporte não regular","voo internacional",0,0,0,0,0,0,0,0,0,0
"2345",2013-08-01,"sbiz","transporte regular","voo doméstico",186,187,373,15051,14013,29064,0,0,0,0
"2346",2013-08-01,"sbiz","transporte regular","voo internacional",0,0,0,0,0,0,0,0,0,0
"2347",2013-08-01,"sbiz","transporte não regular","voo doméstico",188,191,379,1479,1315,2794,0,0,0,0
"2348",2013-08-01,"sbiz","transporte não regular","voo internacional",2,1,3,0,0,0,0,0,0,0
"2349",2013-08-01,"sbjc","transporte regular","voo doméstico",0,0,0,0,0,0,0,0,0,0
"2350",2013-08-01,"sbjc","transporte regular","voo internacional",0,0,0,0,0,0,0,0,0,0
"2351",2013-08-01,"sbjc","transporte não regular","voo doméstico",678,671,1349,1432,1143,2575,0,0,0,0
"2352",2013-08-01,"sbjc","transporte não regular","voo internacional",0,1,1,0,0,0,0,0,0,0
"2353",2013-08-01,"sbjr","transporte regular","voo doméstico",0,0,0,0,0,0,0,0,0,0
"2354",2013-08-01,"sbjr","transporte regular","voo internacional",0,0,0,0,0,0,0,0,0,0
"2355",2013-08-01,"sbjr","transporte não regular","voo doméstico",3471,3491,6962,8800,3561,12361,0,0,0,0
"2356",2013-08-01,"sbjr","transporte não regular","voo internacional",0,0,0,0,0,0,0,0,0,0
"2357",2013-08-01,"sbjv","transporte regular","voo doméstico",228,228,456,16407,16302,32709,0,0,0,0
"2358",2013-08-01,"sbjv","transporte regular","voo internacional",0,0,0,0,0,0,0,0,0,0
"2359",2013-08-01,"sbjv","transporte não regular","voo doméstico",143,148,291,100,542,642,0,0,0,0
"2360",2013-08-01,"sbjv","transporte não regular","voo internacional",1,1,2,0,0,0,0,0,0,0
"2361",2013-08-01,"sblo","transporte regular","voo doméstico",463,465,928,39544,38579,78123,0,0,0,0
"2362",2013-08-01,"sblo","transporte regular","voo internacional",0,0,0,0,0,0,0,0,0,0
"2363",2013-08-01,"sblo","transporte não regular","voo doméstico",919,916,1835,2197,2596,4793,0,0,0,0
"2364",2013-08-01,"sblo","transporte não regular","voo internacional",3,2,5,0,0,0,0,0,0,0
"2365",2013-08-01,"sbma","transporte regular","voo doméstico",414,415,829,18291,15934,34225,0,0,0,0
"2366",2013-08-01,"sbma","transporte regular","voo internacional",0,0,0,0,0,0,0,0,0,0
"2367",2013-08-01,"sbma","transporte não regular","voo doméstico",286,289,575,1109,1113,2222,0,0,0,0
"2368",2013-08-01,"sbma","transporte não regular","voo internacional",1,1,2,0,0,0,0,0,0,0
"2369",2013-08-01,"sbmk","transporte regular","voo doméstico",195,195,390,13740,13070,26810,0,0,0,0
"2370",2013-08-01,"sbmk","transporte regular","voo internacional",0,0,0,0,0,0,0,0,0,0
"2371",2013-08-01,"sbmk","transporte não regular","voo doméstico",265,262,527,26,42,68,0,0,0,0
"2372",2013-08-01,"sbmk","transporte não regular","voo internacional",0,0,0,0,0,0,0,0,0,0
"2373",2013-08-01,"sbmq","transporte regular","voo doméstico",369,368,737,27984,31551,59535,0,0,0,0
"2374",2013-08-01,"sbmq","transporte regular","voo internacional",0,0,0,0,0,0,0,0,0,0
"2375",2013-08-01,"sbmq","transporte não regular","voo doméstico",263,262,525,337,132,469,0,0,0,0
"2376",2013-08-01,"sbmq","transporte não regular","voo internacional",11,7,18,0,0,0,0,0,0,0
"2377",2013-08-01,"sbmt","transporte regular","voo doméstico",0,0,0,0,0,0,0,0,0,0
"2378",2013-08-01,"sbmt","transporte regular","voo internacional",0,0,0,0,0,0,0,0,0,0
"2379",2013-08-01,"sbmt","transporte não regular","voo doméstico",6273,6290,12563,9438,12549,21987,0,0,0,0
"2380",2013-08-01,"sbmt","transporte não regular","voo internacional",7,4,11,0,0,0,0,0,0,0
"2381",2013-08-01,"sbnf","transporte regular","voo doméstico",523,524,1047,44438,42266,86704,0,0,0,0
"2382",2013-08-01,"sbnf","transporte regular","voo internacional",0,0,0,0,0,0,0,0,0,0
"2383",2013-08-01,"sbnf","transporte não regular","voo doméstico",382,383,765,1537,2173,3710,0,0,0,0
"2384",2013-08-01,"sbnf","transporte não regular","voo internacional",6,5,11,6,5,11,0,0,0,0
"2385",2013-08-01,"sbpb","transporte regular","voo doméstico",0,0,0,0,0,0,0,0,0,0
"2386",2013-08-01,"sbpb","transporte regular","voo internacional",0,0,0,0,0,0,0,0,0,0
"2387",2013-08-01,"sbpb","transporte não regular","voo doméstico",53,52,105,125,129,254,0,0,0,0
"2388",2013-08-01,"sbpb","transporte não regular","voo internacional",0,0,0,0,0,0,0,0,0,0
"2389",2013-08-01,"sbpj","transporte regular","voo doméstico",368,367,735,25084,23859,48943,0,0,0,0
"2390",2013-08-01,"sbpj","transporte regular","voo internacional",0,0,0,0,0,0,0,0,0,0
"2391",2013-08-01,"sbpj","transporte não regular","voo doméstico",477,483,960,676,412,1088,33170,35350,68520,0
"2392",2013-08-01,"sbpj","transporte não regular","voo internacional",3,3,6,0,0,0,0,0,0,0
"2393",2013-08-01,"sbpk","transporte regular","voo doméstico",59,60,119,2455,2176,4631,0,0,0,0
"2394",2013-08-01,"sbpk","transporte regular","voo internacional",0,0,0,0,0,0,0,0,0,0
"2395",2013-08-01,"sbpk","transporte não regular","voo doméstico",47,47,94,127,109,236,0,0,0,0
"2396",2013-08-01,"sbpk","transporte não regular","voo internacional",0,0,0,0,0,0,0,0,0,0
"2397",2013-08-01,"sbpl","transporte regular","voo doméstico",241,241,482,19397,18509,37906,0,0,0,0
"2398",2013-08-01,"sbpl","transporte regular","voo internacional",4,4,8,0,0,0,0,0,0,0
"2399",2013-08-01,"sbpl","transporte não regular","voo doméstico",88,87,175,58,69,127,0,0,0,0
"2400",2013-08-01,"sbpl","transporte não regular","voo internacional",0,0,0,0,0,0,0,0,0,0
"2401",2013-08-01,"sbpp","transporte regular","voo doméstico",0,0,0,0,0,0,0,0,0,0
"2402",2013-08-01,"sbpp","transporte regular","voo internacional",0,0,0,0,0,0,0,0,0,0
"2403",2013-08-01,"sbpp","transporte não regular","voo doméstico",91,88,179,127,126,253,0,0,0,0
"2404",2013-08-01,"sbpp","transporte não regular","voo internacional",4,4,8,4,5,9,0,0,0,0
"2405",2013-08-01,"sbpr","transporte regular","voo doméstico",0,0,0,0,0,0,0,0,0,0
"2406",2013-08-01,"sbpr","transporte regular","voo internacional",0,0,0,0,0,0,0,0,0,0
"2407",2013-08-01,"sbpr","transporte não regular","voo doméstico",1472,1476,2948,1572,1467,3039,0,0,0,0
"2408",2013-08-01,"sbpr","transporte não regular","voo internacional",0,0,0,0,0,0,0,0,0,0
"2409",2013-08-01,"sbpv","transporte regular","voo doméstico",451,450,901,38699,35577,74276,55757,217724,273481,0
"2410",2013-08-01,"sbpv","transporte regular","voo internacional",0,0,0,0,0,0,0,0,0,0
"2411",2013-08-01,"sbpv","transporte não regular","voo doméstico",269,272,541,0,0,0,0,0,0,0
"2412",2013-08-01,"sbpv","transporte não regular","voo internacional",0,0,0,0,0,0,0,0,0,0
"2413",2013-08-01,"sbrb","transporte regular","voo doméstico",163,163,326,15195,14742,29937,0,0,0,0
"2414",2013-08-01,"sbrb","transporte regular","voo internacional",0,0,0,0,0,0,0,0,0,0
"2415",2013-08-01,"sbrb","transporte não regular","voo doméstico",315,321,636,762,563,1325,0,0,0,0
"2416",2013-08-01,"sbrb","transporte não regular","voo internacional",0,0,0,0,0,0,0,0,0,0
"2417",2013-08-01,"sbrj","transporte regular","voo doméstico",4453,4464,8917,385236,366826,752062,0,0,0,0
"2418",2013-08-01,"sbrj","transporte regular","voo internacional",0,0,0,0,0,0,0,0,0,0
"2419",2013-08-01,"sbrj","transporte não regular","voo doméstico",1126,1124,2250,3447,4327,7774,0,0,0,0
"2420",2013-08-01,"sbrj","transporte não regular","voo internacional",10,10,20,0,0,0,0,0,0,0
"2421",2013-08-01,"sbsj","transporte regular","voo doméstico",103,106,209,5244,5002,10246,0,0,0,0
"2422",2013-08-01,"sbsj","transporte regular","voo internacional",0,0,0,0,0,0,0,0,0,0
"2423",2013-08-01,"sbsj","transporte não regular","voo doméstico",611,595,1206,1115,973,2088,0,0,0,0
"2424",2013-08-01,"sbsj","transporte não regular","voo internacional",8,18,26,26,7,33,0,0,0,0
"2425",2013-08-01,"sbsl","transporte regular","voo doméstico",791,791,1582,88253,89584,177837,126,0,126,0
"2426",2013-08-01,"sbsl","transporte regular","voo internacional",0,0,0,0,0,0,0,0,0,0
"2427",2013-08-01,"sbsl","transporte não regular","voo doméstico",493,494,987,1301,826,2127,85469,191925,277394,0
"2428",2013-08-01,"sbsl","transporte não regular","voo internacional",1,2,3,4,0,4,0,0,0,0
"2429",2013-08-01,"sbsn","transporte regular","voo doméstico",380,381,761,23689,21214,44903,0,0,0,0
"2430",2013-08-01,"sbsn","transporte regular","voo internacional",0,0,0,0,0,0,0,0,0,0
"2431",2013-08-01,"sbsn","transporte não regular","voo doméstico",385,385,770,911,564,1475,0,0,0,0
"2432",2013-08-01,"sbsn","transporte não regular","voo internacional",1,1,2,0,0,0,0,0,0,0
"2433",2013-08-01,"sbsp","transporte regular","voo doméstico",6772,6810,13582,724446,715021,1439467,0,0,0,0
"2434",2013-08-01,"sbsp","transporte regular","voo internacional",0,0,0,0,0,0,0,0,0,0
"2435",2013-08-01,"sbsp","transporte não regular","voo doméstico",2464,2400,4864,8881,10239,19120,0,0,0,0
"2436",2013-08-01,"sbsp","transporte não regular","voo internacional",0,0,0,0,0,0,0,0,0,0
"2437",2013-08-01,"sbte","transporte regular","voo doméstico",470,468,938,51126,48225,99351,22526,88401,110927,297700
"2438",2013-08-01,"sbte","transporte regular","voo internacional",0,0,0,0,0,0,0,0,0,0
"2439",2013-08-01,"sbte","transporte não regular","voo doméstico",264,269,533,1258,1281,2539,0,0,0,0
"2440",2013-08-01,"sbte","transporte não regular","voo internacional",1,1,2,0,0,0,0,0,0,0
"2441",2013-08-01,"sbtf","transporte regular","voo doméstico",68,68,136,1952,2131,4083,0,0,0,0
"2442",2013-08-01,"sbtf","transporte regular","voo internacional",0,0,0,0,0,0,0,0,0,0
"2443",2013-08-01,"sbtf","transporte não regular","voo doméstico",201,201,402,435,369,804,2527,4718,7245,21405
"2444",2013-08-01,"sbtf","transporte não regular","voo internacional",0,0,0,0,0,0,0,0,0,0
"2445",2013-08-01,"sbtt","transporte regular","voo doméstico",39,39,78,2414,2482,4896,0,0,0,0
"2446",2013-08-01,"sbtt","transporte regular","voo internacional",0,0,0,0,0,0,0,0,0,0
"2447",2013-08-01,"sbtt","transporte não regular","voo doméstico",69,68,137,273,258,531,1899,3481,5380,684
"2448",2013-08-01,"sbtt","transporte não regular","voo internacional",1,2,3,3,6,9,0,0,0,0
"2449",2013-08-01,"sbuf","transporte regular","voo doméstico",0,0,0,0,0,0,0,0,0,0
"2450",2013-08-01,"sbuf","transporte regular","voo internacional",0,0,0,0,0,0,0,0,0,0
"2451",2013-08-01,"sbuf","transporte não regular","voo doméstico",57,57,114,146,143,289,0,0,0,0
"2452",2013-08-01,"sbuf","transporte não regular","voo internacional",0,0,0,0,0,0,0,0,0,0
"2453",2013-08-01,"sbug","transporte regular","voo doméstico",0,0,0,0,0,0,0,0,0,0
"2454",2013-08-01,"sbug","transporte regular","voo internacional",0,0,0,0,0,0,0,0,0,0
"2455",2013-08-01,"sbug","transporte não regular","voo doméstico",21,20,41,26,16,42,0,0,0,0
"2456",2013-08-01,"sbug","transporte não regular","voo internacional",1,2,3,0,1,1,0,0,0,0
"2457",2013-08-01,"sbul","transporte regular","voo doméstico",587,587,1174,47974,47306,95280,0,0,0,0
"2458",2013-08-01,"sbul","transporte regular","voo internacional",0,0,0,0,0,0,0,0,0,0
"2459",2013-08-01,"sbul","transporte não regular","voo doméstico",786,781,1567,2020,1837,3857,0,0,0,0
"2460",2013-08-01,"sbul","transporte não regular","voo internacional",4,4,8,9,9,18,0,0,0,0
"2461",2013-08-01,"sbur","transporte regular","voo doméstico",123,124,247,6054,6441,12495,0,0,0,0
"2462",2013-08-01,"sbur","transporte regular","voo internacional",0,0,0,0,0,0,0,0,0,0
"2463",2013-08-01,"sbur","transporte não regular","voo doméstico",229,230,459,703,759,1462,0,0,0,0
"2464",2013-08-01,"sbur","transporte não regular","voo internacional",1,1,2,0,0,0,0,0,0,0
"2465",2013-12-01,"sbbe","transporte regular","voo doméstico",1729,1727,3456,159713,166530,326243,0,0,0,0
"2466",2013-12-01,"sbbe","transporte regular","voo internacional",21,21,42,1266,2162,3428,0,11,11,0
"2467",2013-12-01,"sbbe","transporte não regular","voo doméstico",630,621,1251,3069,3350,6419,110136,354948,465084,0
"2468",2013-12-01,"sbbe","transporte não regular","voo internacional",29,31,60,84,44,128,0,0,0,0
"2469",2013-12-01,"sbbg","transporte regular","voo doméstico",0,0,0,0,0,0,0,0,0,0
"2470",2013-12-01,"sbbg","transporte regular","voo internacional",0,0,0,0,0,0,0,0,0,0
"2471",2013-12-01,"sbbg","transporte não regular","voo doméstico",21,21,42,94,109,203,0,0,0,0
"2472",2013-12-01,"sbbg","transporte não regular","voo internacional",3,3,6,16,0,16,0,0,0,0
"2473",2013-12-01,"sbbh","transporte regular","voo doméstico",553,578,1131,28331,30375,58706,0,0,0,0
"2474",2013-12-01,"sbbh","transporte regular","voo internacional",0,0,0,0,0,0,0,0,0,0
"2475",2013-12-01,"sbbh","transporte não regular","voo doméstico",1733,1733,3466,8140,8537,16677,0,0,0,0
"2476",2013-12-01,"sbbh","transporte não regular","voo internacional",3,3,6,23,23,46,0,0,0,0
"2477",2013-12-01,"sbbi","transporte regular","voo doméstico",0,0,0,0,0,0,0,0,0,0
"2478",2013-12-01,"sbbi","transporte regular","voo internacional",0,0,0,0,0,0,0,0,0,0
"2479",2013-12-01,"sbbi","transporte não regular","voo doméstico",1063,1078,2141,3628,3553,7181,0,0,0,0
"2480",2013-12-01,"sbbi","transporte não regular","voo internacional",1,1,2,0,0,0,0,0,0,0
"2481",2013-12-01,"sbbv","transporte regular","voo doméstico",145,145,290,18800,16761,35561,0,0,0,0
"2482",2013-12-01,"sbbv","transporte regular","voo internacional",0,0,0,0,0,0,0,0,0,0
"2483",2013-12-01,"sbbv","transporte não regular","voo doméstico",136,139,275,287,102,389,0,0,0,0
"2484",2013-12-01,"sbbv","transporte não regular","voo internacional",27,25,52,36,22,58,0,0,0,0
"2485",2013-12-01,"sbcg","transporte regular","voo doméstico",609,590,1199,67551,64395,131946,64639,119110,183749,0
"2486",2013-12-01,"sbcg","transporte regular","voo internacional",0,0,0,0,0,0,0,0,0,0
"2487",2013-12-01,"sbcg","transporte não regular","voo doméstico",342,363,705,4875,2688,7563,0,0,0,0
"2488",2013-12-01,"sbcg","transporte não regular","voo internacional",16,18,34,0,0,0,0,0,0,0
"2489",2013-12-01,"sbcj","transporte regular","voo doméstico",95,95,190,4920,3261,8181,5,0,5,0
"2490",2013-12-01,"sbcj","transporte regular","voo internacional",0,0,0,0,0,0,0,0,0,0
"2491",2013-12-01,"sbcj","transporte não regular","voo doméstico",116,115,231,1351,906,2257,0,0,0,0
"2492",2013-12-01,"sbcj","transporte não regular","voo internacional",1,1,2,0,0,0,0,0,0,0
"2493",2013-12-01,"sbcr","transporte regular","voo doméstico",26,26,52,1417,1371,2788,0,0,0,0
"2494",2013-12-01,"sbcr","transporte regular","voo internacional",0,0,0,0,0,0,0,0,0,0
"2495",2013-12-01,"sbcr","transporte não regular","voo doméstico",44,44,88,94,78,172,0,0,0,0
"2496",2013-12-01,"sbcr","transporte não regular","voo internacional",3,3,6,10,8,18,0,0,0,0
"2497",2013-12-01,"sbct","transporte regular","voo doméstico",2960,2964,5924,314861,304664,619525,76213,4010,80223,138055
"2498",2013-12-01,"sbct","transporte regular","voo internacional",99,97,196,5857,5399,11256,0,16575,16575,0
"2499",2013-12-01,"sbct","transporte não regular","voo doméstico",325,323,648,1838,1947,3785,0,0,0,0
"2500",2013-12-01,"sbct","transporte não regular","voo internacional",13,16,29,62,25,87,0,0,0,0
"2501",2013-12-01,"sbcz","transporte regular","voo doméstico",31,31,62,2860,3046,5906,0,0,0,0
"2502",2013-12-01,"sbcz","transporte regular","voo internacional",0,0,0,0,0,0,0,0,0,0
"2503",2013-12-01,"sbcz","transporte não regular","voo doméstico",146,143,289,539,557,1096,0,0,0,0
"2504",2013-12-01,"sbcz","transporte não regular","voo internacional",1,1,2,0,0,0,0,0,0,0
"2505",2013-12-01,"sbeg","transporte regular","voo doméstico",1343,1336,2679,140310,112152,252462,0,0,0,0
"2506",2013-12-01,"sbeg","transporte regular","voo internacional",118,125,243,11907,9132,21039,0,0,0,0
"2507",2013-12-01,"sbeg","transporte não regular","voo doméstico",748,747,1495,11194,9380,20574,0,0,0,0
"2508",2013-12-01,"sbeg","transporte não regular","voo internacional",140,145,285,1,154,155,0,0,0,0
"2509",2013-12-01,"sbfi","transporte regular","voo doméstico",541,538,1079,68203,70725,138928,0,0,0,0
"2510",2013-12-01,"sbfi","transporte regular","voo internacional",25,25,50,2599,2242,4841,0,0,0,0
"2511",2013-12-01,"sbfi","transporte não regular","voo doméstico",98,96,194,159,251,410,0,0,0,0
"2512",2013-12-01,"sbfi","transporte não regular","voo internacional",43,49,92,231,170,401,0,0,0,0
"2513",2013-12-01,"sbgo","transporte regular","voo doméstico",1445,1439,2884,143291,135709,279000,74733,138263,212996,167273
"2514",2013-12-01,"sbgo","transporte regular","voo internacional",0,0,0,0,0,0,0,0,0,0
"2515",2013-12-01,"sbgo","transporte não regular","voo doméstico",1076,1108,2184,5830,5594,11424,0,0,0,0
"2516",2013-12-01,"sbgo","transporte não regular","voo internacional",8,8,16,40,40,80,0,0,0,0
"2517",2013-12-01,"sbht","transporte regular","voo doméstico",190,190,380,9236,7042,16278,0,0,0,0
"2518",2013-12-01,"sbht","transporte regular","voo internacional",0,0,0,0,0,0,0,0,0,0
"2519",2013-12-01,"sbht","transporte não regular","voo doméstico",194,196,390,1899,457,2356,0,0,0,0
"2520",2013-12-01,"sbht","transporte não regular","voo internacional",0,0,0,0,0,0,0,0,0,0
"2521",2013-12-01,"sbiz","transporte regular","voo doméstico",183,183,366,14311,14311,28622,0,0,0,0
"2522",2013-12-01,"sbiz","transporte regular","voo internacional",0,0,0,0,0,0,0,0,0,0
"2523",2013-12-01,"sbiz","transporte não regular","voo doméstico",141,136,277,365,399,764,0,0,0,0
"2524",2013-12-01,"sbiz","transporte não regular","voo internacional",0,1,1,0,0,0,0,0,0,0
"2525",2013-12-01,"sbjc","transporte regular","voo doméstico",0,0,0,0,0,0,0,0,0,0
"2526",2013-12-01,"sbjc","transporte regular","voo internacional",0,0,0,0,0,0,0,0,0,0
"2527",2013-12-01,"sbjc","transporte não regular","voo doméstico",658,651,1309,1521,1232,2753,0,0,0,0
"2528",2013-12-01,"sbjc","transporte não regular","voo internacional",1,0,1,0,0,0,0,0,0,0
"2529",2013-12-01,"sbjr","transporte regular","voo doméstico",0,0,0,0,0,0,0,0,0,0
"2530",2013-12-01,"sbjr","transporte regular","voo internacional",0,0,0,0,0,0,0,0,0,0
"2531",2013-12-01,"sbjr","transporte não regular","voo doméstico",3308,3301,6609,8571,3760,12331,0,0,0,0
"2532",2013-12-01,"sbjr","transporte não regular","voo internacional",0,0,0,0,0,0,0,0,0,0
"2533",2013-12-01,"sbjv","transporte regular","voo doméstico",258,257,515,20773,21984,42757,0,0,0,0
"2534",2013-12-01,"sbjv","transporte regular","voo internacional",0,0,0,0,0,0,0,0,0,0
"2535",2013-12-01,"sbjv","transporte não regular","voo doméstico",215,214,429,146,150,296,0,0,0,0
"2536",2013-12-01,"sbjv","transporte não regular","voo internacional",1,1,2,6,6,12,0,0,0,0
"2537",2013-12-01,"sblo","transporte regular","voo doméstico",503,503,1006,51038,51124,102162,0,0,0,0
"2538",2013-12-01,"sblo","transporte regular","voo internacional",0,0,0,0,0,0,0,0,0,0
"2539",2013-12-01,"sblo","transporte não regular","voo doméstico",691,690,1381,564,277,841,0,0,0,0
"2540",2013-12-01,"sblo","transporte não regular","voo internacional",1,1,2,0,0,0,0,0,0,0
"2541",2013-12-01,"sbma","transporte regular","voo doméstico",370,374,744,21015,19711,40726,0,0,0,0
"2542",2013-12-01,"sbma","transporte regular","voo internacional",0,0,0,0,0,0,0,0,0,0
"2543",2013-12-01,"sbma","transporte não regular","voo doméstico",303,298,601,1372,1411,2783,0,0,0,0
"2544",2013-12-01,"sbma","transporte não regular","voo internacional",2,2,4,0,0,0,0,0,0,0
"2545",2013-12-01,"sbmk","transporte regular","voo doméstico",170,167,337,15153,15589,30742,0,0,0,0
"2546",2013-12-01,"sbmk","transporte regular","voo internacional",0,0,0,0,0,0,0,0,0,0
"2547",2013-12-01,"sbmk","transporte não regular","voo doméstico",186,188,374,147,149,296,0,0,0,0
"2548",2013-12-01,"sbmk","transporte não regular","voo internacional",0,0,0,0,0,0,0,0,0,0
"2549",2013-12-01,"sbmq","transporte regular","voo doméstico",340,344,684,36526,30365,66891,4840,26010,30850,0
"2550",2013-12-01,"sbmq","transporte regular","voo internacional",0,0,0,0,0,0,0,0,0,0
"2551",2013-12-01,"sbmq","transporte não regular","voo doméstico",288,293,581,472,194,666,0,0,0,0
"2552",2013-12-01,"sbmq","transporte não regular","voo internacional",10,6,16,0,0,0,0,0,0,0
"2553",2013-12-01,"sbmt","transporte regular","voo doméstico",0,0,0,0,0,0,0,0,0,0
"2554",2013-12-01,"sbmt","transporte regular","voo internacional",0,0,0,0,0,0,0,0,0,0
"2555",2013-12-01,"sbmt","transporte não regular","voo doméstico",5472,5487,10959,9189,8812,18001,0,0,0,0
"2556",2013-12-01,"sbmt","transporte não regular","voo internacional",7,7,14,0,4,4,0,0,0,0
"2557",2013-12-01,"sbnf","transporte regular","voo doméstico",574,574,1148,51714,58385,110099,0,0,0,0
"2558",2013-12-01,"sbnf","transporte regular","voo internacional",0,0,0,0,0,0,0,0,0,0
"2559",2013-12-01,"sbnf","transporte não regular","voo doméstico",362,361,723,1024,1527,2551,0,0,0,0
"2560",2013-12-01,"sbnf","transporte não regular","voo internacional",5,5,10,22,25,47,0,0,0,0
"2561",2013-12-01,"sbpb","transporte regular","voo doméstico",0,0,0,0,0,0,0,0,0,0
"2562",2013-12-01,"sbpb","transporte regular","voo internacional",0,0,0,0,0,0,0,0,0,0
"2563",2013-12-01,"sbpb","transporte não regular","voo doméstico",85,74,159,116,171,287,0,0,0,0
"2564",2013-12-01,"sbpb","transporte não regular","voo internacional",0,0,0,0,0,0,0,0,0,0
"2565",2013-12-01,"sbpj","transporte regular","voo doméstico",371,372,743,26664,24384,51048,0,0,0,0
"2566",2013-12-01,"sbpj","transporte regular","voo internacional",0,0,0,0,0,0,0,0,0,0
"2567",2013-12-01,"sbpj","transporte não regular","voo doméstico",377,382,759,642,409,1051,0,0,0,0
"2568",2013-12-01,"sbpj","transporte não regular","voo internacional",7,7,14,0,0,0,0,0,0,0
"2569",2013-12-01,"sbpk","transporte regular","voo doméstico",39,39,78,2046,1864,3910,0,0,0,0
"2570",2013-12-01,"sbpk","transporte regular","voo internacional",0,0,0,0,0,0,0,0,0,0
"2571",2013-12-01,"sbpk","transporte não regular","voo doméstico",74,75,149,168,166,334,0,0,0,0
"2572",2013-12-01,"sbpk","transporte não regular","voo internacional",2,1,3,2,2,4,0,0,0,0
"2573",2013-12-01,"sbpl","transporte regular","voo doméstico",197,197,394,19771,22701,42472,0,0,0,0
"2574",2013-12-01,"sbpl","transporte regular","voo internacional",5,5,10,0,0,0,0,0,0,0
"2575",2013-12-01,"sbpl","transporte não regular","voo doméstico",102,101,203,121,114,235,0,0,0,0
"2576",2013-12-01,"sbpl","transporte não regular","voo internacional",0,0,0,0,0,0,0,0,0,0
"2577",2013-12-01,"sbpp","transporte regular","voo doméstico",0,0,0,0,0,0,0,0,0,0
"2578",2013-12-01,"sbpp","transporte regular","voo internacional",0,0,0,0,0,0,0,0,0,0
"2579",2013-12-01,"sbpp","transporte não regular","voo doméstico",101,104,205,192,197,389,0,0,0,0
"2580",2013-12-01,"sbpp","transporte não regular","voo internacional",6,7,13,5,4,9,0,0,0,0
"2581",2013-12-01,"sbpr","transporte regular","voo doméstico",0,0,0,0,0,0,0,0,0,0
"2582",2013-12-01,"sbpr","transporte regular","voo internacional",0,0,0,0,0,0,0,0,0,0
"2583",2013-12-01,"sbpr","transporte não regular","voo doméstico",1511,1517,3028,1728,1621,3349,0,0,0,0
"2584",2013-12-01,"sbpr","transporte não regular","voo internacional",0,0,0,0,0,0,0,0,0,0
"2585",2013-12-01,"sbpv","transporte regular","voo doméstico",459,459,918,47075,38698,85773,47651,216181,263832,0
"2586",2013-12-01,"sbpv","transporte regular","voo internacional",0,0,0,0,0,0,0,0,0,0
"2587",2013-12-01,"sbpv","transporte não regular","voo doméstico",310,310,620,0,0,0,0,0,0,0
"2588",2013-12-01,"sbpv","transporte não regular","voo internacional",0,0,0,0,0,0,0,0,0,0
"2589",2013-12-01,"sbrb","transporte regular","voo doméstico",162,163,325,17542,16262,33804,0,0,0,0
"2590",2013-12-01,"sbrb","transporte regular","voo internacional",0,0,0,0,0,0,0,0,0,0
"2591",2013-12-01,"sbrb","transporte não regular","voo doméstico",338,334,672,921,585,1506,0,0,0,0
"2592",2013-12-01,"sbrb","transporte não regular","voo internacional",1,1,2,0,0,0,0,0,0,0
"2593",2013-12-01,"sbrj","transporte regular","voo doméstico",4221,4257,8478,388105,407755,795860,0,0,0,0
"2594",2013-12-01,"sbrj","transporte regular","voo internacional",0,0,0,0,0,0,0,0,0,0
"2595",2013-12-01,"sbrj","transporte não regular","voo doméstico",1102,1068,2170,2127,1656,3783,0,0,0,0
"2596",2013-12-01,"sbrj","transporte não regular","voo internacional",3,3,6,0,0,0,0,0,0,0
"2597",2013-12-01,"sbsj","transporte regular","voo doméstico",50,49,99,3062,3338,6400,0,0,0,0
"2598",2013-12-01,"sbsj","transporte regular","voo internacional",0,0,0,0,0,0,0,0,0,0
"2599",2013-12-01,"sbsj","transporte não regular","voo doméstico",618,618,1236,1761,900,2661,0,0,0,0
"2600",2013-12-01,"sbsj","transporte não regular","voo internacional",4,30,34,127,13,140,0,0,0,0
"2601",2013-12-01,"sbsl","transporte regular","voo doméstico",744,758,1502,71281,82254,153535,0,0,0,0
"2602",2013-12-01,"sbsl","transporte regular","voo internacional",0,0,0,0,0,0,0,0,0,0
"2603",2013-12-01,"sbsl","transporte não regular","voo doméstico",492,482,974,3634,7339,10973,73294,181462,254756,0
"2604",2013-12-01,"sbsl","transporte não regular","voo internacional",2,2,4,11,0,11,0,0,0,0
"2605",2013-12-01,"sbsn","transporte regular","voo doméstico",442,440,882,26053,25414,51467,0,0,0,0
"2606",2013-12-01,"sbsn","transporte regular","voo internacional",0,0,0,0,0,0,0,0,0,0
"2607",2013-12-01,"sbsn","transporte não regular","voo doméstico",371,371,742,920,520,1440,0,0,0,0
"2608",2013-12-01,"sbsn","transporte não regular","voo internacional",1,1,2,0,0,0,0,0,0,0
"2609",2013-12-01,"sbsp","transporte regular","voo doméstico",6529,6625,13154,816264,735640,1551904,0,0,0,0
"2610",2013-12-01,"sbsp","transporte regular","voo internacional",0,0,0,0,0,0,0,0,0,0
"2611",2013-12-01,"sbsp","transporte não regular","voo doméstico",2355,2270,4625,15356,13516,28872,0,0,0,0
"2612",2013-12-01,"sbsp","transporte não regular","voo internacional",0,0,0,0,0,0,0,0,0,0
"2613",2013-12-01,"sbte","transporte regular","voo doméstico",490,492,982,44908,57187,102095,21139,87622,108761,231162
"2614",2013-12-01,"sbte","transporte regular","voo internacional",0,0,0,0,0,0,0,0,0,0
"2615",2013-12-01,"sbte","transporte não regular","voo doméstico",284,290,574,1771,2128,3899,0,0,0,0
"2616",2013-12-01,"sbte","transporte não regular","voo internacional",0,0,0,0,0,0,0,0,0,0
"2617",2013-12-01,"sbtf","transporte regular","voo doméstico",90,89,179,4072,4059,8131,0,0,0,0
"2618",2013-12-01,"sbtf","transporte regular","voo internacional",0,0,0,0,0,0,0,0,0,0
"2619",2013-12-01,"sbtf","transporte não regular","voo doméstico",261,261,522,350,304,654,4546,4836,9382,20528
"2620",2013-12-01,"sbtf","transporte não regular","voo internacional",0,0,0,0,0,0,0,0,0,0
"2621",2013-12-01,"sbtt","transporte regular","voo doméstico",31,31,62,2668,3222,5890,0,0,0,0
"2622",2013-12-01,"sbtt","transporte regular","voo internacional",0,0,0,0,0,0,0,0,0,0
"2623",2013-12-01,"sbtt","transporte não regular","voo doméstico",146,148,294,591,623,1214,2382,3920,6302,723
"2624",2013-12-01,"sbtt","transporte não regular","voo internacional",1,1,2,0,0,0,0,0,0,0
"2625",2013-12-01,"sbuf","transporte regular","voo doméstico",6,6,12,397,386,783,0,0,0,0
"2626",2013-12-01,"sbuf","transporte regular","voo internacional",0,0,0,0,0,0,0,0,0,0
"2627",2013-12-01,"sbuf","transporte não regular","voo doméstico",42,43,85,134,130,264,0,0,0,0
"2628",2013-12-01,"sbuf","transporte não regular","voo internacional",0,0,0,0,0,0,0,0,0,0
"2629",2013-12-01,"sbug","transporte regular","voo doméstico",0,0,0,0,0,0,0,0,0,0
"2630",2013-12-01,"sbug","transporte regular","voo internacional",0,0,0,0,0,0,0,0,0,0
"2631",2013-12-01,"sbug","transporte não regular","voo doméstico",16,14,30,39,41,80,0,0,0,0
"2632",2013-12-01,"sbug","transporte não regular","voo internacional",1,3,4,7,5,12,0,0,0,0
"2633",2013-12-01,"sbul","transporte regular","voo doméstico",536,538,1074,49778,47348,97126,0,0,0,0
"2634",2013-12-01,"sbul","transporte regular","voo internacional",0,0,0,0,0,0,0,0,0,0
"2635",2013-12-01,"sbul","transporte não regular","voo doméstico",597,595,1192,2089,2115,4204,0,0,0,0
"2636",2013-12-01,"sbul","transporte não regular","voo internacional",0,0,0,0,0,0,0,0,0,0
"2637",2013-12-01,"sbur","transporte regular","voo doméstico",96,94,190,5111,5007,10118,0,0,0,0
"2638",2013-12-01,"sbur","transporte regular","voo internacional",0,0,0,0,0,0,0,0,0,0
"2639",2013-12-01,"sbur","transporte não regular","voo doméstico",184,186,370,984,1130,2114,0,0,0,0
"2640",2013-12-01,"sbur","transporte não regular","voo internacional",1,1,2,0,0,0,0,0,0,0
"2641",2013-02-01,"sbbe","transporte regular","voo doméstico",1400,1396,2796,109665,102664,212329,0,0,0,0
"2642",2013-02-01,"sbbe","transporte regular","voo internacional",16,16,32,1921,1603,3524,0,16,16,0
"2643",2013-02-01,"sbbe","transporte não regular","voo doméstico",498,497,995,2487,1975,4462,83335,292794,376129,0
"2644",2013-02-01,"sbbe","transporte não regular","voo internacional",14,17,31,48,32,80,0,0,0,0
"2645",2013-02-01,"sbbg","transporte regular","voo doméstico",0,0,0,0,0,0,0,0,0,0
"2646",2013-02-01,"sbbg","transporte regular","voo internacional",0,0,0,0,0,0,0,0,0,0
"2647",2013-02-01,"sbbg","transporte não regular","voo doméstico",10,9,19,55,52,107,0,0,0,0
"2648",2013-02-01,"sbbg","transporte não regular","voo internacional",0,1,1,5,0,5,0,0,0,0
"2649",2013-02-01,"sbbh","transporte regular","voo doméstico",640,642,1282,24876,28204,53080,0,0,0,0
"2650",2013-02-01,"sbbh","transporte regular","voo internacional",0,0,0,0,0,0,0,0,0,0
"2651",2013-02-01,"sbbh","transporte não regular","voo doméstico",1886,1885,3771,8399,8321,16720,0,0,0,0
"2652",2013-02-01,"sbbh","transporte não regular","voo internacional",9,8,17,40,40,80,0,0,0,0
"2653",2013-02-01,"sbbi","transporte regular","voo doméstico",0,0,0,0,0,0,0,0,0,0
"2654",2013-02-01,"sbbi","transporte regular","voo internacional",0,0,0,0,0,0,0,0,0,0
"2655",2013-02-01,"sbbi","transporte não regular","voo doméstico",901,890,1791,2210,2108,4318,0,0,0,0
"2656",2013-02-01,"sbbi","transporte não regular","voo internacional",0,0,0,0,0,0,0,0,0,0
"2657",2013-02-01,"sbbv","transporte regular","voo doméstico",80,80,160,10510,12874,23384,0,0,0,0
"2658",2013-02-01,"sbbv","transporte regular","voo internacional",0,0,0,0,0,0,0,0,0,0
"2659",2013-02-01,"sbbv","transporte não regular","voo doméstico",151,152,303,401,322,723,0,0,0,0
"2660",2013-02-01,"sbbv","transporte não regular","voo internacional",16,15,31,15,2,17,0,0,0,0
"2661",2013-02-01,"sbcg","transporte regular","voo doméstico",689,692,1381,57644,57301,114945,64189,118803,182992,0
"2662",2013-02-01,"sbcg","transporte regular","voo internacional",0,0,0,0,0,0,0,0,0,0
"2663",2013-02-01,"sbcg","transporte não regular","voo doméstico",276,276,552,437,391,828,0,0,0,0
"2664",2013-02-01,"sbcg","transporte não regular","voo internacional",4,5,9,0,0,0,0,0,0,0
"2665",2013-02-01,"sbcj","transporte regular","voo doméstico",122,122,244,3389,3307,6696,4,20,24,0
"2666",2013-02-01,"sbcj","transporte regular","voo internacional",0,0,0,0,0,0,0,0,0,0
"2667",2013-02-01,"sbcj","transporte não regular","voo doméstico",103,103,206,378,456,834,0,0,0,0
"2668",2013-02-01,"sbcj","transporte não regular","voo internacional",1,1,2,0,0,0,0,0,0,0
"2669",2013-02-01,"sbcr","transporte regular","voo doméstico",26,26,52,860,931,1791,0,0,0,0
"2670",2013-02-01,"sbcr","transporte regular","voo internacional",0,0,0,0,0,0,0,0,0,0
"2671",2013-02-01,"sbcr","transporte não regular","voo doméstico",34,36,70,148,152,300,0,0,0,0
"2672",2013-02-01,"sbcr","transporte não regular","voo internacional",2,2,4,9,5,14,0,0,0,0
"2673",2013-02-01,"sbct","transporte regular","voo doméstico",2768,2774,5542,184047,220369,404416,190566,112030,302596,380052
"2674",2013-02-01,"sbct","transporte regular","voo internacional",87,87,174,1444,1838,3282,0,0,0,0
"2675",2013-02-01,"sbct","transporte não regular","voo doméstico",261,246,507,1312,2313,3625,0,0,0,0
"2676",2013-02-01,"sbct","transporte não regular","voo internacional",15,16,31,28,6,34,0,0,0,0
"2677",2013-02-01,"sbcz","transporte regular","voo doméstico",27,27,54,1703,1442,3145,0,0,0,0
"2678",2013-02-01,"sbcz","transporte regular","voo internacional",0,0,0,0,0,0,0,0,0,0
"2679",2013-02-01,"sbcz","transporte não regular","voo doméstico",156,156,312,590,604,1194,0,0,0,0
"2680",2013-02-01,"sbcz","transporte não regular","voo internacional",0,0,0,0,0,0,0,0,0,0
"2681",2013-02-01,"sbeg","transporte regular","voo doméstico",1167,1162,2329,96484,103205,199689,0,0,0,0
"2682",2013-02-01,"sbeg","transporte regular","voo internacional",106,106,212,7816,9883,17699,0,0,0,0
"2683",2013-02-01,"sbeg","transporte não regular","voo doméstico",631,659,1290,5810,5287,11097,0,0,0,0
"2684",2013-02-01,"sbeg","transporte não regular","voo internacional",183,165,348,848,1081,1929,0,0,0,0
"2685",2013-02-01,"sbfi","transporte regular","voo doméstico",472,475,947,57223,56758,113981,0,0,0,0
"2686",2013-02-01,"sbfi","transporte regular","voo internacional",16,16,32,2186,2180,4366,0,0,0,0
"2687",2013-02-01,"sbfi","transporte não regular","voo doméstico",91,84,175,249,627,876,0,0,0,0
"2688",2013-02-01,"sbfi","transporte não regular","voo internacional",36,37,73,478,482,960,0,0,0,0
"2689",2013-02-01,"sbgo","transporte regular","voo doméstico",1240,1233,2473,93777,91962,185739,94835,166211,261046,171996
"2690",2013-02-01,"sbgo","transporte regular","voo internacional",0,0,0,0,0,0,0,0,0,0
"2691",2013-02-01,"sbgo","transporte não regular","voo doméstico",971,970,1941,5510,5453,10963,0,0,0,0
"2692",2013-02-01,"sbgo","transporte não regular","voo internacional",7,5,12,25,35,60,0,0,0,0
"2693",2013-02-01,"sbht","transporte regular","voo doméstico",190,190,380,6894,6943,13837,0,0,0,0
"2694",2013-02-01,"sbht","transporte regular","voo internacional",0,0,0,0,0,0,0,0,0,0
"2695",2013-02-01,"sbht","transporte não regular","voo doméstico",180,180,360,249,229,478,12077,20083,32160,11574
"2696",2013-02-01,"sbht","transporte não regular","voo internacional",0,0,0,0,0,0,0,0,0,0
"2697",2013-02-01,"sbiz","transporte regular","voo doméstico",164,164,328,9241,8795,18036,0,0,0,0
"2698",2013-02-01,"sbiz","transporte regular","voo internacional",0,0,0,0,0,0,0,0,0,0
"2699",2013-02-01,"sbiz","transporte não regular","voo doméstico",158,153,311,842,843,1685,0,0,0,0
"2700",2013-02-01,"sbiz","transporte não regular","voo internacional",0,1,1,0,0,0,0,0,0,0
"2701",2013-02-01,"sbjc","transporte regular","voo doméstico",0,0,0,0,0,0,0,0,0,0
"2702",2013-02-01,"sbjc","transporte regular","voo internacional",0,0,0,0,0,0,0,0,0,0
"2703",2013-02-01,"sbjc","transporte não regular","voo doméstico",515,518,1033,1228,1100,2328,0,0,0,0
"2704",2013-02-01,"sbjc","transporte não regular","voo internacional",0,0,0,0,0,0,0,0,0,0
"2705",2013-02-01,"sbjr","transporte regular","voo doméstico",0,0,0,0,0,0,0,0,0,0
"2706",2013-02-01,"sbjr","transporte regular","voo internacional",0,0,0,0,0,0,0,0,0,0
"2707",2013-02-01,"sbjr","transporte não regular","voo doméstico",2821,2821,5642,7494,3722,11216,0,0,0,0
"2708",2013-02-01,"sbjr","transporte não regular","voo internacional",0,0,0,0,0,0,0,0,0,0
"2709",2013-02-01,"sbjv","transporte regular","voo doméstico",220,219,439,13007,12887,25894,0,0,0,0
"2710",2013-02-01,"sbjv","transporte regular","voo internacional",0,0,0,0,0,0,0,0,0,0
"2711",2013-02-01,"sbjv","transporte não regular","voo doméstico",131,131,262,50,136,186,0,0,0,0
"2712",2013-02-01,"sbjv","transporte não regular","voo internacional",0,0,0,0,0,0,0,0,0,0
"2713",2013-02-01,"sblo","transporte regular","voo doméstico",483,482,965,33930,34010,67940,0,0,0,0
"2714",2013-02-01,"sblo","transporte regular","voo internacional",0,0,0,0,0,0,0,0,0,0
"2715",2013-02-01,"sblo","transporte não regular","voo doméstico",589,591,1180,538,855,1393,0,0,0,0
"2716",2013-02-01,"sblo","transporte não regular","voo internacional",1,1,2,0,0,0,0,0,0,0
"2717",2013-02-01,"sbma","transporte regular","voo doméstico",390,392,782,13743,14163,27906,0,0,0,0
"2718",2013-02-01,"sbma","transporte regular","voo internacional",0,0,0,0,0,0,0,0,0,0
"2719",2013-02-01,"sbma","transporte não regular","voo doméstico",219,220,439,1080,1133,2213,0,0,0,0
"2720",2013-02-01,"sbma","transporte não regular","voo internacional",1,1,2,0,0,0,0,0,0,0
"2721",2013-02-01,"sbmk","transporte regular","voo doméstico",230,231,461,11062,10926,21988,0,0,0,0
"2722",2013-02-01,"sbmk","transporte regular","voo internacional",0,0,0,0,0,0,0,0,0,0
"2723",2013-02-01,"sbmk","transporte não regular","voo doméstico",185,186,371,86,48,134,0,0,0,0
"2724",2013-02-01,"sbmk","transporte não regular","voo internacional",0,0,0,0,0,0,0,0,0,0
"2725",2013-02-01,"sbmq","transporte regular","voo doméstico",236,238,474,16788,17896,34684,20480,30550,51030,0
"2726",2013-02-01,"sbmq","transporte regular","voo internacional",0,0,0,0,0,0,0,0,0,0
"2727",2013-02-01,"sbmq","transporte não regular","voo doméstico",186,190,376,263,91,354,0,0,0,0
"2728",2013-02-01,"sbmq","transporte não regular","voo internacional",11,5,16,0,3,3,0,0,0,0
"2729",2013-02-01,"sbmt","transporte regular","voo doméstico",0,0,0,0,0,0,0,0,0,0
"2730",2013-02-01,"sbmt","transporte regular","voo internacional",0,0,0,0,0,0,0,0,0,0
"2731",2013-02-01,"sbmt","transporte não regular","voo doméstico",4976,4948,9924,9870,9948,19818,0,0,0,0
"2732",2013-02-01,"sbmt","transporte não regular","voo internacional",1,1,2,0,0,0,0,0,0,0
"2733",2013-02-01,"sbnf","transporte regular","voo doméstico",516,518,1034,43683,43008,86691,0,0,0,0
"2734",2013-02-01,"sbnf","transporte regular","voo internacional",0,0,0,0,0,0,0,0,0,0
"2735",2013-02-01,"sbnf","transporte não regular","voo doméstico",441,435,876,1789,1582,3371,0,0,0,0
"2736",2013-02-01,"sbnf","transporte não regular","voo internacional",8,10,18,2,0,2,0,0,0,0
"2737",2013-02-01,"sbpb","transporte regular","voo doméstico",0,0,0,0,0,0,0,0,0,0
"2738",2013-02-01,"sbpb","transporte regular","voo internacional",0,0,0,0,0,0,0,0,0,0
"2739",2013-02-01,"sbpb","transporte não regular","voo doméstico",59,60,119,178,166,344,0,0,0,0
"2740",2013-02-01,"sbpb","transporte não regular","voo internacional",0,0,0,0,0,0,0,0,0,0
"2741",2013-02-01,"sbpj","transporte regular","voo doméstico",290,285,575,16438,16608,33046,0,0,0,0
"2742",2013-02-01,"sbpj","transporte regular","voo internacional",0,0,0,0,0,0,0,0,0,0
"2743",2013-02-01,"sbpj","transporte não regular","voo doméstico",407,407,814,900,551,1451,24500,46250,70750,0
"2744",2013-02-01,"sbpj","transporte não regular","voo internacional",2,2,4,0,0,0,0,0,0,0
"2745",2013-02-01,"sbpk","transporte regular","voo doméstico",53,54,107,104,122,226,0,0,0,0
"2746",2013-02-01,"sbpk","transporte regular","voo internacional",0,0,0,0,0,0,0,0,0,0
"2747",2013-02-01,"sbpk","transporte não regular","voo doméstico",33,33,66,72,78,150,0,0,0,0
"2748",2013-02-01,"sbpk","transporte não regular","voo internacional",2,2,4,9,8,17,0,0,0,0
"2749",2013-02-01,"sbpl","transporte regular","voo doméstico",204,204,408,16893,15502,32395,0,0,0,0
"2750",2013-02-01,"sbpl","transporte regular","voo internacional",1,1,2,0,0,0,0,0,0,0
"2751",2013-02-01,"sbpl","transporte não regular","voo doméstico",67,66,133,78,67,145,0,0,0,0
"2752",2013-02-01,"sbpl","transporte não regular","voo internacional",0,0,0,0,0,0,0,0,0,0
"2753",2013-02-01,"sbpp","transporte regular","voo doméstico",0,0,0,0,0,0,0,0,0,0
"2754",2013-02-01,"sbpp","transporte regular","voo internacional",0,0,0,0,0,0,0,0,0,0
"2755",2013-02-01,"sbpp","transporte não regular","voo doméstico",64,63,127,117,103,220,0,0,0,0
"2756",2013-02-01,"sbpp","transporte não regular","voo internacional",6,5,11,3,6,9,0,0,0,0
"2757",2013-02-01,"sbpr","transporte regular","voo doméstico",0,0,0,0,0,0,0,0,0,0
"2758",2013-02-01,"sbpr","transporte regular","voo internacional",0,0,0,0,0,0,0,0,0,0
"2759",2013-02-01,"sbpr","transporte não regular","voo doméstico",1364,1354,2718,1454,1465,2919,0,0,0,0
"2760",2013-02-01,"sbpr","transporte não regular","voo internacional",0,0,0,0,0,0,0,0,0,0
"2761",2013-02-01,"sbpv","transporte regular","voo doméstico",508,508,1016,33619,39474,73093,53686,188523,242209,0
"2762",2013-02-01,"sbpv","transporte regular","voo internacional",0,0,0,0,0,0,0,0,0,0
"2763",2013-02-01,"sbpv","transporte não regular","voo doméstico",210,211,421,33,84,117,0,0,0,0
"2764",2013-02-01,"sbpv","transporte não regular","voo internacional",1,1,2,0,0,0,0,0,0,0
"2765",2013-02-01,"sbrb","transporte regular","voo doméstico",169,169,338,12072,14314,26386,0,0,0,0
"2766",2013-02-01,"sbrb","transporte regular","voo internacional",0,0,0,0,0,0,0,0,0,0
"2767",2013-02-01,"sbrb","transporte não regular","voo doméstico",214,209,423,716,493,1209,0,0,0,0
"2768",2013-02-01,"sbrb","transporte não regular","voo internacional",0,0,0,0,0,0,0,0,0,0
"2769",2013-02-01,"sbrj","transporte regular","voo doméstico",3583,3602,7185,315772,304601,620373,0,0,0,0
"2770",2013-02-01,"sbrj","transporte regular","voo internacional",0,0,0,0,0,0,0,0,0,0
"2771",2013-02-01,"sbrj","transporte não regular","voo doméstico",1082,1062,2144,5953,6144,12097,0,0,0,0
"2772",2013-02-01,"sbrj","transporte não regular","voo internacional",10,10,20,0,0,0,0,0,0,0
"2773",2013-02-01,"sbsj","transporte regular","voo doméstico",145,143,288,6376,6746,13122,0,0,0,0
"2774",2013-02-01,"sbsj","transporte regular","voo internacional",0,0,0,0,0,0,0,0,0,0
"2775",2013-02-01,"sbsj","transporte não regular","voo doméstico",458,445,903,1380,1378,2758,0,0,0,0
"2776",2013-02-01,"sbsj","transporte não regular","voo internacional",5,12,17,27,11,38,0,0,0,0
"2777",2013-02-01,"sbsl","transporte regular","voo doméstico",625,628,1253,65505,60761,126266,0,0,0,0
"2778",2013-02-01,"sbsl","transporte regular","voo internacional",0,0,0,0,0,0,0,0,0,0
"2779",2013-02-01,"sbsl","transporte não regular","voo doméstico",412,402,814,766,810,1576,74895,179023,253918,0
"2780",2013-02-01,"sbsl","transporte não regular","voo internacional",1,1,2,0,0,0,0,0,0,0
"2781",2013-02-01,"sbsn","transporte regular","voo doméstico",275,275,550,15284,13707,28991,0,0,0,0
"2782",2013-02-01,"sbsn","transporte regular","voo internacional",0,0,0,0,0,0,0,0,0,0
"2783",2013-02-01,"sbsn","transporte não regular","voo doméstico",262,267,529,634,522,1156,0,0,0,0
"2784",2013-02-01,"sbsn","transporte não regular","voo internacional",0,0,0,0,0,0,0,0,0,0
"2785",2013-02-01,"sbsp","transporte regular","voo doméstico",5678,5745,11423,547767,534945,1082712,0,0,0,0
"2786",2013-02-01,"sbsp","transporte regular","voo internacional",0,0,0,0,0,0,0,0,0,0
"2787",2013-02-01,"sbsp","transporte não regular","voo doméstico",1967,1905,3872,9957,9974,19931,0,0,0,0
"2788",2013-02-01,"sbsp","transporte não regular","voo internacional",0,0,0,0,0,0,0,0,0,0
"2789",2013-02-01,"sbte","transporte regular","voo doméstico",390,390,780,35053,29740,64793,16178,76240,92418,205372
"2790",2013-02-01,"sbte","transporte regular","voo internacional",0,0,0,0,0,0,0,0,0,0
"2791",2013-02-01,"sbte","transporte não regular","voo doméstico",218,214,432,1061,1083,2144,1179,650,1829,3301
"2792",2013-02-01,"sbte","transporte não regular","voo internacional",0,0,0,0,0,0,0,0,0,0
"2793",2013-02-01,"sbtf","transporte regular","voo doméstico",64,64,128,1168,1494,2662,0,0,0,0
"2794",2013-02-01,"sbtf","transporte regular","voo internacional",0,0,0,0,0,0,0,0,0,0
"2795",2013-02-01,"sbtf","transporte não regular","voo doméstico",243,241,484,663,597,1260,2259,4115,6374,21534
"2796",2013-02-01,"sbtf","transporte não regular","voo internacional",0,0,0,0,0,0,0,0,0,0
"2797",2013-02-01,"sbtt","transporte regular","voo doméstico",56,56,112,1738,2258,3996,0,0,0,0
"2798",2013-02-01,"sbtt","transporte regular","voo internacional",0,0,0,0,0,0,0,0,0,0
"2799",2013-02-01,"sbtt","transporte não regular","voo doméstico",39,41,80,184,149,333,1749,2795,4544,716
"2800",2013-02-01,"sbtt","transporte não regular","voo internacional",0,0,0,0,0,0,0,0,0,0
"2801",2013-02-01,"sbuf","transporte regular","voo doméstico",0,0,0,0,0,0,0,0,0,0
"2802",2013-02-01,"sbuf","transporte regular","voo internacional",0,0,0,0,0,0,0,0,0,0
"2803",2013-02-01,"sbuf","transporte não regular","voo doméstico",40,39,79,148,155,303,0,0,0,0
"2804",2013-02-01,"sbuf","transporte não regular","voo internacional",0,0,0,0,0,0,0,0,0,0
"2805",2013-02-01,"sbug","transporte regular","voo doméstico",15,15,30,50,54,104,0,0,0,0
"2806",2013-02-01,"sbug","transporte regular","voo internacional",0,0,0,0,0,0,0,0,0,0
"2807",2013-02-01,"sbug","transporte não regular","voo doméstico",11,11,22,22,24,46,0,0,0,0
"2808",2013-02-01,"sbug","transporte não regular","voo internacional",1,1,2,0,0,0,0,0,0,0
"2809",2013-02-01,"sbul","transporte regular","voo doméstico",521,520,1041,33404,35442,68846,0,0,0,0
"2810",2013-02-01,"sbul","transporte regular","voo internacional",0,0,0,0,0,0,0,0,0,0
"2811",2013-02-01,"sbul","transporte não regular","voo doméstico",597,596,1193,1677,1938,3615,0,0,0,0
"2812",2013-02-01,"sbul","transporte não regular","voo internacional",0,0,0,0,0,0,0,0,0,0
"2813",2013-02-01,"sbur","transporte regular","voo doméstico",122,123,245,4574,5244,9818,0,0,0,0
"2814",2013-02-01,"sbur","transporte regular","voo internacional",0,0,0,0,0,0,0,0,0,0
"2815",2013-02-01,"sbur","transporte não regular","voo doméstico",171,173,344,598,586,1184,0,0,0,0
"2816",2013-02-01,"sbur","transporte não regular","voo internacional",1,1,2,0,0,0,0,0,0,0
"2817",2013-01-01,"sbbe","transporte regular","voo doméstico",1599,1587,3186,138349,133973,272322,5186,17404,22590,0
"2818",2013-01-01,"sbbe","transporte regular","voo internacional",18,18,36,2110,1861,3971,0,8,8,0
"2819",2013-01-01,"sbbe","transporte não regular","voo doméstico",594,616,1210,4137,3429,7566,104199,329781,433980,0
"2820",2013-01-01,"sbbe","transporte não regular","voo internacional",24,25,49,52,60,112,0,0,0,0
"2821",2013-01-01,"sbbg","transporte regular","voo doméstico",0,0,0,0,0,0,0,0,0,0
"2822",2013-01-01,"sbbg","transporte regular","voo internacional",0,0,0,0,0,0,0,0,0,0
"2823",2013-01-01,"sbbg","transporte não regular","voo doméstico",15,14,29,67,56,123,0,0,0,0
"2824",2013-01-01,"sbbg","transporte não regular","voo internacional",1,1,2,0,13,13,0,0,0,0
"2825",2013-01-01,"sbbh","transporte regular","voo doméstico",729,741,1470,25681,31578,57259,0,0,0,0
"2826",2013-01-01,"sbbh","transporte regular","voo internacional",0,0,0,0,0,0,0,0,0,0
"2827",2013-01-01,"sbbh","transporte não regular","voo doméstico",1703,1665,3368,7852,7804,15656,0,0,0,0
"2828",2013-01-01,"sbbh","transporte não regular","voo internacional",5,3,8,20,26,46,0,0,0,0
"2829",2013-01-01,"sbbi","transporte regular","voo doméstico",0,0,0,0,0,0,0,0,0,0
"2830",2013-01-01,"sbbi","transporte regular","voo internacional",0,0,0,0,0,0,0,0,0,0
"2831",2013-01-01,"sbbi","transporte não regular","voo doméstico",913,906,1819,3180,2775,5955,0,0,0,0
"2832",2013-01-01,"sbbi","transporte não regular","voo internacional",3,2,5,0,0,0,0,0,0,0
"2833",2013-01-01,"sbbv","transporte regular","voo doméstico",94,94,188,14472,15562,30034,0,0,0,0
"2834",2013-01-01,"sbbv","transporte regular","voo internacional",0,0,0,0,0,0,0,0,0,0
"2835",2013-01-01,"sbbv","transporte não regular","voo doméstico",144,143,287,254,93,347,0,0,0,0
"2836",2013-01-01,"sbbv","transporte não regular","voo internacional",23,24,47,11,18,29,0,0,0,0
"2837",2013-01-01,"sbcg","transporte regular","voo doméstico",845,842,1687,74838,77131,151969,74725,137237,211962,0
"2838",2013-01-01,"sbcg","transporte regular","voo internacional",0,0,0,0,0,0,0,0,0,0
"2839",2013-01-01,"sbcg","transporte não regular","voo doméstico",270,271,541,81,40,121,0,0,0,0
"2840",2013-01-01,"sbcg","transporte não regular","voo internacional",11,10,21,0,0,0,0,0,0,0
"2841",2013-01-01,"sbcj","transporte regular","voo doméstico",141,141,282,3305,4053,7358,0,0,0,0
"2842",2013-01-01,"sbcj","transporte regular","voo internacional",0,0,0,0,0,0,0,0,0,0
"2843",2013-01-01,"sbcj","transporte não regular","voo doméstico",96,97,193,1267,1466,2733,0,0,0,0
"2844",2013-01-01,"sbcj","transporte não regular","voo internacional",3,3,6,0,0,0,0,0,0,0
"2845",2013-01-01,"sbcr","transporte regular","voo doméstico",31,31,62,947,1077,2024,0,0,0,0
"2846",2013-01-01,"sbcr","transporte regular","voo internacional",0,0,0,0,0,0,0,0,0,0
"2847",2013-01-01,"sbcr","transporte não regular","voo doméstico",71,71,142,268,254,522,0,0,0,0
"2848",2013-01-01,"sbcr","transporte não regular","voo internacional",3,3,6,7,6,13,0,0,0,0
"2849",2013-01-01,"sbct","transporte regular","voo doméstico",3084,3085,6169,253941,230697,484638,205358,125126,330484,431862
"2850",2013-01-01,"sbct","transporte regular","voo internacional",91,91,182,2439,1833,4272,0,0,0,0
"2851",2013-01-01,"sbct","transporte não regular","voo doméstico",254,258,512,1579,1438,3017,0,0,0,0
"2852",2013-01-01,"sbct","transporte não regular","voo internacional",20,20,40,29,36,65,0,0,0,0
"2853",2013-01-01,"sbcz","transporte regular","voo doméstico",30,30,60,1711,1381,3092,0,0,0,0
"2854",2013-01-01,"sbcz","transporte regular","voo internacional",0,0,0,0,0,0,0,0,0,0
"2855",2013-01-01,"sbcz","transporte não regular","voo doméstico",177,174,351,682,693,1375,0,0,0,0
"2856",2013-01-01,"sbcz","transporte não regular","voo internacional",0,0,0,0,0,0,0,0,0,0
"2857",2013-01-01,"sbeg","transporte regular","voo doméstico",1357,1350,2707,121473,132482,253955,0,0,0,0
"2858",2013-01-01,"sbeg","transporte regular","voo internacional",113,110,223,10157,10165,20322,0,0,0,0
"2859",2013-01-01,"sbeg","transporte não regular","voo doméstico",679,694,1373,5427,4759,10186,0,0,0,0
"2860",2013-01-01,"sbeg","transporte não regular","voo internacional",260,257,517,2067,583,2650,0,0,0,0
"2861",2013-01-01,"sbfi","transporte regular","voo doméstico",579,578,1157,72406,65779,138185,0,0,0,0
"2862",2013-01-01,"sbfi","transporte regular","voo internacional",18,18,36,2267,2380,4647,0,0,0,0
"2863",2013-01-01,"sbfi","transporte não regular","voo doméstico",108,115,223,1537,1203,2740,0,0,0,0
"2864",2013-01-01,"sbfi","transporte não regular","voo internacional",49,45,94,212,241,453,0,0,0,0
"2865",2013-01-01,"sbgo","transporte regular","voo doméstico",1450,1447,2897,115748,122714,238462,111104,189166,300270,183226
"2866",2013-01-01,"sbgo","transporte regular","voo internacional",0,0,0,0,0,0,0,0,0,0
"2867",2013-01-01,"sbgo","transporte não regular","voo doméstico",921,889,1810,4932,5235,10167,0,0,0,0
"2868",2013-01-01,"sbgo","transporte não regular","voo internacional",10,10,20,50,50,100,0,0,0,0
"2869",2013-01-01,"sbht","transporte regular","voo doméstico",186,187,373,5780,6651,12431,0,0,0,0
"2870",2013-01-01,"sbht","transporte regular","voo internacional",0,0,0,0,0,0,0,0,0,0
"2871",2013-01-01,"sbht","transporte não regular","voo doméstico",240,237,477,1415,1821,3236,28712,44070,72782,32238
"2872",2013-01-01,"sbht","transporte não regular","voo internacional",1,1,2,0,0,0,0,0,0,0
"2873",2013-01-01,"sbiz","transporte regular","voo doméstico",182,182,364,9739,10428,20167,0,0,0,0
"2874",2013-01-01,"sbiz","transporte regular","voo internacional",0,0,0,0,0,0,0,0,0,0
"2875",2013-01-01,"sbiz","transporte não regular","voo doméstico",149,153,302,441,1064,1505,0,0,0,0
"2876",2013-01-01,"sbiz","transporte não regular","voo internacional",2,2,4,0,0,0,0,0,0,0
"2877",2013-01-01,"sbjc","transporte regular","voo doméstico",0,0,0,0,0,0,0,0,0,0
"2878",2013-01-01,"sbjc","transporte regular","voo internacional",0,0,0,0,0,0,0,0,0,0
"2879",2013-01-01,"sbjc","transporte não regular","voo doméstico",603,592,1195,1378,1248,2626,0,0,0,0
"2880",2013-01-01,"sbjc","transporte não regular","voo internacional",0,0,0,0,0,0,0,0,0,0
"2881",2013-01-01,"sbjr","transporte regular","voo doméstico",0,0,0,0,0,0,0,0,0,0
"2882",2013-01-01,"sbjr","transporte regular","voo internacional",0,0,0,0,0,0,0,0,0,0
"2883",2013-01-01,"sbjr","transporte não regular","voo doméstico",2766,2770,5536,7640,4975,12615,0,0,0,0
"2884",2013-01-01,"sbjr","transporte não regular","voo internacional",0,0,0,0,0,0,0,0,0,0
"2885",2013-01-01,"sbjv","transporte regular","voo doméstico",305,304,609,15466,13578,29044,0,0,0,0
"2886",2013-01-01,"sbjv","transporte regular","voo internacional",0,0,0,0,0,0,0,0,0,0
"2887",2013-01-01,"sbjv","transporte não regular","voo doméstico",120,117,237,65,91,156,0,0,0,0
"2888",2013-01-01,"sbjv","transporte não regular","voo internacional",0,0,0,0,0,0,0,0,0,0
"2889",2013-01-01,"sblo","transporte regular","voo doméstico",642,646,1288,43692,41416,85108,0,0,0,0
"2890",2013-01-01,"sblo","transporte regular","voo internacional",0,0,0,0,0,0,0,0,0,0
"2891",2013-01-01,"sblo","transporte não regular","voo doméstico",728,728,1456,1163,1404,2567,0,0,0,0
"2892",2013-01-01,"sblo","transporte não regular","voo internacional",4,3,7,0,0,0,0,0,0,0
"2893",2013-01-01,"sbma","transporte regular","voo doméstico",454,452,906,14503,17316,31819,0,0,0,0
"2894",2013-01-01,"sbma","transporte regular","voo internacional",0,0,0,0,0,0,0,0,0,0
"2895",2013-01-01,"sbma","transporte não regular","voo doméstico",223,222,445,1108,1056,2164,0,0,0,0
"2896",2013-01-01,"sbma","transporte não regular","voo internacional",4,4,8,0,0,0,0,0,0,0
"2897",2013-01-01,"sbmk","transporte regular","voo doméstico",261,259,520,14009,11900,25909,0,0,0,0
"2898",2013-01-01,"sbmk","transporte regular","voo internacional",0,0,0,0,0,0,0,0,0,0
"2899",2013-01-01,"sbmk","transporte não regular","voo doméstico",205,202,407,26,22,48,0,0,0,0
"2900",2013-01-01,"sbmk","transporte não regular","voo internacional",2,2,4,0,0,0,0,0,0,0
"2901",2013-01-01,"sbmq","transporte regular","voo doméstico",253,257,510,21741,24567,46308,18030,30050,48080,0
"2902",2013-01-01,"sbmq","transporte regular","voo internacional",0,0,0,0,0,0,0,0,0,0
"2903",2013-01-01,"sbmq","transporte não regular","voo doméstico",263,262,525,537,560,1097,0,0,0,0
"2904",2013-01-01,"sbmq","transporte não regular","voo internacional",13,12,25,0,0,0,0,0,0,0
"2905",2013-01-01,"sbmt","transporte regular","voo doméstico",0,0,0,0,0,0,0,0,0,0
"2906",2013-01-01,"sbmt","transporte regular","voo internacional",0,0,0,0,0,0,0,0,0,0
"2907",2013-01-01,"sbmt","transporte não regular","voo doméstico",4897,4865,9762,9969,9798,19767,0,0,0,0
"2908",2013-01-01,"sbmt","transporte não regular","voo internacional",2,1,3,0,0,0,0,0,0,0
"2909",2013-01-01,"sbnf","transporte regular","voo doméstico",644,640,1284,61073,51815,112888,0,0,0,0
"2910",2013-01-01,"sbnf","transporte regular","voo internacional",0,0,0,0,0,0,0,0,0,0
"2911",2013-01-01,"sbnf","transporte não regular","voo doméstico",512,520,1032,1601,1433,3034,0,0,0,0
"2912",2013-01-01,"sbnf","transporte não regular","voo internacional",12,10,22,28,32,60,0,0,0,0
"2913",2013-01-01,"sbpb","transporte regular","voo doméstico",0,0,0,0,0,0,0,0,0,0
"2914",2013-01-01,"sbpb","transporte regular","voo internacional",0,0,0,0,0,0,0,0,0,0
"2915",2013-01-01,"sbpb","transporte não regular","voo doméstico",58,68,126,128,77,205,0,0,0,0
"2916",2013-01-01,"sbpb","transporte não regular","voo internacional",0,0,0,0,0,0,0,0,0,0
"2917",2013-01-01,"sbpj","transporte regular","voo doméstico",306,307,613,20067,21398,41465,0,0,0,0
"2918",2013-01-01,"sbpj","transporte regular","voo internacional",0,0,0,0,0,0,0,0,0,0
"2919",2013-01-01,"sbpj","transporte não regular","voo doméstico",366,369,735,673,587,1260,25930,36537,62467,0
"2920",2013-01-01,"sbpj","transporte não regular","voo internacional",6,6,12,0,0,0,0,0,0,0
"2921",2013-01-01,"sbpk","transporte regular","voo doméstico",63,62,125,79,61,140,0,0,0,0
"2922",2013-01-01,"sbpk","transporte regular","voo internacional",0,0,0,0,0,0,0,0,0,0
"2923",2013-01-01,"sbpk","transporte não regular","voo doméstico",52,53,105,158,152,310,0,0,0,0
"2924",2013-01-01,"sbpk","transporte não regular","voo internacional",5,6,11,9,22,31,0,0,0,0
"2925",2013-01-01,"sbpl","transporte regular","voo doméstico",234,234,468,20653,19807,40460,0,0,0,0
"2926",2013-01-01,"sbpl","transporte regular","voo internacional",2,2,4,0,0,0,0,0,0,0
"2927",2013-01-01,"sbpl","transporte não regular","voo doméstico",67,66,133,66,63,129,0,0,0,0
"2928",2013-01-01,"sbpl","transporte não regular","voo internacional",0,0,0,0,0,0,0,0,0,0
"2929",2013-01-01,"sbpp","transporte regular","voo doméstico",0,0,0,0,0,0,0,0,0,0
"2930",2013-01-01,"sbpp","transporte regular","voo internacional",0,0,0,0,0,0,0,0,0,0
"2931",2013-01-01,"sbpp","transporte não regular","voo doméstico",81,79,160,157,147,304,0,0,0,0
"2932",2013-01-01,"sbpp","transporte não regular","voo internacional",3,5,8,5,5,10,0,0,0,0
"2933",2013-01-01,"sbpr","transporte regular","voo doméstico",0,0,0,0,0,0,0,0,0,0
"2934",2013-01-01,"sbpr","transporte regular","voo internacional",0,0,0,0,0,0,0,0,0,0
"2935",2013-01-01,"sbpr","transporte não regular","voo doméstico",1130,1120,2250,1220,1173,2393,0,0,0,0
"2936",2013-01-01,"sbpr","transporte não regular","voo internacional",0,0,0,0,0,0,0,0,0,0
"2937",2013-01-01,"sbpv","transporte regular","voo doméstico",623,621,1244,45502,49349,94851,63432,226159,289591,0
"2938",2013-01-01,"sbpv","transporte regular","voo internacional",0,0,0,0,0,0,0,0,0,0
"2939",2013-01-01,"sbpv","transporte não regular","voo doméstico",201,200,401,0,0,0,0,0,0,0
"2940",2013-01-01,"sbpv","transporte não regular","voo internacional",1,1,2,0,0,0,0,0,0,0
"2941",2013-01-01,"sbrb","transporte regular","voo doméstico",207,207,414,17853,17117,34970,0,0,0,0
"2942",2013-01-01,"sbrb","transporte regular","voo internacional",0,0,0,0,0,0,0,0,0,0
"2943",2013-01-01,"sbrb","transporte não regular","voo doméstico",244,249,493,832,638,1470,0,0,0,0
"2944",2013-01-01,"sbrb","transporte não regular","voo internacional",1,1,2,0,0,0,0,0,0,0
"2945",2013-01-01,"sbrj","transporte regular","voo doméstico",4036,4066,8102,392451,328605,721056,0,0,0,0
"2946",2013-01-01,"sbrj","transporte regular","voo internacional",0,0,0,0,0,0,0,0,0,0
"2947",2013-01-01,"sbrj","transporte não regular","voo doméstico",1155,1129,2284,12124,10073,22197,0,0,0,0
"2948",2013-01-01,"sbrj","transporte não regular","voo internacional",1,1,2,0,0,0,0,0,0,0
"2949",2013-01-01,"sbsj","transporte regular","voo doméstico",183,182,365,8138,8368,16506,0,0,0,0
"2950",2013-01-01,"sbsj","transporte regular","voo internacional",0,0,0,0,0,0,0,0,0,0
"2951",2013-01-01,"sbsj","transporte não regular","voo doméstico",350,335,685,928,958,1886,0,0,0,0
"2952",2013-01-01,"sbsj","transporte não regular","voo internacional",5,7,12,13,9,22,0,0,0,0
"2953",2013-01-01,"sbsl","transporte regular","voo doméstico",754,757,1511,88095,82572,170667,0,0,0,0
"2954",2013-01-01,"sbsl","transporte regular","voo internacional",0,0,0,0,0,0,0,0,0,0
"2955",2013-01-01,"sbsl","transporte não regular","voo doméstico",446,446,892,1220,733,1953,81061,162331,243392,0
"2956",2013-01-01,"sbsl","transporte não regular","voo internacional",1,2,3,8,0,8,0,0,0,0
"2957",2013-01-01,"sbsn","transporte regular","voo doméstico",323,324,647,20448,17573,38021,0,0,0,0
"2958",2013-01-01,"sbsn","transporte regular","voo internacional",0,0,0,0,0,0,0,0,0,0
"2959",2013-01-01,"sbsn","transporte não regular","voo doméstico",269,267,536,701,502,1203,0,0,0,0
"2960",2013-01-01,"sbsn","transporte não regular","voo internacional",1,1,2,0,0,0,0,0,0,0
"2961",2013-01-01,"sbsp","transporte regular","voo doméstico",6511,6610,13121,645112,676319,1321431,0,0,0,0
"2962",2013-01-01,"sbsp","transporte regular","voo internacional",0,0,0,0,0,0,0,0,0,0
"2963",2013-01-01,"sbsp","transporte não regular","voo doméstico",2054,1914,3968,13818,16851,30669,0,0,0,0
"2964",2013-01-01,"sbsp","transporte não regular","voo internacional",0,0,0,0,0,0,0,0,0,0
"2965",2013-01-01,"sbte","transporte regular","voo doméstico",459,458,917,47500,40384,87884,21127,73512,94639,208109
"2966",2013-01-01,"sbte","transporte regular","voo internacional",0,0,0,0,0,0,0,0,0,0
"2967",2013-01-01,"sbte","transporte não regular","voo doméstico",209,206,415,867,721,1588,4954,9163,14117,32786
"2968",2013-01-01,"sbte","transporte não regular","voo internacional",1,1,2,0,0,0,0,0,0,0
"2969",2013-01-01,"sbtf","transporte regular","voo doméstico",75,75,150,1630,1597,3227,0,0,0,0
"2970",2013-01-01,"sbtf","transporte regular","voo internacional",0,0,0,0,0,0,0,0,0,0
"2971",2013-01-01,"sbtf","transporte não regular","voo doméstico",242,242,484,579,535,1114,2843,4742,7585,23571
"2972",2013-01-01,"sbtf","transporte não regular","voo internacional",0,0,0,0,0,0,0,0,0,0
"2973",2013-01-01,"sbtt","transporte regular","voo doméstico",63,63,126,2187,2540,4727,0,0,0,0
"2974",2013-01-01,"sbtt","transporte regular","voo internacional",0,0,0,0,0,0,0,0,0,0
"2975",2013-01-01,"sbtt","transporte não regular","voo doméstico",41,39,80,147,129,276,1876,3023,4899,984
"2976",2013-01-01,"sbtt","transporte não regular","voo internacional",1,1,2,6,6,12,0,0,0,0
"2977",2013-01-01,"sbuf","transporte regular","voo doméstico",0,0,0,0,0,0,0,0,0,0
"2978",2013-01-01,"sbuf","transporte regular","voo internacional",0,0,0,0,0,0,0,0,0,0
"2979",2013-01-01,"sbuf","transporte não regular","voo doméstico",45,45,90,135,123,258,0,0,0,0
"2980",2013-01-01,"sbuf","transporte não regular","voo internacional",0,0,0,0,0,0,0,0,0,0
"2981",2013-01-01,"sbug","transporte regular","voo doméstico",20,20,40,92,95,187,0,0,0,0
"2982",2013-01-01,"sbug","transporte regular","voo internacional",0,0,0,0,0,0,0,0,0,0
"2983",2013-01-01,"sbug","transporte não regular","voo doméstico",10,10,20,21,14,35,0,0,0,0
"2984",2013-01-01,"sbug","transporte não regular","voo internacional",0,0,0,0,0,0,0,0,0,0
"2985",2013-01-01,"sbul","transporte regular","voo doméstico",629,626,1255,38763,37741,76504,0,0,0,0
"2986",2013-01-01,"sbul","transporte regular","voo internacional",0,0,0,0,0,0,0,0,0,0
"2987",2013-01-01,"sbul","transporte não regular","voo doméstico",495,495,990,3075,2709,5784,0,0,0,0
"2988",2013-01-01,"sbul","transporte não regular","voo internacional",1,1,2,10,7,17,0,0,0,0
"2989",2013-01-01,"sbur","transporte regular","voo doméstico",150,146,296,5203,5175,10378,0,0,0,0
"2990",2013-01-01,"sbur","transporte regular","voo internacional",0,0,0,0,0,0,0,0,0,0
"2991",2013-01-01,"sbur","transporte não regular","voo doméstico",134,140,274,614,733,1347,0,0,0,0
"2992",2013-01-01,"sbur","transporte não regular","voo internacional",1,1,2,0,0,0,0,0,0,0
"2993",2013-07-01,"sbbe","transporte regular","voo doméstico",1771,1774,3545,167522,165417,332939,0,17565,17565,0
"2994",2013-07-01,"sbbe","transporte regular","voo internacional",22,21,43,1748,2305,4053,0,1,1,0
"2995",2013-07-01,"sbbe","transporte não regular","voo doméstico",616,620,1236,3673,3537,7210,110784,352623,463407,0
"2996",2013-07-01,"sbbe","transporte não regular","voo internacional",9,15,24,24,16,40,0,0,0,0
"2997",2013-07-01,"sbbg","transporte regular","voo doméstico",0,0,0,0,0,0,0,0,0,0
"2998",2013-07-01,"sbbg","transporte regular","voo internacional",0,0,0,0,0,0,0,0,0,0
"2999",2013-07-01,"sbbg","transporte não regular","voo doméstico",21,22,43,120,115,235,0,0,0,0
"3000",2013-07-01,"sbbg","transporte não regular","voo internacional",1,0,1,0,5,5,0,0,0,0
"3001",2013-07-01,"sbbh","transporte regular","voo doméstico",709,711,1420,33671,38330,72001,0,0,0,0
"3002",2013-07-01,"sbbh","transporte regular","voo internacional",0,0,0,0,0,0,0,0,0,0
"3003",2013-07-01,"sbbh","transporte não regular","voo doméstico",2123,2117,4240,9305,9168,18473,0,0,0,0
"3004",2013-07-01,"sbbh","transporte não regular","voo internacional",17,15,32,68,84,152,0,0,0,0
"3005",2013-07-01,"sbbi","transporte regular","voo doméstico",0,0,0,0,0,0,0,0,0,0
"3006",2013-07-01,"sbbi","transporte regular","voo internacional",0,0,0,0,0,0,0,0,0,0
"3007",2013-07-01,"sbbi","transporte não regular","voo doméstico",954,943,1897,2312,1967,4279,0,0,0,0
"3008",2013-07-01,"sbbi","transporte não regular","voo internacional",1,0,1,0,0,0,0,0,0,0
"3009",2013-07-01,"sbbv","transporte regular","voo doméstico",146,146,292,17099,16656,33755,0,0,0,0
"3010",2013-07-01,"sbbv","transporte regular","voo internacional",0,0,0,0,0,0,0,0,0,0
"3011",2013-07-01,"sbbv","transporte não regular","voo doméstico",108,109,217,162,81,243,0,0,0,0
"3012",2013-07-01,"sbbv","transporte não regular","voo internacional",25,21,46,11,8,19,0,0,0,0
"3013",2013-07-01,"sbcg","transporte regular","voo doméstico",740,740,1480,75820,73226,149046,68318,172513,240831,0
"3014",2013-07-01,"sbcg","transporte regular","voo internacional",0,0,0,0,0,0,0,0,0,0
"3015",2013-07-01,"sbcg","transporte não regular","voo doméstico",461,461,922,1581,1557,3138,5257,7682,12939,0
"3016",2013-07-01,"sbcg","transporte não regular","voo internacional",15,16,31,0,0,0,0,0,0,0
"3017",2013-07-01,"sbcj","transporte regular","voo doméstico",109,109,218,4878,4412,9290,0,0,0,0
"3018",2013-07-01,"sbcj","transporte regular","voo internacional",0,0,0,0,0,0,0,0,0,0
"3019",2013-07-01,"sbcj","transporte não regular","voo doméstico",126,124,250,769,440,1209,0,0,0,0
"3020",2013-07-01,"sbcj","transporte não regular","voo internacional",7,7,14,0,0,0,0,0,0,0
"3021",2013-07-01,"sbcr","transporte regular","voo doméstico",23,23,46,981,1038,2019,0,0,0,0
"3022",2013-07-01,"sbcr","transporte regular","voo internacional",0,0,0,0,0,0,0,0,0,0
"3023",2013-07-01,"sbcr","transporte não regular","voo doméstico",35,36,71,134,147,281,0,0,0,0
"3024",2013-07-01,"sbcr","transporte não regular","voo internacional",0,1,1,0,0,0,0,0,0,0
"3025",2013-07-01,"sbct","transporte regular","voo doméstico",3051,3081,6132,296998,289864,586862,128616,48263,176879,217912
"3026",2013-07-01,"sbct","transporte regular","voo internacional",58,60,118,3237,2797,6034,0,0,0,0
"3027",2013-07-01,"sbct","transporte não regular","voo doméstico",393,357,750,2977,4385,7362,0,0,0,0
"3028",2013-07-01,"sbct","transporte não regular","voo internacional",14,15,29,34,19,53,0,0,0,0
"3029",2013-07-01,"sbcz","transporte regular","voo doméstico",31,31,62,2088,1935,4023,0,0,0,0
"3030",2013-07-01,"sbcz","transporte regular","voo internacional",0,0,0,0,0,0,0,0,0,0
"3031",2013-07-01,"sbcz","transporte não regular","voo doméstico",167,168,335,641,628,1269,1960,6585,8545,0
"3032",2013-07-01,"sbcz","transporte não regular","voo internacional",1,1,2,0,0,0,0,0,0,0
"3033",2013-07-01,"sbeg","transporte regular","voo doméstico",1369,1364,2733,126890,124956,251846,0,0,0,0
"3034",2013-07-01,"sbeg","transporte regular","voo internacional",124,125,249,9130,10547,19677,0,0,0,0
"3035",2013-07-01,"sbeg","transporte não regular","voo doméstico",755,752,1507,7431,9804,17235,0,0,0,0
"3036",2013-07-01,"sbeg","transporte não regular","voo internacional",221,223,444,303,25,328,0,0,0,0
"3037",2013-07-01,"sbfi","transporte regular","voo doméstico",639,643,1282,66912,69050,135962,0,0,0,0
"3038",2013-07-01,"sbfi","transporte regular","voo internacional",17,17,34,1887,2368,4255,0,0,0,0
"3039",2013-07-01,"sbfi","transporte não regular","voo doméstico",176,177,353,1784,2325,4109,0,0,0,0
"3040",2013-07-01,"sbfi","transporte não regular","voo internacional",51,45,96,368,349,717,0,0,0,0
"3041",2013-07-01,"sbgo","transporte regular","voo doméstico",1401,1397,2798,136698,134064,270762,110428,175378,285806,191727
"3042",2013-07-01,"sbgo","transporte regular","voo internacional",0,0,0,0,0,0,0,0,0,0
"3043",2013-07-01,"sbgo","transporte não regular","voo doméstico",1440,1421,2861,7557,7301,14858,0,0,0,0
"3044",2013-07-01,"sbgo","transporte não regular","voo internacional",6,4,10,20,30,50,0,0,0,0
"3045",2013-07-01,"sbht","transporte regular","voo doméstico",210,209,419,9324,9102,18426,0,0,0,0
"3046",2013-07-01,"sbht","transporte regular","voo internacional",0,0,0,0,0,0,0,0,0,0
"3047",2013-07-01,"sbht","transporte não regular","voo doméstico",206,202,408,483,481,964,7390,15664,23054,1010
"3048",2013-07-01,"sbht","transporte não regular","voo internacional",0,0,0,0,0,0,0,0,0,0
"3049",2013-07-01,"sbiz","transporte regular","voo doméstico",186,185,371,16013,16754,32767,0,0,0,0
"3050",2013-07-01,"sbiz","transporte regular","voo internacional",0,0,0,0,0,0,0,0,0,0
"3051",2013-07-01,"sbiz","transporte não regular","voo doméstico",170,163,333,1621,1674,3295,0,0,0,0
"3052",2013-07-01,"sbiz","transporte não regular","voo internacional",0,0,0,0,0,0,0,0,0,0
"3053",2013-07-01,"sbjc","transporte regular","voo doméstico",0,0,0,0,0,0,0,0,0,0
"3054",2013-07-01,"sbjc","transporte regular","voo internacional",0,0,0,0,0,0,0,0,0,0
"3055",2013-07-01,"sbjc","transporte não regular","voo doméstico",612,610,1222,1266,911,2177,0,0,0,0
"3056",2013-07-01,"sbjc","transporte não regular","voo internacional",0,0,0,0,0,0,0,0,0,0
"3057",2013-07-01,"sbjr","transporte regular","voo doméstico",0,0,0,0,0,0,0,0,0,0
"3058",2013-07-01,"sbjr","transporte regular","voo internacional",0,0,0,0,0,0,0,0,0,0
"3059",2013-07-01,"sbjr","transporte não regular","voo doméstico",2780,2776,5556,8156,3820,11976,0,0,0,0
"3060",2013-07-01,"sbjr","transporte não regular","voo internacional",0,0,0,0,0,0,0,0,0,0
"3061",2013-07-01,"sbjv","transporte regular","voo doméstico",178,180,358,15442,15195,30637,0,0,0,0
"3062",2013-07-01,"sbjv","transporte regular","voo internacional",0,0,0,0,0,0,0,0,0,0
"3063",2013-07-01,"sbjv","transporte não regular","voo doméstico",188,183,371,166,599,765,0,0,0,0
"3064",2013-07-01,"sbjv","transporte não regular","voo internacional",0,0,0,0,0,0,0,0,0,0
"3065",2013-07-01,"sblo","transporte regular","voo doméstico",545,546,1091,46340,45440,91780,0,0,0,0
"3066",2013-07-01,"sblo","transporte regular","voo internacional",0,0,0,0,0,0,0,0,0,0
"3067",2013-07-01,"sblo","transporte não regular","voo doméstico",842,843,1685,491,968,1459,0,0,0,0
"3068",2013-07-01,"sblo","transporte não regular","voo internacional",0,0,0,0,0,0,0,0,0,0
"3069",2013-07-01,"sbma","transporte regular","voo doméstico",431,432,863,20255,21403,41658,0,0,0,0
"3070",2013-07-01,"sbma","transporte regular","voo internacional",0,0,0,0,0,0,0,0,0,0
"3071",2013-07-01,"sbma","transporte não regular","voo doméstico",385,385,770,1531,1534,3065,0,0,0,0
"3072",2013-07-01,"sbma","transporte não regular","voo internacional",3,3,6,0,0,0,0,0,0,0
"3073",2013-07-01,"sbmk","transporte regular","voo doméstico",205,205,410,13848,13413,27261,0,0,0,0
"3074",2013-07-01,"sbmk","transporte regular","voo internacional",0,0,0,0,0,0,0,0,0,0
"3075",2013-07-01,"sbmk","transporte não regular","voo doméstico",250,254,504,48,34,82,0,0,0,0
"3076",2013-07-01,"sbmk","transporte não regular","voo internacional",1,1,2,0,0,0,0,0,0,0
"3077",2013-07-01,"sbmq","transporte regular","voo doméstico",351,351,702,35065,32956,68021,0,0,0,0
"3078",2013-07-01,"sbmq","transporte regular","voo internacional",0,0,0,0,0,0,0,0,0,0
"3079",2013-07-01,"sbmq","transporte não regular","voo doméstico",206,209,415,428,240,668,0,0,0,0
"3080",2013-07-01,"sbmq","transporte não regular","voo internacional",8,7,15,0,0,0,0,0,0,0
"3081",2013-07-01,"sbmt","transporte regular","voo doméstico",0,0,0,0,0,0,0,0,0,0
"3082",2013-07-01,"sbmt","transporte regular","voo internacional",0,0,0,0,0,0,0,0,0,0
"3083",2013-07-01,"sbmt","transporte não regular","voo doméstico",5472,5431,10903,8294,10946,19240,0,0,0,0
"3084",2013-07-01,"sbmt","transporte não regular","voo internacional",2,1,3,0,0,0,0,0,0,0
"3085",2013-07-01,"sbnf","transporte regular","voo doméstico",528,529,1057,50178,48128,98306,0,0,0,0
"3086",2013-07-01,"sbnf","transporte regular","voo internacional",0,0,0,0,0,0,0,0,0,0
"3087",2013-07-01,"sbnf","transporte não regular","voo doméstico",446,442,888,1818,2239,4057,0,0,0,0
"3088",2013-07-01,"sbnf","transporte não regular","voo internacional",2,0,2,0,0,0,0,0,0,0
"3089",2013-07-01,"sbpb","transporte regular","voo doméstico",0,0,0,0,0,0,0,0,0,0
"3090",2013-07-01,"sbpb","transporte regular","voo internacional",0,0,0,0,0,0,0,0,0,0
"3091",2013-07-01,"sbpb","transporte não regular","voo doméstico",73,73,146,135,136,271,0,0,0,0
"3092",2013-07-01,"sbpb","transporte não regular","voo internacional",0,0,0,0,0,0,0,0,0,0
"3093",2013-07-01,"sbpj","transporte regular","voo doméstico",373,374,747,29274,29081,58355,0,0,0,0
"3094",2013-07-01,"sbpj","transporte regular","voo internacional",0,0,0,0,0,0,0,0,0,0
"3095",2013-07-01,"sbpj","transporte não regular","voo doméstico",538,534,1072,815,465,1280,29450,33755,63205,0
"3096",2013-07-01,"sbpj","transporte não regular","voo internacional",1,1,2,0,0,0,0,0,0,0
"3097",2013-07-01,"sbpk","transporte regular","voo doméstico",75,75,150,1347,1172,2519,0,0,0,0
"3098",2013-07-01,"sbpk","transporte regular","voo internacional",0,0,0,0,0,0,0,0,0,0
"3099",2013-07-01,"sbpk","transporte não regular","voo doméstico",34,34,68,116,115,231,0,0,0,0
"3100",2013-07-01,"sbpk","transporte não regular","voo internacional",2,1,3,0,0,0,0,0,0,0
"3101",2013-07-01,"sbpl","transporte regular","voo doméstico",241,242,483,21219,20892,42111,0,0,0,0
"3102",2013-07-01,"sbpl","transporte regular","voo internacional",5,5,10,0,0,0,0,0,0,0
"3103",2013-07-01,"sbpl","transporte não regular","voo doméstico",84,84,168,136,117,253,0,0,0,0
"3104",2013-07-01,"sbpl","transporte não regular","voo internacional",0,0,0,0,0,0,0,0,0,0
"3105",2013-07-01,"sbpp","transporte regular","voo doméstico",0,0,0,0,0,0,0,0,0,0
"3106",2013-07-01,"sbpp","transporte regular","voo internacional",0,0,0,0,0,0,0,0,0,0
"3107",2013-07-01,"sbpp","transporte não regular","voo doméstico",106,107,213,201,197,398,0,0,0,0
"3108",2013-07-01,"sbpp","transporte não regular","voo internacional",11,11,22,32,38,70,0,0,0,0
"3109",2013-07-01,"sbpr","transporte regular","voo doméstico",0,0,0,0,0,0,0,0,0,0
"3110",2013-07-01,"sbpr","transporte regular","voo internacional",0,0,0,0,0,0,0,0,0,0
"3111",2013-07-01,"sbpr","transporte não regular","voo doméstico",1611,1610,3221,1789,1177,2966,0,0,0,0
"3112",2013-07-01,"sbpr","transporte não regular","voo internacional",1,0,1,0,0,0,0,0,0,0
"3113",2013-07-01,"sbpv","transporte regular","voo doméstico",497,499,996,43702,41995,85697,56178,219396,275574,0
"3114",2013-07-01,"sbpv","transporte regular","voo internacional",0,0,0,0,0,0,0,0,0,0
"3115",2013-07-01,"sbpv","transporte não regular","voo doméstico",314,310,624,41,196,237,0,0,0,0
"3116",2013-07-01,"sbpv","transporte não regular","voo internacional",0,0,0,0,0,0,0,0,0,0
"3117",2013-07-01,"sbrb","transporte regular","voo doméstico",162,161,323,16488,16415,32903,0,0,0,0
"3118",2013-07-01,"sbrb","transporte regular","voo internacional",0,0,0,0,0,0,0,0,0,0
"3119",2013-07-01,"sbrb","transporte não regular","voo doméstico",321,317,638,777,636,1413,0,0,0,0
"3120",2013-07-01,"sbrb","transporte não regular","voo internacional",0,0,0,0,0,0,0,0,0,0
"3121",2013-07-01,"sbrj","transporte regular","voo doméstico",4225,4261,8486,400459,374771,775230,0,0,0,0
"3122",2013-07-01,"sbrj","transporte regular","voo internacional",0,0,0,0,0,0,0,0,0,0
"3123",2013-07-01,"sbrj","transporte não regular","voo doméstico",827,797,1624,2179,3049,5228,0,0,0,0
"3124",2013-07-01,"sbrj","transporte não regular","voo internacional",3,3,6,0,0,0,0,0,0,0
"3125",2013-07-01,"sbsj","transporte regular","voo doméstico",104,105,209,5178,4953,10131,0,0,0,0
"3126",2013-07-01,"sbsj","transporte regular","voo internacional",0,0,0,0,0,0,0,0,0,0
"3127",2013-07-01,"sbsj","transporte não regular","voo doméstico",611,604,1215,1691,1702,3393,0,0,0,0
"3128",2013-07-01,"sbsj","transporte não regular","voo internacional",5,15,20,46,10,56,0,0,0,0
"3129",2013-07-01,"sbsl","transporte regular","voo doméstico",791,791,1582,88253,89584,177837,126,0,126,0
"3130",2013-07-01,"sbsl","transporte regular","voo internacional",0,0,0,0,0,0,0,0,0,0
"3131",2013-07-01,"sbsl","transporte não regular","voo doméstico",493,494,987,1064,737,1801,85469,191925,277394,0
"3132",2013-07-01,"sbsl","transporte não regular","voo internacional",1,2,3,4,0,4,0,0,0,0
"3133",2013-07-01,"sbsn","transporte regular","voo doméstico",384,381,765,25225,22248,47473,0,0,0,0
"3134",2013-07-01,"sbsn","transporte regular","voo internacional",0,0,0,0,0,0,0,0,0,0
"3135",2013-07-01,"sbsn","transporte não regular","voo doméstico",425,434,859,1334,745,2079,0,0,0,0
"3136",2013-07-01,"sbsn","transporte não regular","voo internacional",1,1,2,0,0,0,0,0,0,0
"3137",2013-07-01,"sbsp","transporte regular","voo doméstico",6656,6757,13413,737103,735237,1472340,0,0,0,0
"3138",2013-07-01,"sbsp","transporte regular","voo internacional",0,0,0,0,0,0,0,0,0,0
"3139",2013-07-01,"sbsp","transporte não regular","voo doméstico",1962,1842,3804,12647,16442,29089,0,0,0,0
"3140",2013-07-01,"sbsp","transporte não regular","voo internacional",0,0,0,0,0,0,0,0,0,0
"3141",2013-07-01,"sbte","transporte regular","voo doméstico",469,469,938,52943,53612,106555,20121,75529,95650,256598
"3142",2013-07-01,"sbte","transporte regular","voo internacional",0,0,0,0,0,0,0,0,0,0
"3143",2013-07-01,"sbte","transporte não regular","voo doméstico",252,250,502,1179,1180,2359,0,0,0,0
"3144",2013-07-01,"sbte","transporte não regular","voo internacional",0,0,0,0,0,0,0,0,0,0
"3145",2013-07-01,"sbtf","transporte regular","voo doméstico",75,75,150,1902,2147,4049,0,0,0,0
"3146",2013-07-01,"sbtf","transporte regular","voo internacional",0,0,0,0,0,0,0,0,0,0
"3147",2013-07-01,"sbtf","transporte não regular","voo doméstico",204,204,408,591,537,1128,2315,4915,7230,24620
"3148",2013-07-01,"sbtf","transporte não regular","voo internacional",0,0,0,0,0,0,0,0,0,0
"3149",2013-07-01,"sbtt","transporte regular","voo doméstico",40,40,80,1793,2038,3831,0,0,0,0
"3150",2013-07-01,"sbtt","transporte regular","voo internacional",0,0,0,0,0,0,0,0,0,0
"3151",2013-07-01,"sbtt","transporte não regular","voo doméstico",60,58,118,262,270,532,2585,3951,6536,804
"3152",2013-07-01,"sbtt","transporte não regular","voo internacional",2,3,5,8,8,16,0,0,0,0
"3153",2013-07-01,"sbuf","transporte regular","voo doméstico",0,0,0,0,0,0,0,0,0,0
"3154",2013-07-01,"sbuf","transporte regular","voo internacional",0,0,0,0,0,0,0,0,0,0
"3155",2013-07-01,"sbuf","transporte não regular","voo doméstico",53,52,105,142,150,292,0,0,0,0
"3156",2013-07-01,"sbuf","transporte não regular","voo internacional",0,0,0,0,0,0,0,0,0,0
"3157",2013-07-01,"sbug","transporte regular","voo doméstico",0,0,0,0,0,0,0,0,0,0
"3158",2013-07-01,"sbug","transporte regular","voo internacional",0,0,0,0,0,0,0,0,0,0
"3159",2013-07-01,"sbug","transporte não regular","voo doméstico",22,22,44,38,25,63,0,0,0,0
"3160",2013-07-01,"sbug","transporte não regular","voo internacional",2,2,4,0,0,0,0,0,0,0
"3161",2013-07-01,"sbul","transporte regular","voo doméstico",569,554,1123,47627,47146,94773,0,0,0,0
"3162",2013-07-01,"sbul","transporte regular","voo internacional",0,0,0,0,0,0,0,0,0,0
"3163",2013-07-01,"sbul","transporte não regular","voo doméstico",724,752,1476,2863,1951,4814,0,0,0,0
"3164",2013-07-01,"sbul","transporte não regular","voo internacional",0,0,0,0,0,0,0,0,0,0
"3165",2013-07-01,"sbur","transporte regular","voo doméstico",121,121,242,5239,5214,10453,0,0,0,0
"3166",2013-07-01,"sbur","transporte regular","voo internacional",0,0,0,0,0,0,0,0,0,0
"3167",2013-07-01,"sbur","transporte não regular","voo doméstico",179,172,351,539,573,1112,0,0,0,0
"3168",2013-07-01,"sbur","transporte não regular","voo internacional",0,0,0,0,0,0,0,0,0,0
"3169",2013-06-01,"sbbe","transporte regular","voo doméstico",1575,1580,3155,138751,135553,274304,97260,316986,414246,0
"3170",2013-06-01,"sbbe","transporte regular","voo internacional",17,17,34,1607,1761,3368,0,108,108,0
"3171",2013-06-01,"sbbe","transporte não regular","voo doméstico",559,552,1111,2420,2438,4858,0,0,0,0
"3172",2013-06-01,"sbbe","transporte não regular","voo internacional",11,10,21,40,8,48,0,0,0,0
"3173",2013-06-01,"sbbg","transporte regular","voo doméstico",0,0,0,0,0,0,0,0,0,0
"3174",2013-06-01,"sbbg","transporte regular","voo internacional",0,0,0,0,0,0,0,0,0,0
"3175",2013-06-01,"sbbg","transporte não regular","voo doméstico",15,15,30,75,65,140,0,0,0,0
"3176",2013-06-01,"sbbg","transporte não regular","voo internacional",0,1,1,6,0,6,0,0,0,0
"3177",2013-06-01,"sbbh","transporte regular","voo doméstico",679,683,1362,30139,35169,65308,0,0,0,0
"3178",2013-06-01,"sbbh","transporte regular","voo internacional",0,0,0,0,0,0,0,0,0,0
"3179",2013-06-01,"sbbh","transporte não regular","voo doméstico",2124,2090,4214,9422,9657,19079,0,0,0,0
"3180",2013-06-01,"sbbh","transporte não regular","voo internacional",9,8,17,35,40,75,0,0,0,0
"3181",2013-06-01,"sbbi","transporte regular","voo doméstico",0,0,0,0,0,0,0,0,0,0
"3182",2013-06-01,"sbbi","transporte regular","voo internacional",0,0,0,0,0,0,0,0,0,0
"3183",2013-06-01,"sbbi","transporte não regular","voo doméstico",715,711,1426,1989,1953,3942,0,0,0,0
"3184",2013-06-01,"sbbi","transporte não regular","voo internacional",1,1,2,0,0,0,0,0,0,0
"3185",2013-06-01,"sbbv","transporte regular","voo doméstico",131,131,262,15519,14803,30322,0,0,0,0
"3186",2013-06-01,"sbbv","transporte regular","voo internacional",0,0,0,0,0,0,0,0,0,0
"3187",2013-06-01,"sbbv","transporte não regular","voo doméstico",114,110,224,270,173,443,0,0,0,0
"3188",2013-06-01,"sbbv","transporte não regular","voo internacional",21,24,45,5,6,11,0,0,0,0
"3189",2013-06-01,"sbcg","transporte regular","voo doméstico",679,687,1366,66350,62749,129099,50825,75433,126258,0
"3190",2013-06-01,"sbcg","transporte regular","voo internacional",0,0,0,0,0,0,0,0,0,0
"3191",2013-06-01,"sbcg","transporte não regular","voo doméstico",362,355,717,726,1617,2343,35877,78427,114304,0
"3192",2013-06-01,"sbcg","transporte não regular","voo internacional",20,20,40,0,0,0,0,0,0,0
"3193",2013-06-01,"sbcj","transporte regular","voo doméstico",94,94,188,4106,3895,8001,0,0,0,0
"3194",2013-06-01,"sbcj","transporte regular","voo internacional",0,0,0,0,0,0,0,0,0,0
"3195",2013-06-01,"sbcj","transporte não regular","voo doméstico",121,122,243,537,425,962,0,0,0,0
"3196",2013-06-01,"sbcj","transporte não regular","voo internacional",0,0,0,0,0,0,0,0,0,0
"3197",2013-06-01,"sbcr","transporte regular","voo doméstico",21,21,42,918,929,1847,0,0,0,0
"3198",2013-06-01,"sbcr","transporte regular","voo internacional",0,0,0,0,0,0,0,0,0,0
"3199",2013-06-01,"sbcr","transporte não regular","voo doméstico",42,41,83,120,91,211,0,0,0,0
"3200",2013-06-01,"sbcr","transporte não regular","voo internacional",3,3,6,3,0,3,0,0,0,0
"3201",2013-06-01,"sbct","transporte regular","voo doméstico",2748,2795,5543,262976,253361,516337,125443,73224,198667,215936
"3202",2013-06-01,"sbct","transporte regular","voo internacional",64,65,129,2461,2327,4788,0,0,0,0
"3203",2013-06-01,"sbct","transporte não regular","voo doméstico",374,336,710,4844,8040,12884,0,0,0,0
"3204",2013-06-01,"sbct","transporte não regular","voo internacional",21,18,39,14,17,31,0,0,0,0
"3205",2013-06-01,"sbcz","transporte regular","voo doméstico",30,30,60,2435,2383,4818,0,0,0,0
"3206",2013-06-01,"sbcz","transporte regular","voo internacional",0,0,0,0,0,0,0,0,0,0
"3207",2013-06-01,"sbcz","transporte não regular","voo doméstico",164,166,330,589,553,1142,1450,6050,7500,0
"3208",2013-06-01,"sbcz","transporte não regular","voo internacional",1,1,2,0,0,0,0,0,0,0
"3209",2013-06-01,"sbeg","transporte regular","voo doméstico",1268,1275,2543,114104,103415,217519,0,0,0,0
"3210",2013-06-01,"sbeg","transporte regular","voo internacional",122,119,241,6822,7210,14032,0,0,0,0
"3211",2013-06-01,"sbeg","transporte não regular","voo doméstico",863,865,1728,8067,6549,14616,0,0,0,0
"3212",2013-06-01,"sbeg","transporte não regular","voo internacional",170,165,335,0,0,0,0,0,0,0
"3213",2013-06-01,"sbfi","transporte regular","voo doméstico",563,567,1130,61418,60479,121897,0,0,0,0
"3214",2013-06-01,"sbfi","transporte regular","voo internacional",17,17,34,2285,2371,4656,0,0,0,0
"3215",2013-06-01,"sbfi","transporte não regular","voo doméstico",150,151,301,1850,2242,4092,0,0,0,0
"3216",2013-06-01,"sbfi","transporte não regular","voo internacional",46,44,90,226,260,486,0,0,0,0
"3217",2013-06-01,"sbgo","transporte regular","voo doméstico",1165,1165,2330,112516,108862,221378,32112,100270,132382,54287
"3218",2013-06-01,"sbgo","transporte regular","voo internacional",0,0,0,0,0,0,0,0,0,0
"3219",2013-06-01,"sbgo","transporte não regular","voo doméstico",1293,1275,2568,6464,6490,12954,53334,75560,128894,94952
"3220",2013-06-01,"sbgo","transporte não regular","voo internacional",9,6,15,30,45,75,0,0,0,0
"3221",2013-06-01,"sbht","transporte regular","voo doméstico",155,156,311,7081,7163,14244,0,0,0,0
"3222",2013-06-01,"sbht","transporte regular","voo internacional",1,1,2,0,0,0,0,0,0,0
"3223",2013-06-01,"sbht","transporte não regular","voo doméstico",158,158,316,366,272,638,7927,14580,22507,6245
"3224",2013-06-01,"sbht","transporte não regular","voo internacional",0,0,0,0,0,0,0,0,0,0
"3225",2013-06-01,"sbiz","transporte regular","voo doméstico",172,171,343,14654,15184,29838,0,0,0,0
"3226",2013-06-01,"sbiz","transporte regular","voo internacional",0,0,0,0,0,0,0,0,0,0
"3227",2013-06-01,"sbiz","transporte não regular","voo doméstico",169,170,339,1531,1545,3076,0,0,0,0
"3228",2013-06-01,"sbiz","transporte não regular","voo internacional",0,0,0,0,0,0,0,0,0,0
"3229",2013-06-01,"sbjc","transporte regular","voo doméstico",0,0,0,0,0,0,0,0,0,0
"3230",2013-06-01,"sbjc","transporte regular","voo internacional",0,0,0,0,0,0,0,0,0,0
"3231",2013-06-01,"sbjc","transporte não regular","voo doméstico",585,585,1170,1203,1159,2362,0,0,0,0
"3232",2013-06-01,"sbjc","transporte não regular","voo internacional",0,0,0,0,0,0,0,0,0,0
"3233",2013-06-01,"sbjr","transporte regular","voo doméstico",0,0,0,0,0,0,0,0,0,0
"3234",2013-06-01,"sbjr","transporte regular","voo internacional",0,0,0,0,0,0,0,0,0,0
"3235",2013-06-01,"sbjr","transporte não regular","voo doméstico",3448,3420,6868,8468,4264,12732,0,0,0,0
"3236",2013-06-01,"sbjr","transporte não regular","voo internacional",0,0,0,0,0,0,0,0,0,0
"3237",2013-06-01,"sbjv","transporte regular","voo doméstico",166,170,336,13698,13481,27179,0,0,0,0
"3238",2013-06-01,"sbjv","transporte regular","voo internacional",0,0,0,0,0,0,0,0,0,0
"3239",2013-06-01,"sbjv","transporte não regular","voo doméstico",163,159,322,54,908,962,0,0,0,0
"3240",2013-06-01,"sbjv","transporte não regular","voo internacional",0,0,0,0,0,0,0,0,0,0
"3241",2013-06-01,"sblo","transporte regular","voo doméstico",466,469,935,40185,38732,78917,0,0,0,0
"3242",2013-06-01,"sblo","transporte regular","voo internacional",0,0,0,0,0,0,0,0,0,0
"3243",2013-06-01,"sblo","transporte não regular","voo doméstico",569,569,1138,900,1959,2859,0,0,0,0
"3244",2013-06-01,"sblo","transporte não regular","voo internacional",2,2,4,0,0,0,0,0,0,0
"3245",2013-06-01,"sbma","transporte regular","voo doméstico",402,401,803,19511,19267,38778,0,0,0,0
"3246",2013-06-01,"sbma","transporte regular","voo internacional",0,0,0,0,0,0,0,0,0,0
"3247",2013-06-01,"sbma","transporte não regular","voo doméstico",326,323,649,1159,1099,2258,0,0,0,0
"3248",2013-06-01,"sbma","transporte não regular","voo internacional",1,1,2,0,0,0,0,0,0,0
"3249",2013-06-01,"sbmk","transporte regular","voo doméstico",199,197,396,12654,12822,25476,0,0,0,0
"3250",2013-06-01,"sbmk","transporte regular","voo internacional",0,0,0,0,0,0,0,0,0,0
"3251",2013-06-01,"sbmk","transporte não regular","voo doméstico",259,256,515,64,58,122,0,0,0,0
"3252",2013-06-01,"sbmk","transporte não regular","voo internacional",0,0,0,0,0,0,0,0,0,0
"3253",2013-06-01,"sbmq","transporte regular","voo doméstico",308,309,617,27204,26259,53463,0,1000,1000,0
"3254",2013-06-01,"sbmq","transporte regular","voo internacional",0,0,0,0,0,0,0,0,0,0
"3255",2013-06-01,"sbmq","transporte não regular","voo doméstico",196,192,388,216,138,354,0,0,0,0
"3256",2013-06-01,"sbmq","transporte não regular","voo internacional",6,6,12,0,0,0,0,0,0,0
"3257",2013-06-01,"sbmt","transporte regular","voo doméstico",0,0,0,0,0,0,0,0,0,0
"3258",2013-06-01,"sbmt","transporte regular","voo internacional",0,0,0,0,0,0,0,0,0,0
"3259",2013-06-01,"sbmt","transporte não regular","voo doméstico",5431,5429,10860,10774,10862,21636,0,0,0,0
"3260",2013-06-01,"sbmt","transporte não regular","voo internacional",0,0,0,0,0,0,0,0,0,0
"3261",2013-06-01,"sbnf","transporte regular","voo doméstico",495,494,989,40928,39929,80857,0,0,0,0
"3262",2013-06-01,"sbnf","transporte regular","voo internacional",0,0,0,0,0,0,0,0,0,0
"3263",2013-06-01,"sbnf","transporte não regular","voo doméstico",415,423,838,1362,1961,3323,0,0,0,0
"3264",2013-06-01,"sbnf","transporte não regular","voo internacional",2,1,3,0,2,2,0,0,0,0
"3265",2013-06-01,"sbpb","transporte regular","voo doméstico",0,0,0,0,0,0,0,0,0,0
"3266",2013-06-01,"sbpb","transporte regular","voo internacional",0,0,0,0,0,0,0,0,0,0
"3267",2013-06-01,"sbpb","transporte não regular","voo doméstico",43,47,90,116,84,200,0,0,0,0
"3268",2013-06-01,"sbpb","transporte não regular","voo internacional",0,0,0,0,0,0,0,0,0,0
"3269",2013-06-01,"sbpj","transporte regular","voo doméstico",352,348,700,24652,24510,49162,0,0,0,0
"3270",2013-06-01,"sbpj","transporte regular","voo internacional",0,0,0,0,0,0,0,0,0,0
"3271",2013-06-01,"sbpj","transporte não regular","voo doméstico",482,474,956,1678,1189,2867,27150,38865,66015,0
"3272",2013-06-01,"sbpj","transporte não regular","voo internacional",2,2,4,0,0,0,0,0,0,0
"3273",2013-06-01,"sbpk","transporte regular","voo doméstico",68,68,136,1007,855,1862,0,0,0,0
"3274",2013-06-01,"sbpk","transporte regular","voo internacional",0,0,0,0,0,0,0,0,0,0
"3275",2013-06-01,"sbpk","transporte não regular","voo doméstico",32,31,63,97,91,188,0,0,0,0
"3276",2013-06-01,"sbpk","transporte não regular","voo internacional",3,5,8,4,7,11,0,0,0,0
"3277",2013-06-01,"sbpl","transporte regular","voo doméstico",224,222,446,19708,21738,41446,0,0,0,0
"3278",2013-06-01,"sbpl","transporte regular","voo internacional",4,4,8,0,0,0,0,0,0,0
"3279",2013-06-01,"sbpl","transporte não regular","voo doméstico",78,81,159,161,109,270,0,0,0,0
"3280",2013-06-01,"sbpl","transporte não regular","voo internacional",0,0,0,0,0,0,0,0,0,0
"3281",2013-06-01,"sbpp","transporte regular","voo doméstico",0,0,0,0,0,0,0,0,0,0
"3282",2013-06-01,"sbpp","transporte regular","voo internacional",0,0,0,0,0,0,0,0,0,0
"3283",2013-06-01,"sbpp","transporte não regular","voo doméstico",60,61,121,101,101,202,0,0,0,0
"3284",2013-06-01,"sbpp","transporte não regular","voo internacional",4,4,8,7,3,10,0,0,0,0
"3285",2013-06-01,"sbpr","transporte regular","voo doméstico",0,0,0,0,0,0,0,0,0,0
"3286",2013-06-01,"sbpr","transporte regular","voo internacional",0,0,0,0,0,0,0,0,0,0
"3287",2013-06-01,"sbpr","transporte não regular","voo doméstico",1278,1257,2535,1369,1248,2617,0,0,0,0
"3288",2013-06-01,"sbpr","transporte não regular","voo internacional",0,0,0,0,0,0,0,0,0,0
"3289",2013-06-01,"sbpv","transporte regular","voo doméstico",471,469,940,39658,38314,77972,46921,186667,233588,0
"3290",2013-06-01,"sbpv","transporte regular","voo internacional",0,0,0,0,0,0,0,0,0,0
"3291",2013-06-01,"sbpv","transporte não regular","voo doméstico",258,255,513,0,0,0,0,0,0,0
"3292",2013-06-01,"sbpv","transporte não regular","voo internacional",1,1,2,0,0,0,0,0,0,0
"3293",2013-06-01,"sbrb","transporte regular","voo doméstico",154,154,308,15957,15773,31730,0,0,0,0
"3294",2013-06-01,"sbrb","transporte regular","voo internacional",0,0,0,0,0,0,0,0,0,0
"3295",2013-06-01,"sbrb","transporte não regular","voo doméstico",253,250,503,695,468,1163,0,0,0,0
"3296",2013-06-01,"sbrb","transporte não regular","voo internacional",0,0,0,0,0,0,0,0,0,0
"3297",2013-06-01,"sbrj","transporte regular","voo doméstico",3872,3896,7768,347609,343312,690921,0,0,0,0
"3298",2013-06-01,"sbrj","transporte regular","voo internacional",0,0,0,0,0,0,0,0,0,0
"3299",2013-06-01,"sbrj","transporte não regular","voo doméstico",1022,988,2010,2612,2318,4930,0,0,0,0
"3300",2013-06-01,"sbrj","transporte não regular","voo internacional",3,3,6,0,0,0,0,0,0,0
"3301",2013-06-01,"sbsj","transporte regular","voo doméstico",95,97,192,4440,4172,8612,0,0,0,0
"3302",2013-06-01,"sbsj","transporte regular","voo internacional",0,0,0,0,0,0,0,0,0,0
"3303",2013-06-01,"sbsj","transporte não regular","voo doméstico",619,605,1224,2161,1965,4126,0,0,0,0
"3304",2013-06-01,"sbsj","transporte não regular","voo internacional",3,14,17,59,6,65,0,0,0,0
"3305",2013-06-01,"sbsl","transporte regular","voo doméstico",653,653,1306,74001,78773,152774,0,0,0,0
"3306",2013-06-01,"sbsl","transporte regular","voo internacional",0,0,0,0,0,0,0,0,0,0
"3307",2013-06-01,"sbsl","transporte não regular","voo doméstico",421,415,836,1012,884,1896,71398,171070,242468,0
"3308",2013-06-01,"sbsl","transporte não regular","voo internacional",0,0,0,0,0,0,0,0,0,0
"3309",2013-06-01,"sbsn","transporte regular","voo doméstico",362,362,724,20320,18302,38622,0,0,0,0
"3310",2013-06-01,"sbsn","transporte regular","voo internacional",0,0,0,0,0,0,0,0,0,0
"3311",2013-06-01,"sbsn","transporte não regular","voo doméstico",383,381,764,997,588,1585,0,0,0,0
"3312",2013-06-01,"sbsn","transporte não regular","voo internacional",1,1,2,0,0,0,0,0,0,0
"3313",2013-06-01,"sbsp","transporte regular","voo doméstico",6093,6226,12319,684456,646076,1330532,0,0,0,0
"3314",2013-06-01,"sbsp","transporte regular","voo internacional",0,0,0,0,0,0,0,0,0,0
"3315",2013-06-01,"sbsp","transporte não regular","voo doméstico",2336,2218,4554,12658,11853,24511,0,0,0,0
"3316",2013-06-01,"sbsp","transporte não regular","voo internacional",0,0,0,0,0,0,0,0,0,0
"3317",2013-06-01,"sbte","transporte regular","voo doméstico",430,430,860,44118,48697,92815,22783,82946,105729,249510
"3318",2013-06-01,"sbte","transporte regular","voo internacional",0,0,0,0,0,0,0,0,0,0
"3319",2013-06-01,"sbte","transporte não regular","voo doméstico",251,241,492,976,1154,2130,0,0,0,0
"3320",2013-06-01,"sbte","transporte não regular","voo internacional",0,0,0,0,0,0,0,0,0,0
"3321",2013-06-01,"sbtf","transporte regular","voo doméstico",71,71,142,1748,1906,3654,0,0,0,0
"3322",2013-06-01,"sbtf","transporte regular","voo internacional",0,0,0,0,0,0,0,0,0,0
"3323",2013-06-01,"sbtf","transporte não regular","voo doméstico",214,215,429,588,508,1096,3235,3503,6738,19678
"3324",2013-06-01,"sbtf","transporte não regular","voo internacional",0,0,0,0,0,0,0,0,0,0
"3325",2013-06-01,"sbtt","transporte regular","voo doméstico",58,58,116,2055,2291,4346,0,0,0,0
"3326",2013-06-01,"sbtt","transporte regular","voo internacional",0,0,0,0,0,0,0,0,0,0
"3327",2013-06-01,"sbtt","transporte não regular","voo doméstico",56,57,113,282,257,539,2808,4942,7750,856
"3328",2013-06-01,"sbtt","transporte não regular","voo internacional",1,1,2,14,14,28,0,0,0,0
"3329",2013-06-01,"sbuf","transporte regular","voo doméstico",0,0,0,0,0,0,0,0,0,0
"3330",2013-06-01,"sbuf","transporte regular","voo internacional",0,0,0,0,0,0,0,0,0,0
"3331",2013-06-01,"sbuf","transporte não regular","voo doméstico",46,47,93,134,127,261,0,0,0,0
"3332",2013-06-01,"sbuf","transporte não regular","voo internacional",0,0,0,0,0,0,0,0,0,0
"3333",2013-06-01,"sbug","transporte regular","voo doméstico",0,0,0,0,0,0,0,0,0,0
"3334",2013-06-01,"sbug","transporte regular","voo internacional",0,0,0,0,0,0,0,0,0,0
"3335",2013-06-01,"sbug","transporte não regular","voo doméstico",10,10,20,20,16,36,0,0,0,0
"3336",2013-06-01,"sbug","transporte não regular","voo internacional",0,0,0,0,0,0,0,0,0,0
"3337",2013-06-01,"sbul","transporte regular","voo doméstico",548,549,1097,44934,44471,89405,0,0,0,0
"3338",2013-06-01,"sbul","transporte regular","voo internacional",0,0,0,0,0,0,0,0,0,0
"3339",2013-06-01,"sbul","transporte não regular","voo doméstico",672,670,1342,1864,1644,3508,0,0,0,0
"3340",2013-06-01,"sbul","transporte não regular","voo internacional",2,2,4,6,6,12,0,0,0,0
"3341",2013-06-01,"sbur","transporte regular","voo doméstico",114,114,228,4981,5293,10274,0,0,0,0
"3342",2013-06-01,"sbur","transporte regular","voo internacional",0,0,0,0,0,0,0,0,0,0
"3343",2013-06-01,"sbur","transporte não regular","voo doméstico",146,150,296,432,390,822,0,0,0,0
"3344",2013-06-01,"sbur","transporte não regular","voo internacional",1,1,2,0,0,0,0,0,0,0
"3345",2013-05-01,"sbbe","transporte regular","voo doméstico",1670,1676,3346,138326,138104,276430,2,0,2,0
"3346",2013-05-01,"sbbe","transporte regular","voo internacional",18,18,36,1783,1721,3504,0,2,2,0
"3347",2013-05-01,"sbbe","transporte não regular","voo doméstico",506,497,1003,2453,2661,5114,105664,352113,457777,0
"3348",2013-05-01,"sbbe","transporte não regular","voo internacional",16,14,30,32,20,52,0,0,0,0
"3349",2013-05-01,"sbbg","transporte regular","voo doméstico",0,0,0,0,0,0,0,0,0,0
"3350",2013-05-01,"sbbg","transporte regular","voo internacional",0,0,0,0,0,0,0,0,0,0
"3351",2013-05-01,"sbbg","transporte não regular","voo doméstico",15,17,32,96,79,175,0,0,0,0
"3352",2013-05-01,"sbbg","transporte não regular","voo internacional",2,0,2,0,0,0,0,0,0,0
"3353",2013-05-01,"sbbh","transporte regular","voo doméstico",729,728,1457,31756,36546,68302,0,0,0,0
"3354",2013-05-01,"sbbh","transporte regular","voo internacional",0,0,0,0,0,0,0,0,0,0
"3355",2013-05-01,"sbbh","transporte não regular","voo doméstico",2323,2348,4671,9953,9991,19944,0,0,0,0
"3356",2013-05-01,"sbbh","transporte não regular","voo internacional",5,5,10,31,31,62,0,0,0,0
"3357",2013-05-01,"sbbi","transporte regular","voo doméstico",0,0,0,0,0,0,0,0,0,0
"3358",2013-05-01,"sbbi","transporte regular","voo internacional",0,0,0,0,0,0,0,0,0,0
"3359",2013-05-01,"sbbi","transporte não regular","voo doméstico",1005,1013,2018,2944,3913,6857,0,0,0,0
"3360",2013-05-01,"sbbi","transporte não regular","voo internacional",0,0,0,0,0,0,0,0,0,0
"3361",2013-05-01,"sbbv","transporte regular","voo doméstico",139,140,279,15435,14881,30316,0,0,0,0
"3362",2013-05-01,"sbbv","transporte regular","voo internacional",0,0,0,0,0,0,0,0,0,0
"3363",2013-05-01,"sbbv","transporte não regular","voo doméstico",125,129,254,653,458,1111,0,0,0,0
"3364",2013-05-01,"sbbv","transporte não regular","voo internacional",29,23,52,11,13,24,0,0,0,0
"3365",2013-05-01,"sbcg","transporte regular","voo doméstico",722,721,1443,67311,63798,131109,41933,67487,109420,3
"3366",2013-05-01,"sbcg","transporte regular","voo internacional",0,0,0,0,0,0,0,0,0,0
"3367",2013-05-01,"sbcg","transporte não regular","voo doméstico",377,373,750,459,427,886,180,0,180,0
"3368",2013-05-01,"sbcg","transporte não regular","voo internacional",10,11,21,0,0,0,0,0,0,0
"3369",2013-05-01,"sbcj","transporte regular","voo doméstico",101,101,202,4199,3910,8109,0,0,0,0
"3370",2013-05-01,"sbcj","transporte regular","voo internacional",0,0,0,0,0,0,0,0,0,0
"3371",2013-05-01,"sbcj","transporte não regular","voo doméstico",100,100,200,911,691,1602,0,0,0,0
"3372",2013-05-01,"sbcj","transporte não regular","voo internacional",0,0,0,0,0,0,0,0,0,0
"3373",2013-05-01,"sbcr","transporte regular","voo doméstico",23,23,46,1102,1088,2190,0,0,0,0
"3374",2013-05-01,"sbcr","transporte regular","voo internacional",0,0,0,0,0,0,0,0,0,0
"3375",2013-05-01,"sbcr","transporte não regular","voo doméstico",62,61,123,168,162,330,0,0,0,0
"3376",2013-05-01,"sbcr","transporte não regular","voo internacional",2,3,5,11,5,16,0,0,0,0
"3377",2013-05-01,"sbct","transporte regular","voo doméstico",3062,3088,6150,290115,275272,565387,161982,101649,263631,355704
"3378",2013-05-01,"sbct","transporte regular","voo internacional",70,70,140,2419,2124,4543,0,0,0,0
"3379",2013-05-01,"sbct","transporte não regular","voo doméstico",491,456,947,2305,4232,6537,0,0,0,0
"3380",2013-05-01,"sbct","transporte não regular","voo internacional",14,18,32,30,27,57,0,0,0,0
"3381",2013-05-01,"sbcz","transporte regular","voo doméstico",31,31,62,2987,2774,5761,0,0,0,0
"3382",2013-05-01,"sbcz","transporte regular","voo internacional",0,0,0,0,0,0,0,0,0,0
"3383",2013-05-01,"sbcz","transporte não regular","voo doméstico",172,171,343,699,704,1403,0,0,0,0
"3384",2013-05-01,"sbcz","transporte não regular","voo internacional",0,0,0,0,0,0,0,0,0,0
"3385",2013-05-01,"sbeg","transporte regular","voo doméstico",1280,1293,2573,108095,103913,212008,0,0,0,0
"3386",2013-05-01,"sbeg","transporte regular","voo internacional",118,118,236,8460,8720,17180,0,0,0,0
"3387",2013-05-01,"sbeg","transporte não regular","voo doméstico",730,722,1452,6680,6954,13634,0,0,0,0
"3388",2013-05-01,"sbeg","transporte não regular","voo internacional",153,151,304,0,8,8,0,0,0,0
"3389",2013-05-01,"sbfi","transporte regular","voo doméstico",595,597,1192,65654,68897,134551,0,0,0,0
"3390",2013-05-01,"sbfi","transporte regular","voo internacional",18,18,36,2428,2492,4920,0,0,0,0
"3391",2013-05-01,"sbfi","transporte não regular","voo doméstico",162,160,322,882,1380,2262,0,0,0,0
"3392",2013-05-01,"sbfi","transporte não regular","voo internacional",52,50,102,151,184,335,0,0,0,0
"3393",2013-05-01,"sbgo","transporte regular","voo doméstico",1175,1176,2351,113618,113599,227217,4131,97121,101252,7970
"3394",2013-05-01,"sbgo","transporte regular","voo internacional",0,0,0,0,0,0,0,0,0,0
"3395",2013-05-01,"sbgo","transporte não regular","voo doméstico",1391,1406,2797,7055,7036,14091,0,0,0,0
"3396",2013-05-01,"sbgo","transporte não regular","voo internacional",6,5,11,25,30,55,0,0,0,0
"3397",2013-05-01,"sbht","transporte regular","voo doméstico",172,171,343,7862,8418,16280,0,0,0,0
"3398",2013-05-01,"sbht","transporte regular","voo internacional",0,0,0,0,0,0,0,0,0,0
"3399",2013-05-01,"sbht","transporte não regular","voo doméstico",149,151,300,270,225,495,10384,23409,33793,11330
"3400",2013-05-01,"sbht","transporte não regular","voo internacional",1,1,2,0,0,0,0,0,0,0
"3401",2013-05-01,"sbiz","transporte regular","voo doméstico",178,179,357,15144,14768,29912,0,0,0,0
"3402",2013-05-01,"sbiz","transporte regular","voo internacional",0,0,0,0,0,0,0,0,0,0
"3403",2013-05-01,"sbiz","transporte não regular","voo doméstico",175,174,349,1475,1498,2973,0,0,0,0
"3404",2013-05-01,"sbiz","transporte não regular","voo internacional",1,1,2,0,0,0,0,0,0,0
"3405",2013-05-01,"sbjc","transporte regular","voo doméstico",0,0,0,0,0,0,0,0,0,0
"3406",2013-05-01,"sbjc","transporte regular","voo internacional",0,0,0,0,0,0,0,0,0,0
"3407",2013-05-01,"sbjc","transporte não regular","voo doméstico",611,612,1223,1197,1086,2283,0,0,0,0
"3408",2013-05-01,"sbjc","transporte não regular","voo internacional",0,0,0,0,0,0,0,0,0,0
"3409",2013-05-01,"sbjr","transporte regular","voo doméstico",0,0,0,0,0,0,0,0,0,0
"3410",2013-05-01,"sbjr","transporte regular","voo internacional",0,0,0,0,0,0,0,0,0,0
"3411",2013-05-01,"sbjr","transporte não regular","voo doméstico",3430,3432,6862,8853,4517,13370,0,0,0,0
"3412",2013-05-01,"sbjr","transporte não regular","voo internacional",0,0,0,0,0,0,0,0,0,0
"3413",2013-05-01,"sbjv","transporte regular","voo doméstico",179,178,357,15350,14961,30311,0,0,0,0
"3414",2013-05-01,"sbjv","transporte regular","voo internacional",0,0,0,0,0,0,0,0,0,0
"3415",2013-05-01,"sbjv","transporte não regular","voo doméstico",181,181,362,72,217,289,0,0,0,0
"3416",2013-05-01,"sbjv","transporte não regular","voo internacional",0,0,0,0,0,0,0,0,0,0
"3417",2013-05-01,"sblo","transporte regular","voo doméstico",472,469,941,42018,40584,82602,0,0,0,0
"3418",2013-05-01,"sblo","transporte regular","voo internacional",0,0,0,0,0,0,0,0,0,0
"3419",2013-05-01,"sblo","transporte não regular","voo doméstico",801,814,1615,1430,1734,3164,0,0,0,0
"3420",2013-05-01,"sblo","transporte não regular","voo internacional",0,1,1,0,0,0,0,0,0,0
"3421",2013-05-01,"sbma","transporte regular","voo doméstico",461,462,923,23173,21097,44270,0,375,375,0
"3422",2013-05-01,"sbma","transporte regular","voo internacional",0,0,0,0,0,0,0,0,0,0
"3423",2013-05-01,"sbma","transporte não regular","voo doméstico",303,304,607,1647,1545,3192,0,0,0,0
"3424",2013-05-01,"sbma","transporte não regular","voo internacional",2,2,4,0,0,0,0,0,0,0
"3425",2013-05-01,"sbmk","transporte regular","voo doméstico",205,205,410,13174,13055,26229,0,0,0,0
"3426",2013-05-01,"sbmk","transporte regular","voo internacional",0,0,0,0,0,0,0,0,0,0
"3427",2013-05-01,"sbmk","transporte não regular","voo doméstico",231,231,462,77,64,141,0,0,0,0
"3428",2013-05-01,"sbmk","transporte não regular","voo internacional",0,0,0,0,0,0,0,0,0,0
"3429",2013-05-01,"sbmq","transporte regular","voo doméstico",347,347,694,26459,25788,52247,5900,13200,19100,0
"3430",2013-05-01,"sbmq","transporte regular","voo internacional",0,0,0,0,0,0,0,0,0,0
"3431",2013-05-01,"sbmq","transporte não regular","voo doméstico",190,194,384,342,185,527,0,0,0,0
"3432",2013-05-01,"sbmq","transporte não regular","voo internacional",11,10,21,0,0,0,0,0,0,0
"3433",2013-05-01,"sbmt","transporte regular","voo doméstico",0,0,0,0,0,0,0,0,0,0
"3434",2013-05-01,"sbmt","transporte regular","voo internacional",0,0,0,0,0,0,0,0,0,0
"3435",2013-05-01,"sbmt","transporte não regular","voo doméstico",6067,6084,12151,12120,12126,24246,0,0,0,0
"3436",2013-05-01,"sbmt","transporte não regular","voo internacional",1,1,2,0,0,0,0,0,0,0
"3437",2013-05-01,"sbnf","transporte regular","voo doméstico",537,539,1076,47657,47368,95025,0,0,0,0
"3438",2013-05-01,"sbnf","transporte regular","voo internacional",0,0,0,0,0,0,0,0,0,0
"3439",2013-05-01,"sbnf","transporte não regular","voo doméstico",526,522,1048,1827,2540,4367,0,0,0,0
"3440",2013-05-01,"sbnf","transporte não regular","voo internacional",13,6,19,13,6,19,0,0,0,0
"3441",2013-05-01,"sbpb","transporte regular","voo doméstico",0,0,0,0,0,0,0,0,0,0
"3442",2013-05-01,"sbpb","transporte regular","voo internacional",0,0,0,0,0,0,0,0,0,0
"3443",2013-05-01,"sbpb","transporte não regular","voo doméstico",66,65,131,135,147,282,0,0,0,0
"3444",2013-05-01,"sbpb","transporte não regular","voo internacional",0,0,0,0,0,0,0,0,0,0
"3445",2013-05-01,"sbpj","transporte regular","voo doméstico",375,376,751,25624,25211,50835,0,0,0,0
"3446",2013-05-01,"sbpj","transporte regular","voo internacional",0,0,0,0,0,0,0,0,0,0
"3447",2013-05-01,"sbpj","transporte não regular","voo doméstico",486,500,986,1762,1372,3134,26890,31083,57973,0
"3448",2013-05-01,"sbpj","transporte não regular","voo internacional",0,1,1,0,0,0,0,0,0,0
"3449",2013-05-01,"sbpk","transporte regular","voo doméstico",70,70,140,1188,1123,2311,0,0,0,0
"3450",2013-05-01,"sbpk","transporte regular","voo internacional",0,0,0,0,0,0,0,0,0,0
"3451",2013-05-01,"sbpk","transporte não regular","voo doméstico",51,47,98,162,160,322,0,0,0,0
"3452",2013-05-01,"sbpk","transporte não regular","voo internacional",3,6,9,14,17,31,0,0,0,0
"3453",2013-05-01,"sbpl","transporte regular","voo doméstico",227,228,455,20995,20750,41745,0,0,0,0
"3454",2013-05-01,"sbpl","transporte regular","voo internacional",5,5,10,0,0,0,0,0,0,0
"3455",2013-05-01,"sbpl","transporte não regular","voo doméstico",78,78,156,97,85,182,0,0,0,0
"3456",2013-05-01,"sbpl","transporte não regular","voo internacional",1,1,2,0,9,9,0,0,0,0
"3457",2013-05-01,"sbpp","transporte regular","voo doméstico",0,0,0,0,0,0,0,0,0,0
"3458",2013-05-01,"sbpp","transporte regular","voo internacional",0,0,0,0,0,0,0,0,0,0
"3459",2013-05-01,"sbpp","transporte não regular","voo doméstico",100,96,196,135,144,279,0,0,0,0
"3460",2013-05-01,"sbpp","transporte não regular","voo internacional",6,9,15,10,6,16,0,0,0,0
"3461",2013-05-01,"sbpr","transporte regular","voo doméstico",0,0,0,0,0,0,0,0,0,0
"3462",2013-05-01,"sbpr","transporte regular","voo internacional",0,0,0,0,0,0,0,0,0,0
"3463",2013-05-01,"sbpr","transporte não regular","voo doméstico",1548,1546,3094,1432,1582,3014,0,0,0,0
"3464",2013-05-01,"sbpr","transporte não regular","voo internacional",3,1,4,0,0,0,0,0,0,0
"3465",2013-05-01,"sbpv","transporte regular","voo doméstico",477,478,955,38747,36907,75654,49170,188897,238067,0
"3466",2013-05-01,"sbpv","transporte regular","voo internacional",0,0,0,0,0,0,0,0,0,0
"3467",2013-05-01,"sbpv","transporte não regular","voo doméstico",268,265,533,0,0,0,0,0,0,0
"3468",2013-05-01,"sbpv","transporte não regular","voo internacional",0,0,0,0,0,0,0,0,0,0
"3469",2013-05-01,"sbrb","transporte regular","voo doméstico",156,156,312,15661,14686,30347,0,0,0,0
"3470",2013-05-01,"sbrb","transporte regular","voo internacional",0,0,0,0,0,0,0,0,0,0
"3471",2013-05-01,"sbrb","transporte não regular","voo doméstico",253,255,508,747,504,1251,0,0,0,0
"3472",2013-05-01,"sbrb","transporte não regular","voo internacional",0,0,0,0,0,0,0,0,0,0
"3473",2013-05-01,"sbrj","transporte regular","voo doméstico",4128,4158,8286,372485,367800,740285,0,0,0,0
"3474",2013-05-01,"sbrj","transporte regular","voo internacional",0,0,0,0,0,0,0,0,0,0
"3475",2013-05-01,"sbrj","transporte não regular","voo doméstico",1251,1225,2476,4187,3593,7780,0,0,0,0
"3476",2013-05-01,"sbrj","transporte não regular","voo internacional",7,7,14,0,0,0,0,0,0,0
"3477",2013-05-01,"sbsj","transporte regular","voo doméstico",144,146,290,6969,6445,13414,0,0,0,0
"3478",2013-05-01,"sbsj","transporte regular","voo internacional",0,0,0,0,0,0,0,0,0,0
"3479",2013-05-01,"sbsj","transporte não regular","voo doméstico",622,601,1223,1978,1958,3936,0,0,0,0
"3480",2013-05-01,"sbsj","transporte não regular","voo internacional",6,18,24,38,12,50,0,0,0,0
"3481",2013-05-01,"sbsl","transporte regular","voo doméstico",672,670,1342,69800,71215,141015,0,0,0,0
"3482",2013-05-01,"sbsl","transporte regular","voo internacional",0,0,0,0,0,0,0,0,0,0
"3483",2013-05-01,"sbsl","transporte não regular","voo doméstico",393,400,793,1071,737,1808,88903,199854,288757,0
"3484",2013-05-01,"sbsl","transporte não regular","voo internacional",0,1,1,3,5,8,0,0,0,0
"3485",2013-05-01,"sbsn","transporte regular","voo doméstico",371,371,742,21259,18770,40029,0,0,0,0
"3486",2013-05-01,"sbsn","transporte regular","voo internacional",0,0,0,0,0,0,0,0,0,0
"3487",2013-05-01,"sbsn","transporte não regular","voo doméstico",338,337,675,861,583,1444,0,0,0,0
"3488",2013-05-01,"sbsn","transporte não regular","voo internacional",2,2,4,0,0,0,0,0,0,0
"3489",2013-05-01,"sbsp","transporte regular","voo doméstico",6485,6576,13061,694522,669116,1363638,0,0,0,0
"3490",2013-05-01,"sbsp","transporte regular","voo internacional",0,0,0,0,0,0,0,0,0,0
"3491",2013-05-01,"sbsp","transporte não regular","voo doméstico",2291,2227,4518,8977,8952,17929,0,0,0,0
"3492",2013-05-01,"sbsp","transporte não regular","voo internacional",0,0,0,0,0,0,0,0,0,0
"3493",2013-05-01,"sbte","transporte regular","voo doméstico",447,448,895,44022,44809,88831,22542,85243,107785,266276
"3494",2013-05-01,"sbte","transporte regular","voo internacional",0,0,0,0,0,0,0,0,0,0
"3495",2013-05-01,"sbte","transporte não regular","voo doméstico",245,248,493,1174,1183,2357,0,0,0,0
"3496",2013-05-01,"sbte","transporte não regular","voo internacional",0,0,0,0,0,0,0,0,0,0
"3497",2013-05-01,"sbtf","transporte regular","voo doméstico",74,74,148,2108,2201,4309,0,0,0,0
"3498",2013-05-01,"sbtf","transporte regular","voo internacional",0,0,0,0,0,0,0,0,0,0
"3499",2013-05-01,"sbtf","transporte não regular","voo doméstico",264,264,528,899,843,1742,2515,4861,7376,20054
"3500",2013-05-01,"sbtf","transporte não regular","voo internacional",0,0,0,0,0,0,0,0,0,0
"3501",2013-05-01,"sbtt","transporte regular","voo doméstico",60,60,120,2029,2171,4200,0,0,0,0
"3502",2013-05-01,"sbtt","transporte regular","voo internacional",0,0,0,0,0,0,0,0,0,0
"3503",2013-05-01,"sbtt","transporte não regular","voo doméstico",54,54,108,230,230,460,2568,4486,7054,1111
"3504",2013-05-01,"sbtt","transporte não regular","voo internacional",1,0,1,0,3,3,0,0,0,0
"3505",2013-05-01,"sbuf","transporte regular","voo doméstico",0,0,0,0,0,0,0,0,0,0
"3506",2013-05-01,"sbuf","transporte regular","voo internacional",0,0,0,0,0,0,0,0,0,0
"3507",2013-05-01,"sbuf","transporte não regular","voo doméstico",47,45,92,121,112,233,0,0,0,0
"3508",2013-05-01,"sbuf","transporte não regular","voo internacional",0,0,0,0,0,0,0,0,0,0
"3509",2013-05-01,"sbug","transporte regular","voo doméstico",0,0,0,0,0,0,0,0,0,0
"3510",2013-05-01,"sbug","transporte regular","voo internacional",0,0,0,0,0,0,0,0,0,0
"3511",2013-05-01,"sbug","transporte não regular","voo doméstico",9,10,19,20,23,43,0,0,0,0
"3512",2013-05-01,"sbug","transporte não regular","voo internacional",0,0,0,0,0,0,0,0,0,0
"3513",2013-05-01,"sbul","transporte regular","voo doméstico",565,564,1129,47031,47492,94523,0,0,0,0
"3514",2013-05-01,"sbul","transporte regular","voo internacional",0,0,0,0,0,0,0,0,0,0
"3515",2013-05-01,"sbul","transporte não regular","voo doméstico",778,778,1556,1715,1666,3381,0,0,0,0
"3516",2013-05-01,"sbul","transporte não regular","voo internacional",3,3,6,23,11,34,0,0,0,0
"3517",2013-05-01,"sbur","transporte regular","voo doméstico",125,125,250,5990,5815,11805,0,0,0,0
"3518",2013-05-01,"sbur","transporte regular","voo internacional",0,0,0,0,0,0,0,0,0,0
"3519",2013-05-01,"sbur","transporte não regular","voo doméstico",388,385,773,1480,1665,3145,0,0,0,0
"3520",2013-05-01,"sbur","transporte não regular","voo internacional",0,0,0,0,0,0,0,0,0,0
"3521",2013-03-01,"sbbe","transporte regular","voo doméstico",1629,1621,3250,123149,119148,242297,0,10217,10217,0
"3522",2013-03-01,"sbbe","transporte regular","voo internacional",15,15,30,1814,1539,3353,0,2,2,0
"3523",2013-03-01,"sbbe","transporte não regular","voo doméstico",548,547,1095,3302,2945,6247,100644,361230,461874,0
"3524",2013-03-01,"sbbe","transporte não regular","voo internacional",17,18,35,266,229,495,0,0,0,0
"3525",2013-03-01,"sbbg","transporte regular","voo doméstico",0,0,0,0,0,0,0,0,0,0
"3526",2013-03-01,"sbbg","transporte regular","voo internacional",0,0,0,0,0,0,0,0,0,0
"3527",2013-03-01,"sbbg","transporte não regular","voo doméstico",21,21,42,88,103,191,0,0,0,0
"3528",2013-03-01,"sbbg","transporte não regular","voo internacional",1,1,2,6,5,11,0,0,0,0
"3529",2013-03-01,"sbbh","transporte regular","voo doméstico",743,749,1492,32427,34066,66493,0,0,0,0
"3530",2013-03-01,"sbbh","transporte regular","voo internacional",0,0,0,0,0,0,0,0,0,0
"3531",2013-03-01,"sbbh","transporte não regular","voo doméstico",2007,1998,4005,8962,9161,18123,0,0,0,0
"3532",2013-03-01,"sbbh","transporte não regular","voo internacional",4,3,7,16,21,37,0,0,0,0
"3533",2013-03-01,"sbbi","transporte regular","voo doméstico",0,0,0,0,0,0,0,0,0,0
"3534",2013-03-01,"sbbi","transporte regular","voo internacional",0,0,0,0,0,0,0,0,0,0
"3535",2013-03-01,"sbbi","transporte não regular","voo doméstico",867,843,1710,1445,1753,3198,0,0,0,0
"3536",2013-03-01,"sbbi","transporte não regular","voo internacional",1,1,2,0,0,0,0,0,0,0
"3537",2013-03-01,"sbbv","transporte regular","voo doméstico",90,90,180,12139,11986,24125,0,0,0,0
"3538",2013-03-01,"sbbv","transporte regular","voo internacional",0,0,0,0,0,0,0,0,0,0
"3539",2013-03-01,"sbbv","transporte não regular","voo doméstico",128,128,256,224,73,297,0,0,0,0
"3540",2013-03-01,"sbbv","transporte não regular","voo internacional",34,30,64,2,8,10,0,0,0,0
"3541",2013-03-01,"sbcg","transporte regular","voo doméstico",764,759,1523,64436,63334,127770,18260,42924,61184,0
"3542",2013-03-01,"sbcg","transporte regular","voo internacional",0,0,0,0,0,0,0,0,0,0
"3543",2013-03-01,"sbcg","transporte não regular","voo doméstico",344,338,682,174,219,393,28393,66410,94803,0
"3544",2013-03-01,"sbcg","transporte não regular","voo internacional",20,20,40,0,0,0,0,0,0,0
"3545",2013-03-01,"sbcj","transporte regular","voo doméstico",121,122,243,3523,2852,6375,0,0,0,0
"3546",2013-03-01,"sbcj","transporte regular","voo internacional",0,0,0,0,0,0,0,0,0,0
"3547",2013-03-01,"sbcj","transporte não regular","voo doméstico",108,107,215,1684,1687,3371,0,0,0,0
"3548",2013-03-01,"sbcj","transporte não regular","voo internacional",1,1,2,0,0,0,0,0,0,0
"3549",2013-03-01,"sbcr","transporte regular","voo doméstico",28,28,56,1143,1241,2384,0,0,0,0
"3550",2013-03-01,"sbcr","transporte regular","voo internacional",0,0,0,0,0,0,0,0,0,0
"3551",2013-03-01,"sbcr","transporte não regular","voo doméstico",52,52,104,133,119,252,0,0,0,0
"3552",2013-03-01,"sbcr","transporte não regular","voo internacional",5,5,10,11,9,20,0,0,0,0
"3553",2013-03-01,"sbct","transporte regular","voo doméstico",3035,3012,6047,262995,247104,510099,233775,76136,309911,382377
"3554",2013-03-01,"sbct","transporte regular","voo internacional",99,100,199,2343,2204,4547,0,0,0,0
"3555",2013-03-01,"sbct","transporte não regular","voo doméstico",558,579,1137,13892,12543,26435,0,0,0,0
"3556",2013-03-01,"sbct","transporte não regular","voo internacional",21,24,45,23,58,81,0,0,0,0
"3557",2013-03-01,"sbcz","transporte regular","voo doméstico",31,31,62,2474,2281,4755,0,0,0,0
"3558",2013-03-01,"sbcz","transporte regular","voo internacional",0,0,0,0,0,0,0,0,0,0
"3559",2013-03-01,"sbcz","transporte não regular","voo doméstico",183,182,365,676,621,1297,0,0,0,0
"3560",2013-03-01,"sbcz","transporte não regular","voo internacional",1,1,2,0,0,0,0,0,0,0
"3561",2013-03-01,"sbeg","transporte regular","voo doméstico",1235,1242,2477,104775,100054,204829,0,0,0,0
"3562",2013-03-01,"sbeg","transporte regular","voo internacional",123,122,245,8991,7990,16981,0,0,0,0
"3563",2013-03-01,"sbeg","transporte não regular","voo doméstico",690,679,1369,5839,6075,11914,0,0,0,0
"3564",2013-03-01,"sbeg","transporte não regular","voo internacional",154,154,308,1315,1453,2768,0,0,0,0
"3565",2013-03-01,"sbfi","transporte regular","voo doméstico",592,594,1186,69451,68948,138399,0,0,0,0
"3566",2013-03-01,"sbfi","transporte regular","voo internacional",18,18,36,2507,2420,4927,0,0,0,0
"3567",2013-03-01,"sbfi","transporte não regular","voo doméstico",118,124,242,479,811,1290,0,0,0,0
"3568",2013-03-01,"sbfi","transporte não regular","voo internacional",37,32,69,375,372,747,0,0,0,0
"3569",2013-03-01,"sbgo","transporte regular","voo doméstico",1204,1211,2415,103137,101252,204389,22002,138868,160870,31513
"3570",2013-03-01,"sbgo","transporte regular","voo internacional",0,0,0,0,0,0,0,0,0,0
"3571",2013-03-01,"sbgo","transporte não regular","voo doméstico",1110,1125,2235,5806,5813,11619,0,0,0,0
"3572",2013-03-01,"sbgo","transporte não regular","voo internacional",6,4,10,20,30,50,0,0,0,0
"3573",2013-03-01,"sbht","transporte regular","voo doméstico",211,210,421,7191,7909,15100,0,0,0,0
"3574",2013-03-01,"sbht","transporte regular","voo internacional",0,0,0,0,0,0,0,0,0,0
"3575",2013-03-01,"sbht","transporte não regular","voo doméstico",202,206,408,474,346,820,11643,25086,36729,11650
"3576",2013-03-01,"sbht","transporte não regular","voo internacional",0,0,0,0,0,0,0,0,0,0
"3577",2013-03-01,"sbiz","transporte regular","voo doméstico",176,175,351,11929,11401,23330,0,0,0,0
"3578",2013-03-01,"sbiz","transporte regular","voo internacional",0,0,0,0,0,0,0,0,0,0
"3579",2013-03-01,"sbiz","transporte não regular","voo doméstico",176,175,351,1093,1192,2285,0,0,0,0
"3580",2013-03-01,"sbiz","transporte não regular","voo internacional",0,1,1,0,0,0,0,0,0,0
"3581",2013-03-01,"sbjc","transporte regular","voo doméstico",0,0,0,0,0,0,0,0,0,0
"3582",2013-03-01,"sbjc","transporte regular","voo internacional",0,0,0,0,0,0,0,0,0,0
"3583",2013-03-01,"sbjc","transporte não regular","voo doméstico",543,544,1087,1339,1280,2619,0,0,0,0
"3584",2013-03-01,"sbjc","transporte não regular","voo internacional",1,1,2,0,0,0,0,0,0,0
"3585",2013-03-01,"sbjr","transporte regular","voo doméstico",0,0,0,0,0,0,0,0,0,0
"3586",2013-03-01,"sbjr","transporte regular","voo internacional",0,0,0,0,0,0,0,0,0,0
"3587",2013-03-01,"sbjr","transporte não regular","voo doméstico",3161,3155,6316,8307,3687,11994,0,0,0,0
"3588",2013-03-01,"sbjr","transporte não regular","voo internacional",0,0,0,0,0,0,0,0,0,0
"3589",2013-03-01,"sbjv","transporte regular","voo doméstico",179,181,360,12291,12310,24601,0,0,0,0
"3590",2013-03-01,"sbjv","transporte regular","voo internacional",0,0,0,0,0,0,0,0,0,0
"3591",2013-03-01,"sbjv","transporte não regular","voo doméstico",136,136,272,48,125,173,0,0,0,0
"3592",2013-03-01,"sbjv","transporte não regular","voo internacional",0,0,0,0,0,0,0,0,0,0
"3593",2013-03-01,"sblo","transporte regular","voo doméstico",521,522,1043,40114,40983,81097,0,0,0,0
"3594",2013-03-01,"sblo","transporte regular","voo internacional",0,0,0,0,0,0,0,0,0,0
"3595",2013-03-01,"sblo","transporte não regular","voo doméstico",809,804,1613,1774,2118,3892,0,0,0,0
"3596",2013-03-01,"sblo","transporte não regular","voo internacional",4,1,5,0,0,0,0,0,0,0
"3597",2013-03-01,"sbma","transporte regular","voo doméstico",436,433,869,16945,15659,32604,0,0,0,0
"3598",2013-03-01,"sbma","transporte regular","voo internacional",0,0,0,0,0,0,0,0,0,0
"3599",2013-03-01,"sbma","transporte não regular","voo doméstico",238,241,479,1280,1239,2519,0,0,0,0
"3600",2013-03-01,"sbma","transporte não regular","voo internacional",1,1,2,0,0,0,0,0,0,0
"3601",2013-03-01,"sbmk","transporte regular","voo doméstico",210,210,420,12656,12365,25021,0,0,0,0
"3602",2013-03-01,"sbmk","transporte regular","voo internacional",0,0,0,0,0,0,0,0,0,0
"3603",2013-03-01,"sbmk","transporte não regular","voo doméstico",214,214,428,147,145,292,0,0,0,0
"3604",2013-03-01,"sbmk","transporte não regular","voo internacional",0,0,0,0,0,0,0,0,0,0
"3605",2013-03-01,"sbmq","transporte regular","voo doméstico",320,323,643,24504,22330,46834,20650,28415,49065,0
"3606",2013-03-01,"sbmq","transporte regular","voo internacional",0,0,0,0,0,0,0,0,0,0
"3607",2013-03-01,"sbmq","transporte não regular","voo doméstico",241,236,477,343,264,607,0,0,0,0
"3608",2013-03-01,"sbmq","transporte não regular","voo internacional",11,12,23,0,0,0,0,0,0,0
"3609",2013-03-01,"sbmt","transporte regular","voo doméstico",0,0,0,0,0,0,0,0,0,0
"3610",2013-03-01,"sbmt","transporte regular","voo internacional",0,0,0,0,0,0,0,0,0,0
"3611",2013-03-01,"sbmt","transporte não regular","voo doméstico",5946,5963,11909,11908,11900,23808,0,0,0,0
"3612",2013-03-01,"sbmt","transporte não regular","voo internacional",5,3,8,0,0,0,0,0,0,0
"3613",2013-03-01,"sbnf","transporte regular","voo doméstico",549,549,1098,46323,46115,92438,0,0,0,0
"3614",2013-03-01,"sbnf","transporte regular","voo internacional",0,0,0,0,0,0,0,0,0,0
"3615",2013-03-01,"sbnf","transporte não regular","voo doméstico",530,538,1068,1922,2412,4334,0,0,0,0
"3616",2013-03-01,"sbnf","transporte não regular","voo internacional",11,9,20,12,28,40,0,0,0,0
"3617",2013-03-01,"sbpb","transporte regular","voo doméstico",0,0,0,0,0,0,0,0,0,0
"3618",2013-03-01,"sbpb","transporte regular","voo internacional",0,0,0,0,0,0,0,0,0,0
"3619",2013-03-01,"sbpb","transporte não regular","voo doméstico",39,39,78,76,79,155,0,0,0,0
"3620",2013-03-01,"sbpb","transporte não regular","voo internacional",0,0,0,0,0,0,0,0,0,0
"3621",2013-03-01,"sbpj","transporte regular","voo doméstico",353,345,698,20541,21194,41735,0,0,0,0
"3622",2013-03-01,"sbpj","transporte regular","voo internacional",0,0,0,0,0,0,0,0,0,0
"3623",2013-03-01,"sbpj","transporte não regular","voo doméstico",425,434,859,1932,1106,3038,27820,36760,64580,0
"3624",2013-03-01,"sbpj","transporte não regular","voo internacional",3,3,6,0,0,0,0,0,0,0
"3625",2013-03-01,"sbpk","transporte regular","voo doméstico",68,69,137,574,521,1095,0,0,0,0
"3626",2013-03-01,"sbpk","transporte regular","voo internacional",0,0,0,0,0,0,0,0,0,0
"3627",2013-03-01,"sbpk","transporte não regular","voo doméstico",64,62,126,157,180,337,0,0,0,0
"3628",2013-03-01,"sbpk","transporte não regular","voo internacional",1,3,4,8,3,11,0,0,0,0
"3629",2013-03-01,"sbpl","transporte regular","voo doméstico",228,229,457,19040,19401,38441,0,0,0,0
"3630",2013-03-01,"sbpl","transporte regular","voo internacional",4,4,8,0,0,0,0,0,0,0
"3631",2013-03-01,"sbpl","transporte não regular","voo doméstico",77,78,155,61,50,111,0,0,0,0
"3632",2013-03-01,"sbpl","transporte não regular","voo internacional",1,1,2,0,0,0,0,0,0,0
"3633",2013-03-01,"sbpp","transporte regular","voo doméstico",0,0,0,0,0,0,0,0,0,0
"3634",2013-03-01,"sbpp","transporte regular","voo internacional",0,0,0,0,0,0,0,0,0,0
"3635",2013-03-01,"sbpp","transporte não regular","voo doméstico",89,96,185,158,152,310,0,0,0,0
"3636",2013-03-01,"sbpp","transporte não regular","voo internacional",8,4,12,7,13,20,0,0,0,0
"3637",2013-03-01,"sbpr","transporte regular","voo doméstico",0,0,0,0,0,0,0,0,0,0
"3638",2013-03-01,"sbpr","transporte regular","voo internacional",0,0,0,0,0,0,0,0,0,0
"3639",2013-03-01,"sbpr","transporte não regular","voo doméstico",1394,1396,2790,1479,1372,2851,0,0,0,0
"3640",2013-03-01,"sbpr","transporte não regular","voo internacional",1,1,2,0,0,0,0,0,0,0
"3641",2013-03-01,"sbpv","transporte regular","voo doméstico",393,391,784,26371,25504,51875,61261,253982,315243,0
"3642",2013-03-01,"sbpv","transporte regular","voo internacional",0,0,0,0,0,0,0,0,0,0
"3643",2013-03-01,"sbpv","transporte não regular","voo doméstico",157,157,314,0,0,0,0,0,0,0
"3644",2013-03-01,"sbpv","transporte não regular","voo internacional",2,2,4,0,0,0,0,0,0,0
"3645",2013-03-01,"sbrb","transporte regular","voo doméstico",157,157,314,12828,12171,24999,0,0,0,0
"3646",2013-03-01,"sbrb","transporte regular","voo internacional",0,0,0,0,0,0,0,0,0,0
"3647",2013-03-01,"sbrb","transporte não regular","voo doméstico",272,274,546,832,779,1611,0,0,0,0
"3648",2013-03-01,"sbrb","transporte não regular","voo internacional",0,0,0,0,0,0,0,0,0,0
"3649",2013-03-01,"sbrj","transporte regular","voo doméstico",4147,4156,8303,380557,371374,751931,0,0,0,0
"3650",2013-03-01,"sbrj","transporte regular","voo internacional",0,0,0,0,0,0,0,0,0,0
"3651",2013-03-01,"sbrj","transporte não regular","voo doméstico",1278,1273,2551,8504,6969,15473,0,0,0,0
"3652",2013-03-01,"sbrj","transporte não regular","voo internacional",4,4,8,0,0,0,0,0,0,0
"3653",2013-03-01,"sbsj","transporte regular","voo doméstico",145,146,291,6531,6400,12931,0,0,0,0
"3654",2013-03-01,"sbsj","transporte regular","voo internacional",0,0,0,0,0,0,0,0,0,0
"3655",2013-03-01,"sbsj","transporte não regular","voo doméstico",514,499,1013,955,880,1835,0,0,0,0
"3656",2013-03-01,"sbsj","transporte não regular","voo internacional",7,17,24,15,4,19,0,0,0,0
"3657",2013-03-01,"sbsl","transporte regular","voo doméstico",615,621,1236,60374,57544,117918,0,0,0,0
"3658",2013-03-01,"sbsl","transporte regular","voo internacional",0,0,0,0,0,0,0,0,0,0
"3659",2013-03-01,"sbsl","transporte não regular","voo doméstico",574,575,1149,5565,5943,11508,66520,164015,230535,0
"3660",2013-03-01,"sbsl","transporte não regular","voo internacional",6,3,9,11,0,11,0,0,0,0
"3661",2013-03-01,"sbsn","transporte regular","voo doméstico",294,294,588,15744,15083,30827,0,0,0,0
"3662",2013-03-01,"sbsn","transporte regular","voo internacional",0,0,0,0,0,0,0,0,0,0
"3663",2013-03-01,"sbsn","transporte não regular","voo doméstico",270,273,543,648,429,1077,0,0,0,0
"3664",2013-03-01,"sbsn","transporte não regular","voo internacional",3,3,6,0,0,0,0,0,0,0
"3665",2013-03-01,"sbsp","transporte regular","voo doméstico",6619,6672,13291,651816,635731,1287547,0,0,0,0
"3666",2013-03-01,"sbsp","transporte regular","voo internacional",0,0,0,0,0,0,0,0,0,0
"3667",2013-03-01,"sbsp","transporte não regular","voo doméstico",2385,2312,4697,12546,10601,23147,0,0,0,0
"3668",2013-03-01,"sbsp","transporte não regular","voo internacional",0,0,0,0,0,0,0,0,0,0
"3669",2013-03-01,"sbte","transporte regular","voo doméstico",421,421,842,37379,38517,75896,15988,71286,87274,213975
"3670",2013-03-01,"sbte","transporte regular","voo internacional",0,0,0,0,0,0,0,0,0,0
"3671",2013-03-01,"sbte","transporte não regular","voo doméstico",187,189,376,935,935,1870,0,0,0,0
"3672",2013-03-01,"sbte","transporte não regular","voo internacional",1,1,2,0,0,0,0,0,0,0
"3673",2013-03-01,"sbtf","transporte regular","voo doméstico",73,74,147,1288,1444,2732,0,0,0,0
"3674",2013-03-01,"sbtf","transporte regular","voo internacional",0,0,0,0,0,0,0,0,0,0
"3675",2013-03-01,"sbtf","transporte não regular","voo doméstico",260,261,521,870,823,1693,2465,4064,6529,18700
"3676",2013-03-01,"sbtf","transporte não regular","voo internacional",0,0,0,0,0,0,0,0,0,0
"3677",2013-03-01,"sbtt","transporte regular","voo doméstico",61,61,122,1522,2607,4129,0,0,0,0
"3678",2013-03-01,"sbtt","transporte regular","voo internacional",0,0,0,0,0,0,0,0,0,0
"3679",2013-03-01,"sbtt","transporte não regular","voo doméstico",48,48,96,210,207,417,2034,3833,5867,865
"3680",2013-03-01,"sbtt","transporte não regular","voo internacional",3,3,6,20,17,37,0,0,0,0
"3681",2013-03-01,"sbuf","transporte regular","voo doméstico",0,0,0,0,0,0,0,0,0,0
"3682",2013-03-01,"sbuf","transporte regular","voo internacional",0,0,0,0,0,0,0,0,0,0
"3683",2013-03-01,"sbuf","transporte não regular","voo doméstico",61,62,123,169,167,336,0,0,0,0
"3684",2013-03-01,"sbuf","transporte não regular","voo internacional",0,0,0,0,0,0,0,0,0,0
"3685",2013-03-01,"sbug","transporte regular","voo doméstico",20,20,40,101,102,203,0,0,0,0
"3686",2013-03-01,"sbug","transporte regular","voo internacional",0,0,0,0,0,0,0,0,0,0
"3687",2013-03-01,"sbug","transporte não regular","voo doméstico",12,12,24,23,21,44,0,0,0,0
"3688",2013-03-01,"sbug","transporte não regular","voo internacional",2,3,5,0,0,0,0,0,0,0
"3689",2013-03-01,"sbul","transporte regular","voo doméstico",647,646,1293,42970,42149,85119,0,0,0,0
"3690",2013-03-01,"sbul","transporte regular","voo internacional",0,0,0,0,0,0,0,0,0,0
"3691",2013-03-01,"sbul","transporte não regular","voo doméstico",706,701,1407,1491,1330,2821,0,0,0,0
"3692",2013-03-01,"sbul","transporte não regular","voo internacional",0,0,0,0,0,0,0,0,0,0
"3693",2013-03-01,"sbur","transporte regular","voo doméstico",135,135,270,5790,5423,11213,0,0,0,0
"3694",2013-03-01,"sbur","transporte regular","voo internacional",0,0,0,0,0,0,0,0,0,0
"3695",2013-03-01,"sbur","transporte não regular","voo doméstico",177,172,349,540,744,1284,0,0,0,0
"3696",2013-03-01,"sbur","transporte não regular","voo internacional",0,0,0,0,0,0,0,0,0,0
"3697",2013-11-01,"sbbe","transporte regular","voo doméstico",1666,1670,3336,144869,143718,288587,0,0,0,0
"3698",2013-11-01,"sbbe","transporte regular","voo internacional",20,20,40,1471,1785,3256,0,20,20,0
"3699",2013-11-01,"sbbe","transporte não regular","voo doméstico",551,551,1102,2958,2844,5802,91375,408559,499934,0
"3700",2013-11-01,"sbbe","transporte não regular","voo internacional",19,20,39,162,24,186,0,0,0,0
"3701",2013-11-01,"sbbg","transporte regular","voo doméstico",0,0,0,0,0,0,0,0,0,0
"3702",2013-11-01,"sbbg","transporte regular","voo internacional",0,0,0,0,0,0,0,0,0,0
"3703",2013-11-01,"sbbg","transporte não regular","voo doméstico",23,24,47,123,105,228,0,0,0,0
"3704",2013-11-01,"sbbg","transporte não regular","voo internacional",2,1,3,7,7,14,0,0,0,0
"3705",2013-11-01,"sbbh","transporte regular","voo doméstico",609,607,1216,28754,33695,62449,0,0,0,0
"3706",2013-11-01,"sbbh","transporte regular","voo internacional",0,0,0,0,0,0,0,0,0,0
"3707",2013-11-01,"sbbh","transporte não regular","voo doméstico",1970,1975,3945,8917,8889,17806,0,0,0,0
"3708",2013-11-01,"sbbh","transporte não regular","voo internacional",15,14,29,83,88,171,0,0,0,0
"3709",2013-11-01,"sbbi","transporte regular","voo doméstico",0,0,0,0,0,0,0,0,0,0
"3710",2013-11-01,"sbbi","transporte regular","voo internacional",0,0,0,0,0,0,0,0,0,0
"3711",2013-11-01,"sbbi","transporte não regular","voo doméstico",1086,1094,2180,3570,3668,7238,0,0,0,0
"3712",2013-11-01,"sbbi","transporte não regular","voo internacional",2,1,3,0,0,0,0,0,0,0
"3713",2013-11-01,"sbbv","transporte regular","voo doméstico",129,131,260,15152,14910,30062,0,0,0,0
"3714",2013-11-01,"sbbv","transporte regular","voo internacional",0,0,0,0,0,0,0,0,0,0
"3715",2013-11-01,"sbbv","transporte não regular","voo doméstico",128,126,254,624,489,1113,0,0,0,0
"3716",2013-11-01,"sbbv","transporte não regular","voo internacional",29,27,56,10,4,14,0,0,0,0
"3717",2013-11-01,"sbcg","transporte regular","voo doméstico",619,604,1223,62836,60923,123759,74144,155630,229774,0
"3718",2013-11-01,"sbcg","transporte regular","voo internacional",0,0,0,0,0,0,0,0,0,0
"3719",2013-11-01,"sbcg","transporte não regular","voo doméstico",386,400,786,4218,3129,7347,85,0,85,0
"3720",2013-11-01,"sbcg","transporte não regular","voo internacional",9,6,15,0,0,0,0,0,0,0
"3721",2013-11-01,"sbcj","transporte regular","voo doméstico",100,100,200,4371,3785,8156,0,0,0,0
"3722",2013-11-01,"sbcj","transporte regular","voo internacional",0,0,0,0,0,0,0,0,0,0
"3723",2013-11-01,"sbcj","transporte não regular","voo doméstico",132,133,265,1439,1508,2947,0,0,0,0
"3724",2013-11-01,"sbcj","transporte não regular","voo internacional",1,1,2,0,0,0,0,0,0,0
"3725",2013-11-01,"sbcr","transporte regular","voo doméstico",25,25,50,1253,1161,2414,0,0,0,0
"3726",2013-11-01,"sbcr","transporte regular","voo internacional",0,0,0,0,0,0,0,0,0,0
"3727",2013-11-01,"sbcr","transporte não regular","voo doméstico",39,41,80,113,91,204,0,0,0,0
"3728",2013-11-01,"sbcr","transporte não regular","voo internacional",7,7,14,11,15,26,0,0,0,0
"3729",2013-11-01,"sbct","transporte regular","voo doméstico",2913,2917,5830,303846,304977,608823,262089,0,262089,188458
"3730",2013-11-01,"sbct","transporte regular","voo internacional",71,71,142,2793,2292,5085,0,21015,21015,0
"3731",2013-11-01,"sbct","transporte não regular","voo doméstico",303,307,610,1807,1466,3273,0,0,0,0
"3732",2013-11-01,"sbct","transporte não regular","voo internacional",21,17,38,56,32,88,0,0,0,0
"3733",2013-11-01,"sbcz","transporte regular","voo doméstico",29,29,58,2551,2381,4932,0,0,0,0
"3734",2013-11-01,"sbcz","transporte regular","voo internacional",0,0,0,0,0,0,0,0,0,0
"3735",2013-11-01,"sbcz","transporte não regular","voo doméstico",166,168,334,610,540,1150,0,0,0,0
"3736",2013-11-01,"sbcz","transporte não regular","voo internacional",0,0,0,0,0,0,0,0,0,0
"3737",2013-11-01,"sbeg","transporte regular","voo doméstico",1278,1258,2536,113399,109585,222984,0,0,0,0
"3738",2013-11-01,"sbeg","transporte regular","voo internacional",113,109,222,9265,8288,17553,0,0,0,0
"3739",2013-11-01,"sbeg","transporte não regular","voo doméstico",781,822,1603,9468,7559,17027,0,0,0,0
"3740",2013-11-01,"sbeg","transporte não regular","voo internacional",147,136,283,0,0,0,0,0,0,0
"3741",2013-11-01,"sbfi","transporte regular","voo doméstico",518,519,1037,69523,68397,137920,0,0,0,0
"3742",2013-11-01,"sbfi","transporte regular","voo internacional",25,25,50,2500,2483,4983,0,0,0,0
"3743",2013-11-01,"sbfi","transporte não regular","voo doméstico",104,111,215,408,480,888,0,0,0,0
"3744",2013-11-01,"sbfi","transporte não regular","voo internacional",42,37,79,195,144,339,0,0,0,0
"3745",2013-11-01,"sbgo","transporte regular","voo doméstico",1420,1417,2837,132723,127772,260495,105226,202064,307290,202718
"3746",2013-11-01,"sbgo","transporte regular","voo internacional",0,0,0,0,0,0,0,0,0,0
"3747",2013-11-01,"sbgo","transporte não regular","voo doméstico",1317,1321,2638,7104,7110,14214,0,0,0,0
"3748",2013-11-01,"sbgo","transporte não regular","voo internacional",8,9,17,45,40,85,0,0,0,0
"3749",2013-11-01,"sbht","transporte regular","voo doméstico",196,196,392,9430,8024,17454,0,0,0,0
"3750",2013-11-01,"sbht","transporte regular","voo internacional",0,0,0,0,0,0,0,0,0,0
"3751",2013-11-01,"sbht","transporte não regular","voo doméstico",130,132,262,415,397,812,0,0,0,0
"3752",2013-11-01,"sbht","transporte não regular","voo internacional",0,0,0,0,0,0,0,0,0,0
"3753",2013-11-01,"sbiz","transporte regular","voo doméstico",178,178,356,13688,13879,27567,0,0,0,0
"3754",2013-11-01,"sbiz","transporte regular","voo internacional",0,0,0,0,0,0,0,0,0,0
"3755",2013-11-01,"sbiz","transporte não regular","voo doméstico",143,146,289,975,888,1863,0,0,0,0
"3756",2013-11-01,"sbiz","transporte não regular","voo internacional",0,0,0,0,0,0,0,0,0,0
"3757",2013-11-01,"sbjc","transporte regular","voo doméstico",0,0,0,0,0,0,0,0,0,0
"3758",2013-11-01,"sbjc","transporte regular","voo internacional",0,0,0,0,0,0,0,0,0,0
"3759",2013-11-01,"sbjc","transporte não regular","voo doméstico",548,552,1100,1276,914,2190,0,0,0,0
"3760",2013-11-01,"sbjc","transporte não regular","voo internacional",0,0,0,0,0,0,0,0,0,0
"3761",2013-11-01,"sbjr","transporte regular","voo doméstico",0,0,0,0,0,0,0,0,0,0
"3762",2013-11-01,"sbjr","transporte regular","voo internacional",0,0,0,0,0,0,0,0,0,0
"3763",2013-11-01,"sbjr","transporte não regular","voo doméstico",3101,3096,6197,7343,3202,10545,0,0,0,0
"3764",2013-11-01,"sbjr","transporte não regular","voo internacional",0,0,0,0,0,0,0,0,0,0
"3765",2013-11-01,"sbjv","transporte regular","voo doméstico",240,240,480,20430,19707,40137,0,0,0,0
"3766",2013-11-01,"sbjv","transporte regular","voo internacional",0,0,0,0,0,0,0,0,0,0
"3767",2013-11-01,"sbjv","transporte não regular","voo doméstico",122,123,245,81,133,214,0,0,0,0
"3768",2013-11-01,"sbjv","transporte não regular","voo internacional",1,1,2,0,0,0,0,0,0,0
"3769",2013-11-01,"sblo","transporte regular","voo doméstico",480,481,961,47311,47299,94610,0,0,0,0
"3770",2013-11-01,"sblo","transporte regular","voo internacional",0,0,0,0,0,0,0,0,0,0
"3771",2013-11-01,"sblo","transporte não regular","voo doméstico",830,830,1660,1150,724,1874,0,0,0,0
"3772",2013-11-01,"sblo","transporte não regular","voo internacional",4,4,8,0,0,0,0,0,0,0
"3773",2013-11-01,"sbma","transporte regular","voo doméstico",371,372,743,17710,16961,34671,0,0,0,0
"3774",2013-11-01,"sbma","transporte regular","voo internacional",0,0,0,0,0,0,0,0,0,0
"3775",2013-11-01,"sbma","transporte não regular","voo doméstico",324,328,652,1460,1586,3046,0,0,0,0
"3776",2013-11-01,"sbma","transporte não regular","voo internacional",2,2,4,0,0,0,0,0,0,0
"3777",2013-11-01,"sbmk","transporte regular","voo doméstico",186,188,374,15502,15102,30604,0,0,0,0
"3778",2013-11-01,"sbmk","transporte regular","voo internacional",0,0,0,0,0,0,0,0,0,0
"3779",2013-11-01,"sbmk","transporte não regular","voo doméstico",241,241,482,37,45,82,0,0,0,0
"3780",2013-11-01,"sbmk","transporte não regular","voo internacional",0,0,0,0,0,0,0,0,0,0
"3781",2013-11-01,"sbmq","transporte regular","voo doméstico",331,335,666,30461,29157,59618,1520,4900,6420,0
"3782",2013-11-01,"sbmq","transporte regular","voo internacional",0,0,0,0,0,0,0,0,0,0
"3783",2013-11-01,"sbmq","transporte não regular","voo doméstico",269,264,533,302,308,610,0,0,0,0
"3784",2013-11-01,"sbmq","transporte não regular","voo internacional",8,9,17,0,0,0,0,0,0,0
"3785",2013-11-01,"sbmt","transporte regular","voo doméstico",0,0,0,0,0,0,0,0,0,0
"3786",2013-11-01,"sbmt","transporte regular","voo internacional",0,0,0,0,0,0,0,0,0,0
"3787",2013-11-01,"sbmt","transporte não regular","voo doméstico",5541,5550,11091,9127,8889,18016,0,0,0,0
"3788",2013-11-01,"sbmt","transporte não regular","voo internacional",4,4,8,0,0,0,0,0,0,0
"3789",2013-11-01,"sbnf","transporte regular","voo doméstico",540,539,1079,52520,53328,105848,0,0,0,0
"3790",2013-11-01,"sbnf","transporte regular","voo internacional",0,0,0,0,0,0,0,0,0,0
"3791",2013-11-01,"sbnf","transporte não regular","voo doméstico",335,334,669,1156,1275,2431,0,0,0,0
"3792",2013-11-01,"sbnf","transporte não regular","voo internacional",3,4,7,2,6,8,0,0,0,0
"3793",2013-11-01,"sbpb","transporte regular","voo doméstico",0,0,0,0,0,0,0,0,0,0
"3794",2013-11-01,"sbpb","transporte regular","voo internacional",0,0,0,0,0,0,0,0,0,0
"3795",2013-11-01,"sbpb","transporte não regular","voo doméstico",58,57,115,114,126,240,0,0,0,0
"3796",2013-11-01,"sbpb","transporte não regular","voo internacional",0,0,0,0,0,0,0,0,0,0
"3797",2013-11-01,"sbpj","transporte regular","voo doméstico",364,365,729,23393,23033,46426,0,0,0,0
"3798",2013-11-01,"sbpj","transporte regular","voo internacional",0,0,0,0,0,0,0,0,0,0
"3799",2013-11-01,"sbpj","transporte não regular","voo doméstico",375,375,750,588,389,977,0,0,0,0
"3800",2013-11-01,"sbpj","transporte não regular","voo internacional",3,3,6,2,0,2,0,0,0,0
"3801",2013-11-01,"sbpk","transporte regular","voo doméstico",46,46,92,2428,2136,4564,0,0,0,0
"3802",2013-11-01,"sbpk","transporte regular","voo internacional",0,0,0,0,0,0,0,0,0,0
"3803",2013-11-01,"sbpk","transporte não regular","voo doméstico",67,64,131,151,168,319,0,0,0,0
"3804",2013-11-01,"sbpk","transporte não regular","voo internacional",0,3,3,8,0,8,0,0,0,0
"3805",2013-11-01,"sbpl","transporte regular","voo doméstico",206,205,411,19085,19095,38180,0,0,0,0
"3806",2013-11-01,"sbpl","transporte regular","voo internacional",9,10,19,0,0,0,0,0,0,0
"3807",2013-11-01,"sbpl","transporte não regular","voo doméstico",97,99,196,117,82,199,0,0,0,0
"3808",2013-11-01,"sbpl","transporte não regular","voo internacional",0,0,0,0,0,0,0,0,0,0
"3809",2013-11-01,"sbpp","transporte regular","voo doméstico",0,0,0,0,0,0,0,0,0,0
"3810",2013-11-01,"sbpp","transporte regular","voo internacional",0,0,0,0,0,0,0,0,0,0
"3811",2013-11-01,"sbpp","transporte não regular","voo doméstico",99,96,195,194,188,382,0,0,0,0
"3812",2013-11-01,"sbpp","transporte não regular","voo internacional",3,4,7,2,1,3,0,0,0,0
"3813",2013-11-01,"sbpr","transporte regular","voo doméstico",0,0,0,0,0,0,0,0,0,0
"3814",2013-11-01,"sbpr","transporte regular","voo internacional",0,0,0,0,0,0,0,0,0,0
"3815",2013-11-01,"sbpr","transporte não regular","voo doméstico",1511,1517,3028,1728,1621,3349,0,0,0,0
"3816",2013-11-01,"sbpr","transporte não regular","voo internacional",0,0,0,0,0,0,0,0,0,0
"3817",2013-11-01,"sbpv","transporte regular","voo doméstico",421,420,841,37254,35549,72803,51113,193414,244527,0
"3818",2013-11-01,"sbpv","transporte regular","voo internacional",0,0,0,0,0,0,0,0,0,0
"3819",2013-11-01,"sbpv","transporte não regular","voo doméstico",275,275,550,0,0,0,0,0,0,0
"3820",2013-11-01,"sbpv","transporte não regular","voo internacional",0,0,0,0,0,0,0,0,0,0
"3821",2013-11-01,"sbrb","transporte regular","voo doméstico",156,157,313,16049,15377,31426,0,0,0,0
"3822",2013-11-01,"sbrb","transporte regular","voo internacional",0,0,0,0,0,0,0,0,0,0
"3823",2013-11-01,"sbrb","transporte não regular","voo doméstico",269,272,541,932,395,1327,0,0,0,0
"3824",2013-11-01,"sbrb","transporte não regular","voo internacional",0,0,0,0,0,0,0,0,0,0
"3825",2013-11-01,"sbrj","transporte regular","voo doméstico",4243,4254,8497,412953,406983,819936,0,0,0,0
"3826",2013-11-01,"sbrj","transporte regular","voo internacional",0,0,0,0,0,0,0,0,0,0
"3827",2013-11-01,"sbrj","transporte não regular","voo doméstico",1095,1088,2183,599,254,853,0,0,0,0
"3828",2013-11-01,"sbrj","transporte não regular","voo internacional",7,7,14,0,0,0,0,0,0,0
"3829",2013-11-01,"sbsj","transporte regular","voo doméstico",52,53,105,3077,2899,5976,0,0,0,0
"3830",2013-11-01,"sbsj","transporte regular","voo internacional",0,0,0,0,0,0,0,0,0,0
"3831",2013-11-01,"sbsj","transporte não regular","voo doméstico",629,608,1237,1481,1257,2738,0,0,0,0
"3832",2013-11-01,"sbsj","transporte não regular","voo internacional",2,17,19,6,2,8,0,0,0,0
"3833",2013-11-01,"sbsl","transporte regular","voo doméstico",711,712,1423,71710,73164,144874,0,0,0,0
"3834",2013-11-01,"sbsl","transporte regular","voo internacional",0,0,0,0,0,0,0,0,0,0
"3835",2013-11-01,"sbsl","transporte não regular","voo doméstico",429,423,852,1114,1036,2150,75589,201899,277488,0
"3836",2013-11-01,"sbsl","transporte não regular","voo internacional",2,2,4,0,0,0,0,0,0,0
"3837",2013-11-01,"sbsn","transporte regular","voo doméstico",419,419,838,24404,21635,46039,0,0,0,0
"3838",2013-11-01,"sbsn","transporte regular","voo internacional",0,0,0,0,0,0,0,0,0,0
"3839",2013-11-01,"sbsn","transporte não regular","voo doméstico",353,355,708,955,434,1389,0,0,0,0
"3840",2013-11-01,"sbsn","transporte não regular","voo internacional",3,3,6,0,0,0,0,0,0,0
"3841",2013-11-01,"sbsp","transporte regular","voo doméstico",6473,6517,12990,785549,761385,1546934,0,0,0,0
"3842",2013-11-01,"sbsp","transporte regular","voo internacional",0,0,0,0,0,0,0,0,0,0
"3843",2013-11-01,"sbsp","transporte não regular","voo doméstico",2336,2292,4628,8216,8449,16665,0,0,0,0
"3844",2013-11-01,"sbsp","transporte não regular","voo internacional",0,0,0,0,0,0,0,0,0,0
"3845",2013-11-01,"sbte","transporte regular","voo doméstico",471,471,942,44484,44622,89106,18033,78982,97015,242657
"3846",2013-11-01,"sbte","transporte regular","voo internacional",0,0,0,0,0,0,0,0,0,0
"3847",2013-11-01,"sbte","transporte não regular","voo doméstico",276,276,552,1224,1305,2529,3966,18648,22614,3057
"3848",2013-11-01,"sbte","transporte não regular","voo internacional",1,2,3,0,0,0,0,0,0,0
"3849",2013-11-01,"sbtf","transporte regular","voo doméstico",83,81,164,3505,3769,7274,0,0,0,0
"3850",2013-11-01,"sbtf","transporte regular","voo internacional",0,0,0,0,0,0,0,0,0,0
"3851",2013-11-01,"sbtf","transporte não regular","voo doméstico",230,233,463,468,249,717,3696,4341,8037,18064
"3852",2013-11-01,"sbtf","transporte não regular","voo internacional",0,0,0,0,0,0,0,0,0,0
"3853",2013-11-01,"sbtt","transporte regular","voo doméstico",30,30,60,2101,2313,4414,0,0,0,0
"3854",2013-11-01,"sbtt","transporte regular","voo internacional",0,0,0,0,0,0,0,0,0,0
"3855",2013-11-01,"sbtt","transporte não regular","voo doméstico",117,115,232,429,453,882,2486,3167,5653,968
"3856",2013-11-01,"sbtt","transporte não regular","voo internacional",0,0,0,0,0,0,0,0,0,0
"3857",2013-11-01,"sbuf","transporte regular","voo doméstico",0,0,0,0,0,0,0,0,0,0
"3858",2013-11-01,"sbuf","transporte regular","voo internacional",0,0,0,0,0,0,0,0,0,0
"3859",2013-11-01,"sbuf","transporte não regular","voo doméstico",55,52,107,127,125,252,0,0,0,0
"3860",2013-11-01,"sbuf","transporte não regular","voo internacional",0,0,0,0,0,0,0,0,0,0
"3861",2013-11-01,"sbug","transporte regular","voo doméstico",0,0,0,0,0,0,0,0,0,0
"3862",2013-11-01,"sbug","transporte regular","voo internacional",0,0,0,0,0,0,0,0,0,0
"3863",2013-11-01,"sbug","transporte não regular","voo doméstico",12,12,24,34,32,66,0,0,0,0
"3864",2013-11-01,"sbug","transporte não regular","voo internacional",0,0,0,0,0,0,0,0,0,0
"3865",2013-11-01,"sbul","transporte regular","voo doméstico",539,541,1080,49009,48494,97503,0,0,0,0
"3866",2013-11-01,"sbul","transporte regular","voo internacional",0,0,0,0,0,0,0,0,0,0
"3867",2013-11-01,"sbul","transporte não regular","voo doméstico",642,641,1283,1666,1723,3389,0,0,0,0
"3868",2013-11-01,"sbul","transporte não regular","voo internacional",1,1,2,3,7,10,0,0,0,0
"3869",2013-11-01,"sbur","transporte regular","voo doméstico",99,100,199,5148,4959,10107,0,0,0,0
"3870",2013-11-01,"sbur","transporte regular","voo internacional",0,0,0,0,0,0,0,0,0,0
"3871",2013-11-01,"sbur","transporte não regular","voo doméstico",188,189,377,802,919,1721,0,0,0,0
"3872",2013-11-01,"sbur","transporte não regular","voo internacional",2,2,4,0,0,0,0,0,0,0
"3873",2013-10-01,"sbbe","transporte regular","voo doméstico",1807,1814,3621,152505,149982,302487,4840,0,4840,0
"3874",2013-10-01,"sbbe","transporte regular","voo internacional",22,22,44,1636,1851,3487,0,7,7,0
"3875",2013-10-01,"sbbe","transporte não regular","voo doméstico",593,589,1182,2491,2947,5438,106153,392841,498994,0
"3876",2013-10-01,"sbbe","transporte não regular","voo internacional",17,20,37,48,152,200,0,0,0,0
"3877",2013-10-01,"sbbg","transporte regular","voo doméstico",0,0,0,0,0,0,0,0,0,0
"3878",2013-10-01,"sbbg","transporte regular","voo internacional",0,0,0,0,0,0,0,0,0,0
"3879",2013-10-01,"sbbg","transporte não regular","voo doméstico",22,23,45,110,94,204,0,0,0,0
"3880",2013-10-01,"sbbg","transporte não regular","voo internacional",2,1,3,5,9,14,0,0,0,0
"3881",2013-10-01,"sbbh","transporte regular","voo doméstico",654,665,1319,30326,36203,66529,0,0,0,0
"3882",2013-10-01,"sbbh","transporte regular","voo internacional",0,0,0,0,0,0,0,0,0,0
"3883",2013-10-01,"sbbh","transporte não regular","voo doméstico",2051,2041,4092,9098,8954,18052,0,0,0,0
"3884",2013-10-01,"sbbh","transporte não regular","voo internacional",13,10,23,85,110,195,0,0,0,0
"3885",2013-10-01,"sbbi","transporte regular","voo doméstico",0,0,0,0,0,0,0,0,0,0
"3886",2013-10-01,"sbbi","transporte regular","voo internacional",0,0,0,0,0,0,0,0,0,0
"3887",2013-10-01,"sbbi","transporte não regular","voo doméstico",1211,1194,2405,3752,3829,7581,0,0,0,0
"3888",2013-10-01,"sbbi","transporte não regular","voo internacional",0,0,0,0,0,0,0,0,0,0
"3889",2013-10-01,"sbbv","transporte regular","voo doméstico",121,121,242,14600,14420,29020,0,0,0,0
"3890",2013-10-01,"sbbv","transporte regular","voo internacional",1,1,2,0,0,0,0,0,0,0
"3891",2013-10-01,"sbbv","transporte não regular","voo doméstico",104,106,210,231,186,417,0,0,0,0
"3892",2013-10-01,"sbbv","transporte não regular","voo internacional",34,31,65,13,12,25,0,0,0,0
"3893",2013-10-01,"sbcg","transporte regular","voo doméstico",575,573,1148,58303,56869,115172,76113,170586,246699,0
"3894",2013-10-01,"sbcg","transporte regular","voo internacional",0,0,0,0,0,0,0,0,0,0
"3895",2013-10-01,"sbcg","transporte não regular","voo doméstico",455,450,905,8068,8309,16377,0,0,0,0
"3896",2013-10-01,"sbcg","transporte não regular","voo internacional",17,17,34,0,1,1,0,0,0,0
"3897",2013-10-01,"sbcj","transporte regular","voo doméstico",122,121,243,5070,4639,9709,0,0,0,0
"3898",2013-10-01,"sbcj","transporte regular","voo internacional",0,0,0,0,0,0,0,0,0,0
"3899",2013-10-01,"sbcj","transporte não regular","voo doméstico",118,119,237,806,785,1591,0,0,0,0
"3900",2013-10-01,"sbcj","transporte não regular","voo internacional",1,1,2,0,0,0,0,0,0,0
"3901",2013-10-01,"sbcr","transporte regular","voo doméstico",27,27,54,1369,1383,2752,0,0,0,0
"3902",2013-10-01,"sbcr","transporte regular","voo internacional",0,0,0,0,0,0,0,0,0,0
"3903",2013-10-01,"sbcr","transporte não regular","voo doméstico",29,27,56,63,59,122,0,0,0,0
"3904",2013-10-01,"sbcr","transporte não regular","voo internacional",3,3,6,10,10,20,0,0,0,0
"3905",2013-10-01,"sbct","transporte regular","voo doméstico",3080,3086,6166,309984,313305,623289,184656,0,184656,188301
"3906",2013-10-01,"sbct","transporte regular","voo internacional",62,62,124,2032,1977,4009,0,19261,19261,0
"3907",2013-10-01,"sbct","transporte não regular","voo doméstico",281,274,555,671,686,1357,0,49521,49521,0
"3908",2013-10-01,"sbct","transporte não regular","voo internacional",14,14,28,27,37,64,0,1463,1463,0
"3909",2013-10-01,"sbcz","transporte regular","voo doméstico",31,31,62,2146,2116,4262,0,0,0,0
"3910",2013-10-01,"sbcz","transporte regular","voo internacional",0,0,0,0,0,0,0,0,0,0
"3911",2013-10-01,"sbcz","transporte não regular","voo doméstico",145,145,290,576,538,1114,0,0,0,0
"3912",2013-10-01,"sbcz","transporte não regular","voo internacional",2,2,4,0,0,0,0,0,0,0
"3913",2013-10-01,"sbeg","transporte regular","voo doméstico",1311,1305,2616,120087,115002,235089,0,0,0,0
"3914",2013-10-01,"sbeg","transporte regular","voo internacional",132,131,263,8860,9182,18042,0,0,0,0
"3915",2013-10-01,"sbeg","transporte não regular","voo doméstico",785,785,1570,8335,7602,15937,0,0,0,0
"3916",2013-10-01,"sbeg","transporte não regular","voo internacional",147,145,292,60,60,120,0,0,0,0
"3917",2013-10-01,"sbfi","transporte regular","voo doméstico",544,544,1088,68044,68179,136223,0,0,0,0
"3918",2013-10-01,"sbfi","transporte regular","voo internacional",27,27,54,2669,2873,5542,0,0,0,0
"3919",2013-10-01,"sbfi","transporte não regular","voo doméstico",160,155,315,543,871,1414,0,0,0,0
"3920",2013-10-01,"sbfi","transporte não regular","voo internacional",40,45,85,125,64,189,0,0,0,0
"3921",2013-10-01,"sbgo","transporte regular","voo doméstico",1465,1465,2930,132542,129281,261823,118278,211541,329819,188632
"3922",2013-10-01,"sbgo","transporte regular","voo internacional",0,0,0,0,0,0,0,0,0,0
"3923",2013-10-01,"sbgo","transporte não regular","voo doméstico",1328,1345,2673,6857,6759,13616,0,0,0,0
"3924",2013-10-01,"sbgo","transporte não regular","voo internacional",3,4,7,20,15,35,0,0,0,0
"3925",2013-10-01,"sbht","transporte regular","voo doméstico",215,216,431,9641,8799,18440,0,0,0,0
"3926",2013-10-01,"sbht","transporte regular","voo internacional",0,0,0,0,0,0,0,0,0,0
"3927",2013-10-01,"sbht","transporte não regular","voo doméstico",160,156,316,504,523,1027,0,0,0,0
"3928",2013-10-01,"sbht","transporte não regular","voo internacional",0,0,0,0,0,0,0,0,0,0
"3929",2013-10-01,"sbiz","transporte regular","voo doméstico",185,186,371,14651,14608,29259,0,0,0,0
"3930",2013-10-01,"sbiz","transporte regular","voo internacional",0,0,0,0,0,0,0,0,0,0
"3931",2013-10-01,"sbiz","transporte não regular","voo doméstico",161,162,323,1314,1202,2516,0,0,0,0
"3932",2013-10-01,"sbiz","transporte não regular","voo internacional",1,1,2,0,0,0,0,0,0,0
"3933",2013-10-01,"sbjc","transporte regular","voo doméstico",0,0,0,0,0,0,0,0,0,0
"3934",2013-10-01,"sbjc","transporte regular","voo internacional",0,0,0,0,0,0,0,0,0,0
"3935",2013-10-01,"sbjc","transporte não regular","voo doméstico",578,577,1155,1226,993,2219,0,0,0,0
"3936",2013-10-01,"sbjc","transporte não regular","voo internacional",0,0,0,0,0,0,0,0,0,0
"3937",2013-10-01,"sbjr","transporte regular","voo doméstico",0,0,0,0,0,0,0,0,0,0
"3938",2013-10-01,"sbjr","transporte regular","voo internacional",0,0,0,0,0,0,0,0,0,0
"3939",2013-10-01,"sbjr","transporte não regular","voo doméstico",3151,3156,6307,7876,3532,11408,0,0,0,0
"3940",2013-10-01,"sbjr","transporte não regular","voo internacional",0,0,0,0,0,0,0,0,0,0
"3941",2013-10-01,"sbjv","transporte regular","voo doméstico",248,248,496,21874,21683,43557,0,0,0,0
"3942",2013-10-01,"sbjv","transporte regular","voo internacional",0,0,0,0,0,0,0,0,0,0
"3943",2013-10-01,"sbjv","transporte não regular","voo doméstico",222,219,441,97,284,381,0,0,0,0
"3944",2013-10-01,"sbjv","transporte não regular","voo internacional",0,0,0,0,0,0,0,0,0,0
"3945",2013-10-01,"sblo","transporte regular","voo doméstico",509,505,1014,47110,47642,94752,0,0,0,0
"3946",2013-10-01,"sblo","transporte regular","voo internacional",0,0,0,0,0,0,0,0,0,0
"3947",2013-10-01,"sblo","transporte não regular","voo doméstico",834,839,1673,1068,884,1952,0,0,0,0
"3948",2013-10-01,"sblo","transporte não regular","voo internacional",0,0,0,0,0,0,0,0,0,0
"3949",2013-10-01,"sbma","transporte regular","voo doméstico",420,421,841,17886,16952,34838,0,0,0,0
"3950",2013-10-01,"sbma","transporte regular","voo internacional",0,0,0,0,0,0,0,0,0,0
"3951",2013-10-01,"sbma","transporte não regular","voo doméstico",299,298,597,1417,1404,2821,0,0,0,0
"3952",2013-10-01,"sbma","transporte não regular","voo internacional",5,5,10,0,0,0,0,0,0,0
"3953",2013-10-01,"sbmk","transporte regular","voo doméstico",191,189,380,15573,15035,30608,0,0,0,0
"3954",2013-10-01,"sbmk","transporte regular","voo internacional",0,0,0,0,0,0,0,0,0,0
"3955",2013-10-01,"sbmk","transporte não regular","voo doméstico",223,226,449,103,75,178,0,0,0,0
"3956",2013-10-01,"sbmk","transporte não regular","voo internacional",1,1,2,0,0,0,0,0,0,0
"3957",2013-10-01,"sbmq","transporte regular","voo doméstico",358,357,715,29784,28920,58704,0,0,0,0
"3958",2013-10-01,"sbmq","transporte regular","voo internacional",0,0,0,0,0,0,0,0,0,0
"3959",2013-10-01,"sbmq","transporte não regular","voo doméstico",296,296,592,659,250,909,0,0,0,0
"3960",2013-10-01,"sbmq","transporte não regular","voo internacional",11,11,22,0,0,0,0,0,0,0
"3961",2013-10-01,"sbmt","transporte regular","voo doméstico",0,0,0,0,0,0,0,0,0,0
"3962",2013-10-01,"sbmt","transporte regular","voo internacional",0,0,0,0,0,0,0,0,0,0
"3963",2013-10-01,"sbmt","transporte não regular","voo doméstico",5985,5981,11966,9269,9229,18498,0,0,0,0
"3964",2013-10-01,"sbmt","transporte não regular","voo internacional",3,4,7,0,0,0,0,0,0,0
"3965",2013-10-01,"sbnf","transporte regular","voo doméstico",537,537,1074,55287,54321,109608,0,0,0,0
"3966",2013-10-01,"sbnf","transporte regular","voo internacional",0,0,0,0,0,0,0,0,0,0
"3967",2013-10-01,"sbnf","transporte não regular","voo doméstico",381,377,758,1204,1756,2960,0,0,0,0
"3968",2013-10-01,"sbnf","transporte não regular","voo internacional",3,4,7,18,12,30,0,0,0,0
"3969",2013-10-01,"sbpb","transporte regular","voo doméstico",0,0,0,0,0,0,0,0,0,0
"3970",2013-10-01,"sbpb","transporte regular","voo internacional",0,0,0,0,0,0,0,0,0,0
"3971",2013-10-01,"sbpb","transporte não regular","voo doméstico",61,62,123,128,118,246,0,0,0,0
"3972",2013-10-01,"sbpb","transporte não regular","voo internacional",0,0,0,0,0,0,0,0,0,0
"3973",2013-10-01,"sbpj","transporte regular","voo doméstico",384,382,766,23473,23044,46517,0,0,0,0
"3974",2013-10-01,"sbpj","transporte regular","voo internacional",0,0,0,0,0,0,0,0,0,0
"3975",2013-10-01,"sbpj","transporte não regular","voo doméstico",470,469,939,660,423,1083,0,0,0,0
"3976",2013-10-01,"sbpj","transporte não regular","voo internacional",5,4,9,0,3,3,0,0,0,0
"3977",2013-10-01,"sbpk","transporte regular","voo doméstico",50,50,100,2577,2472,5049,0,0,0,0
"3978",2013-10-01,"sbpk","transporte regular","voo internacional",0,0,0,0,0,0,0,0,0,0
"3979",2013-10-01,"sbpk","transporte não regular","voo doméstico",52,50,102,141,142,283,0,0,0,0
"3980",2013-10-01,"sbpk","transporte não regular","voo internacional",2,3,5,8,4,12,0,0,0,0
"3981",2013-10-01,"sbpl","transporte regular","voo doméstico",215,215,430,19769,20223,39992,0,0,0,0
"3982",2013-10-01,"sbpl","transporte regular","voo internacional",11,10,21,0,0,0,0,0,0,0
"3983",2013-10-01,"sbpl","transporte não regular","voo doméstico",65,64,129,57,56,113,0,0,0,0
"3984",2013-10-01,"sbpl","transporte não regular","voo internacional",0,0,0,0,0,0,0,0,0,0
"3985",2013-10-01,"sbpp","transporte regular","voo doméstico",0,0,0,0,0,0,0,0,0,0
"3986",2013-10-01,"sbpp","transporte regular","voo internacional",0,0,0,0,0,0,0,0,0,0
"3987",2013-10-01,"sbpp","transporte não regular","voo doméstico",98,98,196,163,167,330,0,0,0,0
"3988",2013-10-01,"sbpp","transporte não regular","voo internacional",6,4,10,12,12,24,0,0,0,0
"3989",2013-10-01,"sbpr","transporte regular","voo doméstico",0,0,0,0,0,0,0,0,0,0
"3990",2013-10-01,"sbpr","transporte regular","voo internacional",0,0,0,0,0,0,0,0,0,0
"3991",2013-10-01,"sbpr","transporte não regular","voo doméstico",1569,1562,3131,1601,1681,3282,0,0,0,0
"3992",2013-10-01,"sbpr","transporte não regular","voo internacional",0,0,0,0,0,0,0,0,0,0
"3993",2013-10-01,"sbpv","transporte regular","voo doméstico",447,446,893,38112,36957,75069,62195,200317,262512,0
"3994",2013-10-01,"sbpv","transporte regular","voo internacional",0,0,0,0,0,0,0,0,0,0
"3995",2013-10-01,"sbpv","transporte não regular","voo doméstico",264,266,530,0,0,0,0,0,0,0
"3996",2013-10-01,"sbpv","transporte não regular","voo internacional",0,0,0,0,0,0,0,0,0,0
"3997",2013-10-01,"sbrb","transporte regular","voo doméstico",164,163,327,14790,13683,28473,0,0,0,0
"3998",2013-10-01,"sbrb","transporte regular","voo internacional",0,0,0,0,0,0,0,0,0,0
"3999",2013-10-01,"sbrb","transporte não regular","voo doméstico",268,265,533,670,486,1156,0,0,0,0
"4000",2013-10-01,"sbrb","transporte não regular","voo internacional",0,0,0,0,0,0,0,0,0,0
"4001",2013-10-01,"sbrj","transporte regular","voo doméstico",4561,4571,9132,424685,413128,837813,0,0,0,0
"4002",2013-10-01,"sbrj","transporte regular","voo internacional",0,0,0,0,0,0,0,0,0,0
"4003",2013-10-01,"sbrj","transporte não regular","voo doméstico",1178,1166,2344,1266,1625,2891,0,0,0,0
"4004",2013-10-01,"sbrj","transporte não regular","voo internacional",5,5,10,0,0,0,0,0,0,0
"4005",2013-10-01,"sbsj","transporte regular","voo doméstico",62,63,125,3614,3534,7148,0,0,0,0
"4006",2013-10-01,"sbsj","transporte regular","voo internacional",0,0,0,0,0,0,0,0,0,0
"4007",2013-10-01,"sbsj","transporte não regular","voo doméstico",557,531,1088,1103,620,1723,0,0,0,0
"4008",2013-10-01,"sbsj","transporte não regular","voo internacional",6,19,25,16,5,21,0,0,0,0
"4009",2013-10-01,"sbsl","transporte regular","voo doméstico",737,734,1471,70346,71187,141533,0,6,6,0
"4010",2013-10-01,"sbsl","transporte regular","voo internacional",0,0,0,0,0,0,0,0,0,0
"4011",2013-10-01,"sbsl","transporte não regular","voo doméstico",449,452,901,1040,862,1902,82231,178896,261127,0
"4012",2013-10-01,"sbsl","transporte não regular","voo internacional",2,2,4,0,0,0,0,0,0,0
"4013",2013-10-01,"sbsn","transporte regular","voo doméstico",429,428,857,27205,24696,51901,0,0,0,0
"4014",2013-10-01,"sbsn","transporte regular","voo internacional",0,0,0,0,0,0,0,0,0,0
"4015",2013-10-01,"sbsn","transporte não regular","voo doméstico",393,393,786,1124,639,1763,0,0,0,0
"4016",2013-10-01,"sbsn","transporte não regular","voo internacional",1,2,3,0,0,0,0,0,0,0
"4017",2013-10-01,"sbsp","transporte regular","voo doméstico",6824,6928,13752,805129,786658,1591787,0,0,0,0
"4018",2013-10-01,"sbsp","transporte regular","voo internacional",0,0,0,0,0,0,0,0,0,0
"4019",2013-10-01,"sbsp","transporte não regular","voo doméstico",2398,2298,4696,10721,14978,25699,0,0,0,0
"4020",2013-10-01,"sbsp","transporte não regular","voo internacional",0,0,0,0,0,0,0,0,0,0
"4021",2013-10-01,"sbte","transporte regular","voo doméstico",501,500,1001,44657,44141,88798,29465,82915,112380,311737
"4022",2013-10-01,"sbte","transporte regular","voo internacional",0,0,0,0,0,0,0,0,0,0
"4023",2013-10-01,"sbte","transporte não regular","voo doméstico",277,269,546,1253,1296,2549,0,0,0,0
"4024",2013-10-01,"sbte","transporte não regular","voo internacional",1,0,1,0,0,0,0,0,0,0
"4025",2013-10-01,"sbtf","transporte regular","voo doméstico",74,72,146,2991,2986,5977,0,0,0,0
"4026",2013-10-01,"sbtf","transporte regular","voo internacional",0,0,0,0,0,0,0,0,0,0
"4027",2013-10-01,"sbtf","transporte não regular","voo doméstico",238,237,475,630,443,1073,2474,4795,7269,19943
"4028",2013-10-01,"sbtf","transporte não regular","voo internacional",0,0,0,0,0,0,0,0,0,0
"4029",2013-10-01,"sbtt","transporte regular","voo doméstico",35,35,70,2265,2504,4769,0,0,0,0
"4030",2013-10-01,"sbtt","transporte regular","voo internacional",0,0,0,0,0,0,0,0,0,0
"4031",2013-10-01,"sbtt","transporte não regular","voo doméstico",104,103,207,401,422,823,3084,3704,6788,610
"4032",2013-10-01,"sbtt","transporte não regular","voo internacional",1,6,7,14,4,18,0,0,0,0
"4033",2013-10-01,"sbuf","transporte regular","voo doméstico",0,0,0,0,0,0,0,0,0,0
"4034",2013-10-01,"sbuf","transporte regular","voo internacional",0,0,0,0,0,0,0,0,0,0
"4035",2013-10-01,"sbuf","transporte não regular","voo doméstico",40,41,81,117,129,246,0,0,0,0
"4036",2013-10-01,"sbuf","transporte não regular","voo internacional",0,0,0,0,0,0,0,0,0,0
"4037",2013-10-01,"sbug","transporte regular","voo doméstico",0,0,0,0,0,0,0,0,0,0
"4038",2013-10-01,"sbug","transporte regular","voo internacional",0,0,0,0,0,0,0,0,0,0
"4039",2013-10-01,"sbug","transporte não regular","voo doméstico",11,10,21,24,22,46,0,0,0,0
"4040",2013-10-01,"sbug","transporte não regular","voo internacional",0,1,1,0,0,0,0,0,0,0
"4041",2013-10-01,"sbul","transporte regular","voo doméstico",564,561,1125,50709,50405,101114,0,0,0,0
"4042",2013-10-01,"sbul","transporte regular","voo internacional",0,0,0,0,0,0,0,0,0,0
"4043",2013-10-01,"sbul","transporte não regular","voo doméstico",750,754,1504,3792,2943,6735,0,0,0,0
"4044",2013-10-01,"sbul","transporte não regular","voo internacional",0,0,0,0,0,0,0,0,0,0
"4045",2013-10-01,"sbur","transporte regular","voo doméstico",102,104,206,5235,5290,10525,0,0,0,0
"4046",2013-10-01,"sbur","transporte regular","voo internacional",0,0,0,0,0,0,0,0,0,0
"4047",2013-10-01,"sbur","transporte não regular","voo doméstico",182,180,362,555,596,1151,0,0,0,0
"4048",2013-10-01,"sbur","transporte não regular","voo internacional",2,2,4,0,0,0,0,0,0,0
"4049",2013-09-01,"sbbe","transporte regular","voo doméstico",1659,1654,3313,142103,141193,283296,0,0,0,0
"4050",2013-09-01,"sbbe","transporte regular","voo internacional",21,21,42,1970,1912,3882,0,12,12,0
"4051",2013-09-01,"sbbe","transporte não regular","voo doméstico",509,505,1014,2313,2354,4667,96600,329761,426361,0
"4052",2013-09-01,"sbbe","transporte não regular","voo internacional",8,9,17,52,16,68,0,0,0,0
"4053",2013-09-01,"sbbg","transporte regular","voo doméstico",0,0,0,0,0,0,0,0,0,0
"4054",2013-09-01,"sbbg","transporte regular","voo internacional",0,0,0,0,0,0,0,0,0,0
"4055",2013-09-01,"sbbg","transporte não regular","voo doméstico",9,11,20,62,42,104,0,0,0,0
"4056",2013-09-01,"sbbg","transporte não regular","voo internacional",1,0,1,0,0,0,0,0,0,0
"4057",2013-09-01,"sbbh","transporte regular","voo doméstico",613,622,1235,29450,34045,63495,0,0,0,0
"4058",2013-09-01,"sbbh","transporte regular","voo internacional",0,0,0,0,0,0,0,0,0,0
"4059",2013-09-01,"sbbh","transporte não regular","voo doméstico",2148,2141,4289,9013,8964,17977,0,0,0,0
"4060",2013-09-01,"sbbh","transporte não regular","voo internacional",5,5,10,27,27,54,0,0,0,0
"4061",2013-09-01,"sbbi","transporte regular","voo doméstico",0,0,0,0,0,0,0,0,0,0
"4062",2013-09-01,"sbbi","transporte regular","voo internacional",0,0,0,0,0,0,0,0,0,0
"4063",2013-09-01,"sbbi","transporte não regular","voo doméstico",1124,1108,2232,3577,3450,7027,0,0,0,0
"4064",2013-09-01,"sbbi","transporte não regular","voo internacional",4,3,7,0,0,0,0,0,0,0
"4065",2013-09-01,"sbbv","transporte regular","voo doméstico",127,127,254,15289,14981,30270,0,0,0,0
"4066",2013-09-01,"sbbv","transporte regular","voo internacional",0,0,0,0,0,0,0,0,0,0
"4067",2013-09-01,"sbbv","transporte não regular","voo doméstico",101,98,199,94,135,229,0,0,0,0
"4068",2013-09-01,"sbbv","transporte não regular","voo internacional",29,25,54,9,9,18,0,0,0,0
"4069",2013-09-01,"sbcg","transporte regular","voo doméstico",498,502,1000,51262,48529,99791,55433,100804,156237,0
"4070",2013-09-01,"sbcg","transporte regular","voo internacional",0,0,0,0,0,0,0,0,0,0
"4071",2013-09-01,"sbcg","transporte não regular","voo doméstico",423,426,849,8757,9260,18017,0,15917,15917,0
"4072",2013-09-01,"sbcg","transporte não regular","voo internacional",9,9,18,0,0,0,0,0,0,0
"4073",2013-09-01,"sbcj","transporte regular","voo doméstico",116,116,232,4947,5135,10082,0,0,0,0
"4074",2013-09-01,"sbcj","transporte regular","voo internacional",0,0,0,0,0,0,0,0,0,0
"4075",2013-09-01,"sbcj","transporte não regular","voo doméstico",124,126,250,1022,1293,2315,0,0,0,0
"4076",2013-09-01,"sbcj","transporte não regular","voo internacional",1,1,2,0,0,0,0,0,0,0
"4077",2013-09-01,"sbcr","transporte regular","voo doméstico",26,26,52,1355,1345,2700,0,0,0,0
"4078",2013-09-01,"sbcr","transporte regular","voo internacional",0,0,0,0,0,0,0,0,0,0
"4079",2013-09-01,"sbcr","transporte não regular","voo doméstico",55,57,112,143,139,282,0,0,0,0
"4080",2013-09-01,"sbcr","transporte não regular","voo internacional",3,3,6,4,4,8,0,0,0,0
"4081",2013-09-01,"sbct","transporte regular","voo doméstico",2970,2991,5961,286987,280891,567878,131084,0,131084,142376
"4082",2013-09-01,"sbct","transporte regular","voo internacional",62,62,124,1935,2074,4009,0,27656,27656,0
"4083",2013-09-01,"sbct","transporte não regular","voo doméstico",318,296,614,2530,4131,6661,0,0,0,0
"4084",2013-09-01,"sbct","transporte não regular","voo internacional",20,16,36,42,60,102,0,0,0,0
"4085",2013-09-01,"sbcz","transporte regular","voo doméstico",30,30,60,2211,2092,4303,0,0,0,0
"4086",2013-09-01,"sbcz","transporte regular","voo internacional",0,0,0,0,0,0,0,0,0,0
"4087",2013-09-01,"sbcz","transporte não regular","voo doméstico",155,153,308,673,694,1367,0,0,0,0
"4088",2013-09-01,"sbcz","transporte não regular","voo internacional",0,0,0,0,0,0,0,0,0,0
"4089",2013-09-01,"sbeg","transporte regular","voo doméstico",1210,1217,2427,98827,93275,192102,0,0,0,0
"4090",2013-09-01,"sbeg","transporte regular","voo internacional",112,113,225,6736,7326,14062,0,0,0,0
"4091",2013-09-01,"sbeg","transporte não regular","voo doméstico",735,729,1464,7764,7711,15475,0,0,0,0
"4092",2013-09-01,"sbeg","transporte não regular","voo internacional",138,135,273,0,0,0,0,0,0,0
"4093",2013-09-01,"sbfi","transporte regular","voo doméstico",568,571,1139,65006,64337,129343,0,0,0,0
"4094",2013-09-01,"sbfi","transporte regular","voo internacional",27,27,54,2594,2775,5369,0,0,0,0
"4095",2013-09-01,"sbfi","transporte não regular","voo doméstico",135,133,268,370,601,971,0,0,0,0
"4096",2013-09-01,"sbfi","transporte não regular","voo internacional",38,40,78,123,82,205,0,0,0,0
"4097",2013-09-01,"sbgo","transporte regular","voo doméstico",1397,1393,2790,121754,119644,241398,132650,153680,286330,174182
"4098",2013-09-01,"sbgo","transporte regular","voo internacional",0,0,0,0,0,0,0,0,0,0
"4099",2013-09-01,"sbgo","transporte não regular","voo doméstico",1389,1374,2763,6946,7111,14057,0,0,0,0
"4100",2013-09-01,"sbgo","transporte não regular","voo internacional",12,10,22,50,60,110,0,0,0,0
"4101",2013-09-01,"sbht","transporte regular","voo doméstico",186,185,371,8690,8517,17207,0,0,0,0
"4102",2013-09-01,"sbht","transporte regular","voo internacional",0,0,0,0,0,0,0,0,0,0
"4103",2013-09-01,"sbht","transporte não regular","voo doméstico",147,148,295,445,410,855,300,0,300,0
"4104",2013-09-01,"sbht","transporte não regular","voo internacional",1,1,2,0,0,0,0,0,0,0
"4105",2013-09-01,"sbiz","transporte regular","voo doméstico",179,179,358,14682,15005,29687,0,0,0,0
"4106",2013-09-01,"sbiz","transporte regular","voo internacional",0,0,0,0,0,0,0,0,0,0
"4107",2013-09-01,"sbiz","transporte não regular","voo doméstico",206,207,413,1625,1455,3080,0,0,0,0
"4108",2013-09-01,"sbiz","transporte não regular","voo internacional",2,2,4,0,0,0,0,0,0,0
"4109",2013-09-01,"sbjc","transporte regular","voo doméstico",0,0,0,0,0,0,0,0,0,0
"4110",2013-09-01,"sbjc","transporte regular","voo internacional",0,0,0,0,0,0,0,0,0,0
"4111",2013-09-01,"sbjc","transporte não regular","voo doméstico",601,610,1211,1304,1027,2331,0,0,0,0
"4112",2013-09-01,"sbjc","transporte não regular","voo internacional",3,3,6,0,0,0,0,0,0,0
"4113",2013-09-01,"sbjr","transporte regular","voo doméstico",0,0,0,0,0,0,0,0,0,0
"4114",2013-09-01,"sbjr","transporte regular","voo internacional",0,0,0,0,0,0,0,0,0,0
"4115",2013-09-01,"sbjr","transporte não regular","voo doméstico",3142,3130,6272,7352,3377,10729,0,0,0,0
"4116",2013-09-01,"sbjr","transporte não regular","voo internacional",0,0,0,0,0,0,0,0,0,0
"4117",2013-09-01,"sbjv","transporte regular","voo doméstico",233,236,469,17953,17655,35608,0,0,0,0
"4118",2013-09-01,"sbjv","transporte regular","voo internacional",0,0,0,0,0,0,0,0,0,0
"4119",2013-09-01,"sbjv","transporte não regular","voo doméstico",241,239,480,191,1024,1215,0,0,0,0
"4120",2013-09-01,"sbjv","transporte não regular","voo internacional",0,0,0,0,0,0,0,0,0,0
"4121",2013-09-01,"sblo","transporte regular","voo doméstico",475,476,951,43659,42517,86176,0,0,0,0
"4122",2013-09-01,"sblo","transporte regular","voo internacional",0,0,0,0,0,0,0,0,0,0
"4123",2013-09-01,"sblo","transporte não regular","voo doméstico",691,690,1381,876,929,1805,0,0,0,0
"4124",2013-09-01,"sblo","transporte não regular","voo internacional",1,1,2,0,0,0,0,0,0,0
"4125",2013-09-01,"sbma","transporte regular","voo doméstico",378,379,757,17628,17425,35053,0,0,0,0
"4126",2013-09-01,"sbma","transporte regular","voo internacional",0,0,0,0,0,0,0,0,0,0
"4127",2013-09-01,"sbma","transporte não regular","voo doméstico",287,282,569,1165,1183,2348,0,0,0,0
"4128",2013-09-01,"sbma","transporte não regular","voo internacional",1,1,2,0,0,0,0,0,0,0
"4129",2013-09-01,"sbmk","transporte regular","voo doméstico",186,185,371,14770,14305,29075,0,0,0,0
"4130",2013-09-01,"sbmk","transporte regular","voo internacional",0,0,0,0,0,0,0,0,0,0
"4131",2013-09-01,"sbmk","transporte não regular","voo doméstico",250,253,503,42,22,64,0,0,0,0
"4132",2013-09-01,"sbmk","transporte não regular","voo internacional",0,0,0,0,0,0,0,0,0,0
"4133",2013-09-01,"sbmq","transporte regular","voo doméstico",333,333,666,28571,28684,57255,0,0,0,0
"4134",2013-09-01,"sbmq","transporte regular","voo internacional",0,0,0,0,0,0,0,0,0,0
"4135",2013-09-01,"sbmq","transporte não regular","voo doméstico",265,266,531,337,123,460,0,0,0,0
"4136",2013-09-01,"sbmq","transporte não regular","voo internacional",10,8,18,0,0,0,0,0,0,0
"4137",2013-09-01,"sbmt","transporte regular","voo doméstico",0,0,0,0,0,0,0,0,0,0
"4138",2013-09-01,"sbmt","transporte regular","voo internacional",0,0,0,0,0,0,0,0,0,0
"4139",2013-09-01,"sbmt","transporte não regular","voo doméstico",5492,5467,10959,8241,8785,17026,0,0,0,0
"4140",2013-09-01,"sbmt","transporte não regular","voo internacional",6,3,9,0,0,0,0,0,0,0
"4141",2013-09-01,"sbnf","transporte regular","voo doméstico",505,505,1010,44502,44375,88877,0,0,0,0
"4142",2013-09-01,"sbnf","transporte regular","voo internacional",0,0,0,0,0,0,0,0,0,0
"4143",2013-09-01,"sbnf","transporte não regular","voo doméstico",362,364,726,1035,1311,2346,0,0,0,0
"4144",2013-09-01,"sbnf","transporte não regular","voo internacional",3,5,8,7,5,12,0,0,0,0
"4145",2013-09-01,"sbpb","transporte regular","voo doméstico",0,0,0,0,0,0,0,0,0,0
"4146",2013-09-01,"sbpb","transporte regular","voo internacional",0,0,0,0,0,0,0,0,0,0
"4147",2013-09-01,"sbpb","transporte não regular","voo doméstico",70,69,139,155,148,303,0,0,0,0
"4148",2013-09-01,"sbpb","transporte não regular","voo internacional",0,0,0,0,0,0,0,0,0,0
"4149",2013-09-01,"sbpj","transporte regular","voo doméstico",324,325,649,22196,21705,43901,120,90,210,0
"4150",2013-09-01,"sbpj","transporte regular","voo internacional",0,0,0,0,0,0,0,0,0,0
"4151",2013-09-01,"sbpj","transporte não regular","voo doméstico",446,450,896,672,526,1198,3200,2792,5992,0
"4152",2013-09-01,"sbpj","transporte não regular","voo internacional",4,4,8,2,1,3,0,0,0,0
"4153",2013-09-01,"sbpk","transporte regular","voo doméstico",50,50,100,2622,2316,4938,0,0,0,0
"4154",2013-09-01,"sbpk","transporte regular","voo internacional",0,0,0,0,0,0,0,0,0,0
"4155",2013-09-01,"sbpk","transporte não regular","voo doméstico",52,50,102,133,139,272,0,0,0,0
"4156",2013-09-01,"sbpk","transporte não regular","voo internacional",2,1,3,0,0,0,0,0,0,0
"4157",2013-09-01,"sbpl","transporte regular","voo doméstico",209,209,418,18485,18287,36772,0,0,0,0
"4158",2013-09-01,"sbpl","transporte regular","voo internacional",4,4,8,0,0,0,0,0,0,0
"4159",2013-09-01,"sbpl","transporte não regular","voo doméstico",94,94,188,140,123,263,0,0,0,0
"4160",2013-09-01,"sbpl","transporte não regular","voo internacional",0,0,0,0,0,0,0,0,0,0
"4161",2013-09-01,"sbpp","transporte regular","voo doméstico",0,0,0,0,0,0,0,0,0,0
"4162",2013-09-01,"sbpp","transporte regular","voo internacional",0,0,0,0,0,0,0,0,0,0
"4163",2013-09-01,"sbpp","transporte não regular","voo doméstico",92,97,189,166,151,317,0,0,0,0
"4164",2013-09-01,"sbpp","transporte não regular","voo internacional",8,7,15,6,7,13,0,0,0,0
"4165",2013-09-01,"sbpr","transporte regular","voo doméstico",1,1,2,1,1,2,0,0,0,0
"4166",2013-09-01,"sbpr","transporte regular","voo internacional",0,0,0,0,0,0,0,0,0,0
"4167",2013-09-01,"sbpr","transporte não regular","voo doméstico",1447,1440,2887,1581,1514,3095,0,0,0,0
"4168",2013-09-01,"sbpr","transporte não regular","voo internacional",0,1,1,0,0,0,0,0,0,0
"4169",2013-09-01,"sbpv","transporte regular","voo doméstico",435,436,871,36445,32551,68996,50561,164009,214570,0
"4170",2013-09-01,"sbpv","transporte regular","voo internacional",0,0,0,0,0,0,0,0,0,0
"4171",2013-09-01,"sbpv","transporte não regular","voo doméstico",301,304,605,0,0,0,0,0,0,0
"4172",2013-09-01,"sbpv","transporte não regular","voo internacional",3,3,6,0,0,0,0,0,0,0
"4173",2013-09-01,"sbrb","transporte regular","voo doméstico",159,159,318,14640,14728,29368,0,0,0,0
"4174",2013-09-01,"sbrb","transporte regular","voo internacional",0,0,0,0,0,0,0,0,0,0
"4175",2013-09-01,"sbrb","transporte não regular","voo doméstico",266,263,529,631,432,1063,0,0,0,0
"4176",2013-09-01,"sbrb","transporte não regular","voo internacional",0,0,0,0,0,0,0,0,0,0
"4177",2013-09-01,"sbrj","transporte regular","voo doméstico",4388,4389,8777,413671,406767,820438,0,0,0,0
"4178",2013-09-01,"sbrj","transporte regular","voo internacional",0,0,0,0,0,0,0,0,0,0
"4179",2013-09-01,"sbrj","transporte não regular","voo doméstico",1183,1174,2357,1121,1501,2622,0,0,0,0
"4180",2013-09-01,"sbrj","transporte não regular","voo internacional",4,4,8,0,0,0,0,0,0,0
"4181",2013-09-01,"sbsj","transporte regular","voo doméstico",93,92,185,4425,4489,8914,0,0,0,0
"4182",2013-09-01,"sbsj","transporte regular","voo internacional",0,0,0,0,0,0,0,0,0,0
"4183",2013-09-01,"sbsj","transporte não regular","voo doméstico",515,506,1021,1443,1032,2475,0,0,0,0
"4184",2013-09-01,"sbsj","transporte não regular","voo internacional",1,10,11,12,0,12,0,0,0,0
"4185",2013-09-01,"sbsl","transporte regular","voo doméstico",679,679,1358,69984,72556,142540,0,0,0,0
"4186",2013-09-01,"sbsl","transporte regular","voo internacional",0,0,0,0,0,0,0,0,0,0
"4187",2013-09-01,"sbsl","transporte não regular","voo doméstico",460,456,916,842,662,1504,91892,189742,281634,0
"4188",2013-09-01,"sbsl","transporte não regular","voo internacional",2,2,4,0,2,2,0,0,0,0
"4189",2013-09-01,"sbsn","transporte regular","voo doméstico",369,368,737,25375,23304,48679,0,0,0,0
"4190",2013-09-01,"sbsn","transporte regular","voo internacional",0,0,0,0,0,0,0,0,0,0
"4191",2013-09-01,"sbsn","transporte não regular","voo doméstico",355,356,711,966,535,1501,0,0,0,0
"4192",2013-09-01,"sbsn","transporte não regular","voo internacional",2,2,4,0,0,0,0,0,0,0
"4193",2013-09-01,"sbsp","transporte regular","voo doméstico",6566,6643,13209,757333,741119,1498452,0,0,0,0
"4194",2013-09-01,"sbsp","transporte regular","voo internacional",0,0,0,0,0,0,0,0,0,0
"4195",2013-09-01,"sbsp","transporte não regular","voo doméstico",2240,2167,4407,9945,9254,19199,0,0,0,0
"4196",2013-09-01,"sbsp","transporte não regular","voo internacional",0,0,0,0,0,0,0,0,0,0
"4197",2013-09-01,"sbte","transporte regular","voo doméstico",476,477,953,44448,43231,87679,17616,91638,109254,269823
"4198",2013-09-01,"sbte","transporte regular","voo internacional",0,0,0,0,0,0,0,0,0,0
"4199",2013-09-01,"sbte","transporte não regular","voo doméstico",260,257,517,1238,1285,2523,0,0,0,0
"4200",2013-09-01,"sbte","transporte não regular","voo internacional",0,0,0,0,0,0,0,0,0,0
"4201",2013-09-01,"sbtf","transporte regular","voo doméstico",59,59,118,1761,1932,3693,0,0,0,0
"4202",2013-09-01,"sbtf","transporte regular","voo internacional",0,0,0,0,0,0,0,0,0,0
"4203",2013-09-01,"sbtf","transporte não regular","voo doméstico",215,216,431,568,509,1077,1665,3505,5170,17729
"4204",2013-09-01,"sbtf","transporte não regular","voo internacional",0,0,0,0,0,0,0,0,0,0
"4205",2013-09-01,"sbtt","transporte regular","voo doméstico",39,39,78,2107,2420,4527,0,0,0,0
"4206",2013-09-01,"sbtt","transporte regular","voo internacional",0,0,0,0,0,0,0,0,0,0
"4207",2013-09-01,"sbtt","transporte não regular","voo doméstico",89,81,170,339,373,712,3017,3022,6039,945
"4208",2013-09-01,"sbtt","transporte não regular","voo internacional",0,2,2,5,0,5,0,0,0,0
"4209",2013-09-01,"sbuf","transporte regular","voo doméstico",0,0,0,0,0,0,0,0,0,0
"4210",2013-09-01,"sbuf","transporte regular","voo internacional",0,0,0,0,0,0,0,0,0,0
"4211",2013-09-01,"sbuf","transporte não regular","voo doméstico",44,44,88,113,110,223,0,0,0,0
"4212",2013-09-01,"sbuf","transporte não regular","voo internacional",0,0,0,0,0,0,0,0,0,0
"4213",2013-09-01,"sbug","transporte regular","voo doméstico",0,0,0,0,0,0,0,0,0,0
"4214",2013-09-01,"sbug","transporte regular","voo internacional",0,0,0,0,0,0,0,0,0,0
"4215",2013-09-01,"sbug","transporte não regular","voo doméstico",13,13,26,32,26,58,0,0,0,0
"4216",2013-09-01,"sbug","transporte não regular","voo internacional",0,0,0,0,0,0,0,0,0,0
"4217",2013-09-01,"sbul","transporte regular","voo doméstico",572,571,1143,49906,48313,98219,0,0,0,0
"4218",2013-09-01,"sbul","transporte regular","voo internacional",0,0,0,0,0,0,0,0,0,0
"4219",2013-09-01,"sbul","transporte não regular","voo doméstico",637,633,1270,1360,1301,2661,0,0,0,0
"4220",2013-09-01,"sbul","transporte não regular","voo internacional",0,0,0,0,0,0,0,0,0,0
"4221",2013-09-01,"sbur","transporte regular","voo doméstico",109,110,219,4744,4530,9274,0,0,0,0
"4222",2013-09-01,"sbur","transporte regular","voo internacional",0,0,0,0,0,0,0,0,0,0
"4223",2013-09-01,"sbur","transporte não regular","voo doméstico",266,265,531,856,922,1778,0,0,0,0
"4224",2013-09-01,"sbur","transporte não regular","voo internacional",0,0,0,0,0,0,0,0,0,0
"4225",2014-04-01,"sbbe","transporte regular","voo doméstico",1584,1589,3173,145498,145430,290928,6,0,6,0
"4226",2014-04-01,"sbbe","transporte regular","voo internacional",26,26,52,2947,3283,6230,0,85,85,0
"4227",2014-04-01,"sbbe","transporte não regular","voo doméstico",612,612,1224,3185,3177,6362,91174,347015,438189,0
"4228",2014-04-01,"sbbe","transporte não regular","voo internacional",14,15,29,36,20,56,0,0,0,0
"4229",2014-04-01,"sbbg","transporte regular","voo doméstico",0,0,0,0,0,0,0,0,0,0
"4230",2014-04-01,"sbbg","transporte regular","voo internacional",0,0,0,0,0,0,0,0,0,0
"4231",2014-04-01,"sbbg","transporte não regular","voo doméstico",22,21,43,91,115,206,0,0,0,0
"4232",2014-04-01,"sbbg","transporte não regular","voo internacional",1,1,2,0,0,0,0,0,0,0
"4233",2014-04-01,"sbbh","transporte regular","voo doméstico",548,538,1086,27578,29878,57456,0,0,0,0
"4234",2014-04-01,"sbbh","transporte regular","voo internacional",0,0,0,0,0,0,0,0,0,0
"4235",2014-04-01,"sbbh","transporte não regular","voo doméstico",2171,2193,4364,9985,9927,19912,0,0,0,0
"4236",2014-04-01,"sbbh","transporte não regular","voo internacional",4,4,8,28,28,56,0,0,0,0
"4237",2014-04-01,"sbbi","transporte regular","voo doméstico",0,0,0,0,0,0,0,0,0,0
"4238",2014-04-01,"sbbi","transporte regular","voo internacional",0,0,0,0,0,0,0,0,0,0
"4239",2014-04-01,"sbbi","transporte não regular","voo doméstico",1245,1247,2492,4353,5869,10222,0,0,0,0
"4240",2014-04-01,"sbbi","transporte não regular","voo internacional",9,9,18,0,0,0,0,0,0,0
"4241",2014-04-01,"sbbv","transporte regular","voo doméstico",125,125,250,14671,14028,28699,0,0,0,0
"4242",2014-04-01,"sbbv","transporte regular","voo internacional",0,0,0,0,0,0,0,0,0,0
"4243",2014-04-01,"sbbv","transporte não regular","voo doméstico",82,95,177,205,107,312,0,0,0,0
"4244",2014-04-01,"sbbv","transporte não regular","voo internacional",27,17,44,2,8,10,0,0,0,0
"4245",2014-04-01,"sbcg","transporte regular","voo doméstico",638,642,1280,67455,65265,132720,67171,129047,196218,0
"4246",2014-04-01,"sbcg","transporte regular","voo internacional",0,0,0,0,0,0,0,0,0,0
"4247",2014-04-01,"sbcg","transporte não regular","voo doméstico",451,449,900,2607,3008,5615,3883,15368,19251,0
"4248",2014-04-01,"sbcg","transporte não regular","voo internacional",8,7,15,0,0,0,0,0,0,0
"4249",2014-04-01,"sbcj","transporte regular","voo doméstico",96,96,192,4390,3974,8364,0,0,0,0
"4250",2014-04-01,"sbcj","transporte regular","voo internacional",0,0,0,0,0,0,0,0,0,0
"4251",2014-04-01,"sbcj","transporte não regular","voo doméstico",87,88,175,1326,1193,2519,0,0,0,0
"4252",2014-04-01,"sbcj","transporte não regular","voo internacional",2,2,4,0,0,0,0,0,0,0
"4253",2014-04-01,"sbcr","transporte regular","voo doméstico",25,25,50,1331,1374,2705,0,0,0,0
"4254",2014-04-01,"sbcr","transporte regular","voo internacional",0,0,0,0,0,0,0,0,0,0
"4255",2014-04-01,"sbcr","transporte não regular","voo doméstico",40,37,77,96,95,191,0,0,0,0
"4256",2014-04-01,"sbcr","transporte não regular","voo internacional",5,6,11,12,6,18,0,0,0,0
"4257",2014-04-01,"sbct","transporte regular","voo doméstico",2881,2873,5754,300732,293493,594225,271712,0,271712,221970
"4258",2014-04-01,"sbct","transporte regular","voo internacional",125,125,250,6166,5417,11583,0,8218,8218,0
"4259",2014-04-01,"sbct","transporte não regular","voo doméstico",256,268,524,3177,1755,4932,0,0,0,0
"4260",2014-04-01,"sbct","transporte não regular","voo internacional",15,13,28,35,36,71,0,0,0,0
"4261",2014-04-01,"sbcz","transporte regular","voo doméstico",29,29,58,2251,2317,4568,0,0,0,0
"4262",2014-04-01,"sbcz","transporte regular","voo internacional",0,0,0,0,0,0,0,0,0,0
"4263",2014-04-01,"sbcz","transporte não regular","voo doméstico",124,124,248,416,382,798,0,0,0,0
"4264",2014-04-01,"sbcz","transporte não regular","voo internacional",1,1,2,0,0,0,0,0,0,0
"4265",2014-04-01,"sbeg","transporte regular","voo doméstico",1254,1247,2501,118764,115445,234209,0,0,0,0
"4266",2014-04-01,"sbeg","transporte regular","voo internacional",107,110,217,7993,7243,15236,0,0,0,0
"4267",2014-04-01,"sbeg","transporte não regular","voo doméstico",618,619,1237,6577,6836,13413,0,0,0,0
"4268",2014-04-01,"sbeg","transporte não regular","voo internacional",116,118,234,416,279,695,0,0,0,0
"4269",2014-04-01,"sbfi","transporte regular","voo doméstico",530,529,1059,68198,69200,137398,0,0,0,0
"4270",2014-04-01,"sbfi","transporte regular","voo internacional",30,30,60,3655,3434,7089,0,0,0,0
"4271",2014-04-01,"sbfi","transporte não regular","voo doméstico",123,126,249,1448,1594,3042,0,0,0,0
"4272",2014-04-01,"sbfi","transporte não regular","voo internacional",48,44,92,387,425,812,0,0,0,0
"4273",2014-04-01,"sbgo","transporte regular","voo doméstico",1343,1341,2684,139336,137370,276706,44334,125634,169968,133290
"4274",2014-04-01,"sbgo","transporte regular","voo internacional",0,0,0,0,0,0,0,0,0,0
"4275",2014-04-01,"sbgo","transporte não regular","voo doméstico",1412,1419,2831,4789,4941,9730,12878,24854,37732,27533
"4276",2014-04-01,"sbgo","transporte não regular","voo internacional",8,8,16,0,0,0,0,0,0,0
"4277",2014-04-01,"sbht","transporte regular","voo doméstico",177,177,354,9262,9165,18427,0,0,0,0
"4278",2014-04-01,"sbht","transporte regular","voo internacional",0,0,0,0,0,0,0,0,0,0
"4279",2014-04-01,"sbht","transporte não regular","voo doméstico",187,186,373,1265,966,2231,6477,8724,15201,728
"4280",2014-04-01,"sbht","transporte não regular","voo internacional",0,0,0,0,0,0,0,0,0,0
"4281",2014-04-01,"sbiz","transporte regular","voo doméstico",217,217,434,13851,13431,27282,0,0,0,0
"4282",2014-04-01,"sbiz","transporte regular","voo internacional",0,0,0,0,0,0,0,0,0,0
"4283",2014-04-01,"sbiz","transporte não regular","voo doméstico",118,120,238,256,309,565,0,0,0,0
"4284",2014-04-01,"sbiz","transporte não regular","voo internacional",0,0,0,0,0,0,0,0,0,0
"4285",2014-04-01,"sbjc","transporte regular","voo doméstico",0,0,0,0,0,0,0,0,0,0
"4286",2014-04-01,"sbjc","transporte regular","voo internacional",0,0,0,0,0,0,0,0,0,0
"4287",2014-04-01,"sbjc","transporte não regular","voo doméstico",434,437,871,916,781,1697,0,0,0,0
"4288",2014-04-01,"sbjc","transporte não regular","voo internacional",0,0,0,0,0,0,0,0,0,0
"4289",2014-04-01,"sbjr","transporte regular","voo doméstico",0,0,0,0,0,0,0,0,0,0
"4290",2014-04-01,"sbjr","transporte regular","voo internacional",0,0,0,0,0,0,0,0,0,0
"4291",2014-04-01,"sbjr","transporte não regular","voo doméstico",3332,3336,6668,10396,4875,15271,0,0,0,0
"4292",2014-04-01,"sbjr","transporte não regular","voo internacional",0,0,0,0,0,0,0,0,0,0
"4293",2014-04-01,"sbjv","transporte regular","voo doméstico",238,239,477,21293,20984,42277,0,0,0,0
"4294",2014-04-01,"sbjv","transporte regular","voo internacional",0,0,0,0,0,0,0,0,0,0
"4295",2014-04-01,"sbjv","transporte não regular","voo doméstico",302,301,603,156,327,483,0,0,0,0
"4296",2014-04-01,"sbjv","transporte não regular","voo internacional",1,2,3,0,3,3,0,0,0,0
"4297",2014-04-01,"sblo","transporte regular","voo doméstico",480,480,960,47589,46605,94194,0,0,0,0
"4298",2014-04-01,"sblo","transporte regular","voo internacional",0,0,0,0,0,0,0,0,0,0
"4299",2014-04-01,"sblo","transporte não regular","voo doméstico",661,662,1323,410,474,884,0,0,0,0
"4300",2014-04-01,"sblo","transporte não regular","voo internacional",5,5,10,0,0,0,0,0,0,0
"4301",2014-04-01,"sbma","transporte regular","voo doméstico",333,332,665,19449,19297,38746,4,0,4,0
"4302",2014-04-01,"sbma","transporte regular","voo internacional",0,0,0,0,0,0,0,0,0,0
"4303",2014-04-01,"sbma","transporte não regular","voo doméstico",285,287,572,1334,1232,2566,0,0,0,0
"4304",2014-04-01,"sbma","transporte não regular","voo internacional",4,4,8,0,0,0,0,0,0,0
"4305",2014-04-01,"sbmk","transporte regular","voo doméstico",166,165,331,13401,12985,26386,0,0,0,0
"4306",2014-04-01,"sbmk","transporte regular","voo internacional",0,0,0,0,0,0,0,0,0,0
"4307",2014-04-01,"sbmk","transporte não regular","voo doméstico",230,229,459,20,22,42,0,0,0,0
"4308",2014-04-01,"sbmk","transporte não regular","voo internacional",0,0,0,0,0,0,0,0,0,0
"4309",2014-04-01,"sbmq","transporte regular","voo doméstico",325,324,649,30166,28661,58827,11260,34840,46100,0
"4310",2014-04-01,"sbmq","transporte regular","voo internacional",0,0,0,0,0,0,0,0,0,0
"4311",2014-04-01,"sbmq","transporte não regular","voo doméstico",215,217,432,600,452,1052,0,0,0,0
"4312",2014-04-01,"sbmq","transporte não regular","voo internacional",12,7,19,0,0,0,0,0,0,0
"4313",2014-04-01,"sbmt","transporte regular","voo doméstico",0,0,0,0,0,0,0,0,0,0
"4314",2014-04-01,"sbmt","transporte regular","voo internacional",0,0,0,0,0,0,0,0,0,0
"4315",2014-04-01,"sbmt","transporte não regular","voo doméstico",5389,5402,10791,8797,8024,16821,0,0,0,0
"4316",2014-04-01,"sbmt","transporte não regular","voo internacional",0,0,0,0,0,0,0,0,0,0
"4317",2014-04-01,"sbnf","transporte regular","voo doméstico",509,510,1019,52684,52666,105350,0,0,0,0
"4318",2014-04-01,"sbnf","transporte regular","voo internacional",0,0,0,0,0,0,0,0,0,0
"4319",2014-04-01,"sbnf","transporte não regular","voo doméstico",327,329,656,849,1007,1856,0,0,0,0
"4320",2014-04-01,"sbnf","transporte não regular","voo internacional",9,8,17,14,10,24,0,0,0,0
"4321",2014-04-01,"sbpb","transporte regular","voo doméstico",20,20,40,1066,1056,2122,0,0,0,0
"4322",2014-04-01,"sbpb","transporte regular","voo internacional",0,0,0,0,0,0,0,0,0,0
"4323",2014-04-01,"sbpb","transporte não regular","voo doméstico",67,67,134,156,125,281,0,0,0,0
"4324",2014-04-01,"sbpb","transporte não regular","voo internacional",0,0,0,0,0,0,0,0,0,0
"4325",2014-04-01,"sbpj","transporte regular","voo doméstico",340,338,678,24193,23640,47833,0,0,0,0
"4326",2014-04-01,"sbpj","transporte regular","voo internacional",0,0,0,0,0,0,0,0,0,0
"4327",2014-04-01,"sbpj","transporte não regular","voo doméstico",361,354,715,679,395,1074,0,0,0,0
"4328",2014-04-01,"sbpj","transporte não regular","voo internacional",9,9,18,0,0,0,0,0,0,0
"4329",2014-04-01,"sbpk","transporte regular","voo doméstico",43,43,86,2155,2038,4193,0,0,0,0
"4330",2014-04-01,"sbpk","transporte regular","voo internacional",0,0,0,0,0,0,0,0,0,0
"4331",2014-04-01,"sbpk","transporte não regular","voo doméstico",73,76,149,178,198,376,0,0,0,0
"4332",2014-04-01,"sbpk","transporte não regular","voo internacional",4,2,6,5,5,10,0,0,0,0
"4333",2014-04-01,"sbpl","transporte regular","voo doméstico",195,171,366,16526,19383,35909,0,0,0,0
"4334",2014-04-01,"sbpl","transporte regular","voo internacional",5,5,10,0,0,0,0,0,0,0
"4335",2014-04-01,"sbpl","transporte não regular","voo doméstico",76,99,175,2476,63,2539,0,0,0,0
"4336",2014-04-01,"sbpl","transporte não regular","voo internacional",0,0,0,0,0,0,0,0,0,0
"4337",2014-04-01,"sbpp","transporte regular","voo doméstico",0,0,0,0,0,0,0,0,0,0
"4338",2014-04-01,"sbpp","transporte regular","voo internacional",0,0,0,0,0,0,0,0,0,0
"4339",2014-04-01,"sbpp","transporte não regular","voo doméstico",91,90,181,203,172,375,0,0,0,0
"4340",2014-04-01,"sbpp","transporte não regular","voo internacional",8,9,17,6,7,13,0,0,0,0
"4341",2014-04-01,"sbpr","transporte regular","voo doméstico",0,0,0,0,0,0,0,0,0,0
"4342",2014-04-01,"sbpr","transporte regular","voo internacional",0,0,0,0,0,0,0,0,0,0
"4343",2014-04-01,"sbpr","transporte não regular","voo doméstico",1642,1641,3283,1812,1717,3529,0,0,0,0
"4344",2014-04-01,"sbpr","transporte não regular","voo internacional",0,0,0,0,0,0,0,0,0,0
"4345",2014-04-01,"sbpv","transporte regular","voo doméstico",461,463,924,35957,33954,69911,53329,179129,232458,0
"4346",2014-04-01,"sbpv","transporte regular","voo internacional",0,0,0,0,0,0,0,0,0,0
"4347",2014-04-01,"sbpv","transporte não regular","voo doméstico",479,475,954,161,55,216,0,8600,8600,0
"4348",2014-04-01,"sbpv","transporte não regular","voo internacional",1,1,2,0,0,0,0,0,0,0
"4349",2014-04-01,"sbrb","transporte regular","voo doméstico",153,155,308,16419,15451,31870,0,0,0,0
"4350",2014-04-01,"sbrb","transporte regular","voo internacional",0,0,0,0,0,0,0,0,0,0
"4351",2014-04-01,"sbrb","transporte não regular","voo doméstico",401,400,801,684,386,1070,0,0,0,0
"4352",2014-04-01,"sbrb","transporte não regular","voo internacional",0,0,0,0,0,0,0,0,0,0
"4353",2014-04-01,"sbrj","transporte regular","voo doméstico",3995,4010,8005,385678,380668,766346,0,0,0,0
"4354",2014-04-01,"sbrj","transporte regular","voo internacional",0,0,0,0,0,0,0,0,0,0
"4355",2014-04-01,"sbrj","transporte não regular","voo doméstico",980,957,1937,2529,2457,4986,0,0,0,0
"4356",2014-04-01,"sbrj","transporte não regular","voo internacional",2,2,4,0,0,0,0,0,0,0
"4357",2014-04-01,"sbsj","transporte regular","voo doméstico",50,50,100,2834,2598,5432,0,0,0,0
"4358",2014-04-01,"sbsj","transporte regular","voo internacional",0,0,0,0,0,0,0,0,0,0
"4359",2014-04-01,"sbsj","transporte não regular","voo doméstico",668,656,1324,1247,1054,2301,0,0,0,0
"4360",2014-04-01,"sbsj","transporte não regular","voo internacional",1,16,17,22,0,22,0,0,0,0
"4361",2014-04-01,"sbsl","transporte regular","voo doméstico",682,709,1391,69217,67963,137180,0,0,0,0
"4362",2014-04-01,"sbsl","transporte regular","voo internacional",0,0,0,0,0,0,0,0,0,0
"4363",2014-04-01,"sbsl","transporte não regular","voo doméstico",446,426,872,5653,8713,14366,84597,198038,282635,0
"4364",2014-04-01,"sbsl","transporte não regular","voo internacional",0,0,0,0,0,0,0,0,0,0
"4365",2014-04-01,"sbsn","transporte regular","voo doméstico",409,409,818,22049,19950,41999,0,0,0,0
"4366",2014-04-01,"sbsn","transporte regular","voo internacional",0,0,0,0,0,0,0,0,0,0
"4367",2014-04-01,"sbsn","transporte não regular","voo doméstico",293,292,585,909,368,1277,0,0,0,0
"4368",2014-04-01,"sbsn","transporte não regular","voo internacional",0,0,0,0,0,0,0,0,0,0
"4369",2014-04-01,"sbsp","transporte regular","voo doméstico",6401,6462,12863,745778,730631,1476409,0,0,0,0
"4370",2014-04-01,"sbsp","transporte regular","voo internacional",0,0,0,0,0,0,0,0,0,0
"4371",2014-04-01,"sbsp","transporte não regular","voo doméstico",2224,2184,4408,8943,7497,16440,0,0,0,0
"4372",2014-04-01,"sbsp","transporte não regular","voo internacional",0,0,0,0,0,0,0,0,0,0
"4373",2014-04-01,"sbte","transporte regular","voo doméstico",450,449,899,44853,46453,91306,25465,89742,115207,257783
"4374",2014-04-01,"sbte","transporte regular","voo internacional",0,0,0,0,0,0,0,0,0,0
"4375",2014-04-01,"sbte","transporte não regular","voo doméstico",242,246,488,1213,1203,2416,0,0,0,0
"4376",2014-04-01,"sbte","transporte não regular","voo internacional",0,1,1,0,0,0,0,0,0,0
"4377",2014-04-01,"sbtf","transporte regular","voo doméstico",83,83,166,3300,3427,6727,0,0,0,0
"4378",2014-04-01,"sbtf","transporte regular","voo internacional",0,0,0,0,0,0,0,0,0,0
"4379",2014-04-01,"sbtf","transporte não regular","voo doméstico",233,231,464,531,488,1019,1920,4602,6522,21474
"4380",2014-04-01,"sbtf","transporte não regular","voo internacional",0,0,0,0,0,0,0,0,0,0
"4381",2014-04-01,"sbtt","transporte regular","voo doméstico",29,30,59,2194,2554,4748,0,0,0,0
"4382",2014-04-01,"sbtt","transporte regular","voo internacional",0,0,0,0,0,0,0,0,0,0
"4383",2014-04-01,"sbtt","transporte não regular","voo doméstico",116,118,234,543,506,1049,1634,3175,4809,743
"4384",2014-04-01,"sbtt","transporte não regular","voo internacional",9,9,18,12,24,36,0,0,0,0
"4385",2014-04-01,"sbuf","transporte regular","voo doméstico",14,14,28,781,814,1595,0,0,0,0
"4386",2014-04-01,"sbuf","transporte regular","voo internacional",0,0,0,0,0,0,0,0,0,0
"4387",2014-04-01,"sbuf","transporte não regular","voo doméstico",52,51,103,140,137,277,0,0,0,0
"4388",2014-04-01,"sbuf","transporte não regular","voo internacional",0,0,0,0,0,0,0,0,0,0
"4389",2014-04-01,"sbug","transporte regular","voo doméstico",0,0,0,0,0,0,0,0,0,0
"4390",2014-04-01,"sbug","transporte regular","voo internacional",0,0,0,0,0,0,0,0,0,0
"4391",2014-04-01,"sbug","transporte não regular","voo doméstico",18,16,34,43,18,61,0,0,0,0
"4392",2014-04-01,"sbug","transporte não regular","voo internacional",5,7,12,0,0,0,0,0,0,0
"4393",2014-04-01,"sbul","transporte regular","voo doméstico",536,536,1072,45689,46503,92192,0,0,0,0
"4394",2014-04-01,"sbul","transporte regular","voo internacional",0,0,0,0,0,0,0,0,0,0
"4395",2014-04-01,"sbul","transporte não regular","voo doméstico",649,649,1298,1460,1520,2980,0,0,0,0
"4396",2014-04-01,"sbul","transporte não regular","voo internacional",3,3,6,18,16,34,0,0,0,0
"4397",2014-04-01,"sbur","transporte regular","voo doméstico",99,100,199,4756,4849,9605,0,0,0,0
"4398",2014-04-01,"sbur","transporte regular","voo internacional",0,0,0,0,0,0,0,0,0,0
"4399",2014-04-01,"sbur","transporte não regular","voo doméstico",279,267,546,1540,1526,3066,0,0,0,0
"4400",2014-04-01,"sbur","transporte não regular","voo internacional",0,0,0,0,0,0,0,0,0,0
"4401",2014-08-01,"sbbe","transporte regular","voo doméstico",1679,1683,3362,166899,172349,339248,47546,200254,247800,0
"4402",2014-08-01,"sbbe","transporte regular","voo internacional",46,45,91,5435,4705,10140,0,38,38,0
"4403",2014-08-01,"sbbe","transporte não regular","voo doméstico",680,675,1355,3679,3826,7505,40787,156948,197735,0
"4404",2014-08-01,"sbbe","transporte não regular","voo internacional",15,12,27,20,28,48,0,0,0,0
"4405",2014-08-01,"sbbg","transporte regular","voo doméstico",0,0,0,0,0,0,0,0,0,0
"4406",2014-08-01,"sbbg","transporte regular","voo internacional",0,0,0,0,0,0,0,0,0,0
"4407",2014-08-01,"sbbg","transporte não regular","voo doméstico",16,16,32,69,65,134,0,0,0,0
"4408",2014-08-01,"sbbg","transporte não regular","voo internacional",1,1,2,3,3,6,0,0,0,0
"4409",2014-08-01,"sbbh","transporte regular","voo doméstico",615,616,1231,29073,32764,61837,0,0,0,0
"4410",2014-08-01,"sbbh","transporte regular","voo internacional",0,0,0,0,0,0,0,0,0,0
"4411",2014-08-01,"sbbh","transporte não regular","voo doméstico",2359,2335,4694,10534,10314,20848,0,0,0,0
"4412",2014-08-01,"sbbh","transporte não regular","voo internacional",13,12,25,66,71,137,0,0,0,0
"4413",2014-08-01,"sbbi","transporte regular","voo doméstico",0,0,0,0,0,0,0,0,0,0
"4414",2014-08-01,"sbbi","transporte regular","voo internacional",0,0,0,0,0,0,0,0,0,0
"4415",2014-08-01,"sbbi","transporte não regular","voo doméstico",1541,1537,3078,8133,8600,16733,0,0,0,0
"4416",2014-08-01,"sbbi","transporte não regular","voo internacional",2,1,3,0,0,0,0,0,0,0
"4417",2014-08-01,"sbbv","transporte regular","voo doméstico",135,135,270,14994,15961,30955,0,0,0,0
"4418",2014-08-01,"sbbv","transporte regular","voo internacional",0,0,0,0,0,0,0,0,0,0
"4419",2014-08-01,"sbbv","transporte não regular","voo doméstico",116,124,240,265,32,297,0,0,0,0
"4420",2014-08-01,"sbbv","transporte não regular","voo internacional",38,29,67,5,3,8,0,0,0,0
"4421",2014-08-01,"sbcg","transporte regular","voo doméstico",654,645,1299,69076,67257,136333,85419,130309,215728,0
"4422",2014-08-01,"sbcg","transporte regular","voo internacional",13,13,26,284,217,501,0,0,0,0
"4423",2014-08-01,"sbcg","transporte não regular","voo doméstico",447,450,897,2411,1493,3904,0,0,0,0
"4424",2014-08-01,"sbcg","transporte não regular","voo internacional",13,14,27,0,0,0,0,0,0,0
"4425",2014-08-01,"sbcj","transporte regular","voo doméstico",85,85,170,5010,5109,10119,0,0,0,0
"4426",2014-08-01,"sbcj","transporte regular","voo internacional",0,0,0,0,0,0,0,0,0,0
"4427",2014-08-01,"sbcj","transporte não regular","voo doméstico",125,126,251,1150,1198,2348,0,0,0,0
"4428",2014-08-01,"sbcj","transporte não regular","voo internacional",1,1,2,0,0,0,0,0,0,0
"4429",2014-08-01,"sbcr","transporte regular","voo doméstico",26,26,52,1333,1409,2742,0,0,0,0
"4430",2014-08-01,"sbcr","transporte regular","voo internacional",0,0,0,0,0,0,0,0,0,0
"4431",2014-08-01,"sbcr","transporte não regular","voo doméstico",55,55,110,146,136,282,0,0,0,0
"4432",2014-08-01,"sbcr","transporte não regular","voo internacional",4,4,8,4,4,8,0,0,0,0
"4433",2014-08-01,"sbct","transporte regular","voo doméstico",2980,2980,5960,307897,304828,612725,133594,0,133594,141338
"4434",2014-08-01,"sbct","transporte regular","voo internacional",111,111,222,6481,6029,12510,0,0,0,0
"4435",2014-08-01,"sbct","transporte não regular","voo doméstico",253,254,507,1181,879,2060,0,0,0,0
"4436",2014-08-01,"sbct","transporte não regular","voo internacional",18,19,37,41,32,73,0,4200,4200,0
"4437",2014-08-01,"sbcz","transporte regular","voo doméstico",31,31,62,2981,2936,5917,0,0,0,0
"4438",2014-08-01,"sbcz","transporte regular","voo internacional",0,0,0,0,0,0,0,0,0,0
"4439",2014-08-01,"sbcz","transporte não regular","voo doméstico",337,338,675,1334,1315,2649,0,0,0,0
"4440",2014-08-01,"sbcz","transporte não regular","voo internacional",2,2,4,0,0,0,0,0,0,0
"4441",2014-08-01,"sbeg","transporte regular","voo doméstico",1279,1279,2558,129344,123291,252635,0,0,0,0
"4442",2014-08-01,"sbeg","transporte regular","voo internacional",132,135,267,10864,10543,21407,0,0,0,0
"4443",2014-08-01,"sbeg","transporte não regular","voo doméstico",934,925,1859,6871,7152,14023,0,0,0,0
"4444",2014-08-01,"sbeg","transporte não regular","voo internacional",118,111,229,499,447,946,0,0,0,0
"4445",2014-08-01,"sbfi","transporte regular","voo doméstico",596,597,1193,73196,72334,145530,0,0,0,0
"4446",2014-08-01,"sbfi","transporte regular","voo internacional",31,31,62,3833,3954,7787,0,0,0,0
"4447",2014-08-01,"sbfi","transporte não regular","voo doméstico",142,143,285,1129,1125,2254,0,0,0,0
"4448",2014-08-01,"sbfi","transporte não regular","voo internacional",71,68,139,83,119,202,0,0,0,0
"4449",2014-08-01,"sbgo","transporte regular","voo doméstico",1509,1507,3016,138946,136145,275091,120204,148847,269051,141064
"4450",2014-08-01,"sbgo","transporte regular","voo internacional",0,0,0,0,0,0,0,0,0,0
"4451",2014-08-01,"sbgo","transporte não regular","voo doméstico",1658,1657,3315,5239,5864,11103,0,0,0,0
"4452",2014-08-01,"sbgo","transporte não regular","voo internacional",3,3,6,0,0,0,0,0,0,0
"4453",2014-08-01,"sbht","transporte regular","voo doméstico",212,210,422,9517,9417,18934,0,0,0,0
"4454",2014-08-01,"sbht","transporte regular","voo internacional",0,0,0,0,0,0,0,0,0,0
"4455",2014-08-01,"sbht","transporte não regular","voo doméstico",277,278,555,1386,1243,2629,7873,18439,26312,2365
"4456",2014-08-01,"sbht","transporte não regular","voo internacional",0,0,0,0,0,0,0,0,0,0
"4457",2014-08-01,"sbiz","transporte regular","voo doméstico",223,223,446,15187,14194,29381,0,0,0,0
"4458",2014-08-01,"sbiz","transporte regular","voo internacional",0,0,0,0,0,0,0,0,0,0
"4459",2014-08-01,"sbiz","transporte não regular","voo doméstico",269,271,540,909,821,1730,0,0,0,0
"4460",2014-08-01,"sbiz","transporte não regular","voo internacional",0,0,0,0,0,0,0,0,0,0
"4461",2014-08-01,"sbjc","transporte regular","voo doméstico",0,1,1,3,0,3,0,0,0,0
"4462",2014-08-01,"sbjc","transporte regular","voo internacional",0,0,0,0,0,0,0,0,0,0
"4463",2014-08-01,"sbjc","transporte não regular","voo doméstico",566,564,1130,1230,1061,2291,0,0,0,0
"4464",2014-08-01,"sbjc","transporte não regular","voo internacional",0,0,0,0,0,0,0,0,0,0
"4465",2014-08-01,"sbjr","transporte regular","voo doméstico",0,0,0,0,0,0,0,0,0,0
"4466",2014-08-01,"sbjr","transporte regular","voo internacional",0,0,0,0,0,0,0,0,0,0
"4467",2014-08-01,"sbjr","transporte não regular","voo doméstico",2878,2868,5746,8920,3913,12833,0,0,0,0
"4468",2014-08-01,"sbjr","transporte não regular","voo internacional",0,0,0,0,0,0,0,0,0,0
"4469",2014-08-01,"sbjv","transporte regular","voo doméstico",235,235,470,21517,20719,42236,0,0,0,0
"4470",2014-08-01,"sbjv","transporte regular","voo internacional",0,0,0,0,0,0,0,0,0,0
"4471",2014-08-01,"sbjv","transporte não regular","voo doméstico",344,344,688,126,193,319,0,0,0,0
"4472",2014-08-01,"sbjv","transporte não regular","voo internacional",1,1,2,0,0,0,0,0,0,0
"4473",2014-08-01,"sblo","transporte regular","voo doméstico",401,402,803,44468,42666,87134,0,0,0,0
"4474",2014-08-01,"sblo","transporte regular","voo internacional",0,0,0,0,0,0,0,0,0,0
"4475",2014-08-01,"sblo","transporte não regular","voo doméstico",789,789,1578,4290,4421,8711,0,0,0,0
"4476",2014-08-01,"sblo","transporte não regular","voo internacional",3,4,7,0,0,0,0,0,0,0
"4477",2014-08-01,"sbma","transporte regular","voo doméstico",350,348,698,19238,18156,37394,0,0,0,0
"4478",2014-08-01,"sbma","transporte regular","voo internacional",0,0,0,0,0,0,0,0,0,0
"4479",2014-08-01,"sbma","transporte não regular","voo doméstico",416,416,832,1351,1369,2720,300,0,300,0
"4480",2014-08-01,"sbma","transporte não regular","voo internacional",2,2,4,0,0,0,0,0,0,0
"4481",2014-08-01,"sbmk","transporte regular","voo doméstico",190,190,380,13600,12624,26224,0,0,0,0
"4482",2014-08-01,"sbmk","transporte regular","voo internacional",0,0,0,0,0,0,0,0,0,0
"4483",2014-08-01,"sbmk","transporte não regular","voo doméstico",310,310,620,83,100,183,0,0,0,0
"4484",2014-08-01,"sbmk","transporte não regular","voo internacional",1,1,2,0,0,0,0,0,0,0
"4485",2014-08-01,"sbmq","transporte regular","voo doméstico",346,342,688,30416,34347,64763,23110,35150,58260,0
"4486",2014-08-01,"sbmq","transporte regular","voo internacional",0,0,0,0,0,0,0,0,0,0
"4487",2014-08-01,"sbmq","transporte não regular","voo doméstico",237,238,475,330,142,472,0,0,0,0
"4488",2014-08-01,"sbmq","transporte não regular","voo internacional",8,5,13,0,0,0,0,0,0,0
"4489",2014-08-01,"sbmt","transporte regular","voo doméstico",0,0,0,0,0,0,0,0,0,0
"4490",2014-08-01,"sbmt","transporte regular","voo internacional",0,0,0,0,0,0,0,0,0,0
"4491",2014-08-01,"sbmt","transporte não regular","voo doméstico",4852,4853,9705,7699,6921,14620,0,0,0,0
"4492",2014-08-01,"sbmt","transporte não regular","voo internacional",0,0,0,0,0,0,0,0,0,0
"4493",2014-08-01,"sbnf","transporte regular","voo doméstico",578,578,1156,57395,56897,114292,0,0,0,0
"4494",2014-08-01,"sbnf","transporte regular","voo internacional",0,0,0,0,0,0,0,0,0,0
"4495",2014-08-01,"sbnf","transporte não regular","voo doméstico",309,312,621,578,795,1373,0,0,0,0
"4496",2014-08-01,"sbnf","transporte não regular","voo internacional",4,2,6,0,7,7,0,0,0,0
"4497",2014-08-01,"sbpb","transporte regular","voo doméstico",24,24,48,804,810,1614,0,0,0,0
"4498",2014-08-01,"sbpb","transporte regular","voo internacional",0,0,0,0,0,0,0,0,0,0
"4499",2014-08-01,"sbpb","transporte não regular","voo doméstico",86,87,173,204,213,417,0,0,0,0
"4500",2014-08-01,"sbpb","transporte não regular","voo internacional",0,0,0,0,0,0,0,0,0,0
"4501",2014-08-01,"sbpj","transporte regular","voo doméstico",353,353,706,28540,27363,55903,0,0,0,0
"4502",2014-08-01,"sbpj","transporte regular","voo internacional",0,0,0,0,0,0,0,0,0,0
"4503",2014-08-01,"sbpj","transporte não regular","voo doméstico",482,489,971,1004,542,1546,0,0,0,0
"4504",2014-08-01,"sbpj","transporte não regular","voo internacional",3,3,6,0,0,0,0,0,0,0
"4505",2014-08-01,"sbpk","transporte regular","voo doméstico",44,44,88,2160,2236,4396,0,0,0,0
"4506",2014-08-01,"sbpk","transporte regular","voo internacional",0,0,0,0,0,0,0,0,0,0
"4507",2014-08-01,"sbpk","transporte não regular","voo doméstico",75,75,150,237,238,475,0,0,0,0
"4508",2014-08-01,"sbpk","transporte não regular","voo internacional",0,0,0,0,0,0,0,0,0,0
"4509",2014-08-01,"sbpl","transporte regular","voo doméstico",211,212,423,20649,19573,40222,0,0,0,0
"4510",2014-08-01,"sbpl","transporte regular","voo internacional",4,4,8,0,0,0,0,0,0,0
"4511",2014-08-01,"sbpl","transporte não regular","voo doméstico",128,131,259,127,130,257,0,0,0,0
"4512",2014-08-01,"sbpl","transporte não regular","voo internacional",2,2,4,0,0,0,0,0,0,0
"4513",2014-08-01,"sbpp","transporte regular","voo doméstico",0,0,0,0,0,0,0,0,0,0
"4514",2014-08-01,"sbpp","transporte regular","voo internacional",0,0,0,0,0,0,0,0,0,0
"4515",2014-08-01,"sbpp","transporte não regular","voo doméstico",128,128,256,270,243,513,0,0,0,0
"4516",2014-08-01,"sbpp","transporte não regular","voo internacional",10,13,23,12,9,21,0,0,0,0
"4517",2014-08-01,"sbpr","transporte regular","voo doméstico",0,0,0,0,0,0,0,0,0,0
"4518",2014-08-01,"sbpr","transporte regular","voo internacional",0,0,0,0,0,0,0,0,0,0
"4519",2014-08-01,"sbpr","transporte não regular","voo doméstico",1798,1790,3588,2157,2044,4201,0,0,0,0
"4520",2014-08-01,"sbpr","transporte não regular","voo internacional",1,0,1,0,0,0,0,0,0,0
"4521",2014-08-01,"sbpv","transporte regular","voo doméstico",438,436,874,39202,37867,77069,56511,219086,275597,0
"4522",2014-08-01,"sbpv","transporte regular","voo internacional",0,0,0,0,0,0,0,0,0,0
"4523",2014-08-01,"sbpv","transporte não regular","voo doméstico",362,362,724,0,0,0,0,0,0,0
"4524",2014-08-01,"sbpv","transporte não regular","voo internacional",0,0,0,0,0,0,0,0,0,0
"4525",2014-08-01,"sbrb","transporte regular","voo doméstico",164,164,328,18734,18208,36942,0,390,390,0
"4526",2014-08-01,"sbrb","transporte regular","voo internacional",0,0,0,0,0,0,0,0,0,0
"4527",2014-08-01,"sbrb","transporte não regular","voo doméstico",270,277,547,676,465,1141,0,0,0,0
"4528",2014-08-01,"sbrb","transporte não regular","voo internacional",0,0,0,0,0,0,0,0,0,0
"4529",2014-08-01,"sbrj","transporte regular","voo doméstico",4570,4580,9150,441044,434521,875565,0,0,0,0
"4530",2014-08-01,"sbrj","transporte regular","voo internacional",0,0,0,0,0,0,0,0,0,0
"4531",2014-08-01,"sbrj","transporte não regular","voo doméstico",1053,1044,2097,662,475,1137,0,0,0,0
"4532",2014-08-01,"sbrj","transporte não regular","voo internacional",17,17,34,0,0,0,0,0,0,0
"4533",2014-08-01,"sbsj","transporte regular","voo doméstico",71,71,142,2845,2749,5594,0,0,0,0
"4534",2014-08-01,"sbsj","transporte regular","voo internacional",0,0,0,0,0,0,0,0,0,0
"4535",2014-08-01,"sbsj","transporte não regular","voo doméstico",615,599,1214,1833,1320,3153,0,0,0,0
"4536",2014-08-01,"sbsj","transporte não regular","voo internacional",3,8,11,16,2,18,0,0,0,0
"4537",2014-08-01,"sbsl","transporte regular","voo doméstico",699,697,1396,77245,76135,153380,6,0,6,0
"4538",2014-08-01,"sbsl","transporte regular","voo internacional",0,0,0,0,0,0,0,0,0,0
"4539",2014-08-01,"sbsl","transporte não regular","voo doméstico",394,399,793,944,615,1559,69105,173412,242517,0
"4540",2014-08-01,"sbsl","transporte não regular","voo internacional",1,1,2,4,4,8,0,0,0,0
"4541",2014-08-01,"sbsn","transporte regular","voo doméstico",464,461,925,26308,24338,50646,0,0,0,0
"4542",2014-08-01,"sbsn","transporte regular","voo internacional",0,0,0,0,0,0,0,0,0,0
"4543",2014-08-01,"sbsn","transporte não regular","voo doméstico",396,398,794,880,970,1850,0,0,0,0
"4544",2014-08-01,"sbsn","transporte não regular","voo internacional",2,2,4,0,0,0,0,0,0,0
"4545",2014-08-01,"sbsp","transporte regular","voo doméstico",6713,6743,13456,785702,779812,1565514,0,0,0,0
"4546",2014-08-01,"sbsp","transporte regular","voo internacional",0,0,0,0,0,0,0,0,0,0
"4547",2014-08-01,"sbsp","transporte não regular","voo doméstico",2263,2228,4491,12494,10697,23191,0,0,0,0
"4548",2014-08-01,"sbsp","transporte não regular","voo internacional",0,0,0,0,0,0,0,0,0,0
"4549",2014-08-01,"sbte","transporte regular","voo doméstico",458,459,917,50506,49108,99614,29770,83242,113012,267674
"4550",2014-08-01,"sbte","transporte regular","voo internacional",0,0,0,0,0,0,0,0,0,0
"4551",2014-08-01,"sbte","transporte não regular","voo doméstico",334,331,665,1726,1743,3469,0,615,615,3825
"4552",2014-08-01,"sbte","transporte não regular","voo internacional",3,3,6,0,0,0,0,0,0,0
"4553",2014-08-01,"sbtf","transporte regular","voo doméstico",47,49,96,2042,2042,4084,0,0,0,0
"4554",2014-08-01,"sbtf","transporte regular","voo internacional",0,0,0,0,0,0,0,0,0,0
"4555",2014-08-01,"sbtf","transporte não regular","voo doméstico",352,349,701,761,609,1370,2629,4375,7004,26094
"4556",2014-08-01,"sbtf","transporte não regular","voo internacional",0,0,0,0,0,0,0,0,0,0
"4557",2014-08-01,"sbtt","transporte regular","voo doméstico",31,31,62,2560,2919,5479,0,0,0,0
"4558",2014-08-01,"sbtt","transporte regular","voo internacional",0,0,0,0,0,0,0,0,0,0
"4559",2014-08-01,"sbtt","transporte não regular","voo doméstico",170,168,338,663,656,1319,1432,2922,4354,498
"4560",2014-08-01,"sbtt","transporte não regular","voo internacional",10,11,21,14,23,37,0,0,0,0
"4561",2014-08-01,"sbuf","transporte regular","voo doméstico",21,21,42,1234,1140,2374,0,0,0,0
"4562",2014-08-01,"sbuf","transporte regular","voo internacional",0,0,0,0,0,0,0,0,0,0
"4563",2014-08-01,"sbuf","transporte não regular","voo doméstico",65,64,129,133,145,278,0,0,0,0
"4564",2014-08-01,"sbuf","transporte não regular","voo internacional",0,0,0,0,0,0,0,0,0,0
"4565",2014-08-01,"sbug","transporte regular","voo doméstico",0,0,0,0,0,0,0,0,0,0
"4566",2014-08-01,"sbug","transporte regular","voo internacional",0,0,0,0,0,0,0,0,0,0
"4567",2014-08-01,"sbug","transporte não regular","voo doméstico",16,16,32,31,24,55,0,0,0,0
"4568",2014-08-01,"sbug","transporte não regular","voo internacional",1,1,2,0,0,0,0,0,0,0
"4569",2014-08-01,"sbul","transporte regular","voo doméstico",634,633,1267,48981,48129,97110,0,0,0,0
"4570",2014-08-01,"sbul","transporte regular","voo internacional",0,0,0,0,0,0,0,0,0,0
"4571",2014-08-01,"sbul","transporte não regular","voo doméstico",703,690,1393,1554,1519,3073,0,0,0,0
"4572",2014-08-01,"sbul","transporte não regular","voo internacional",3,3,6,27,21,48,0,0,0,0
"4573",2014-08-01,"sbur","transporte regular","voo doméstico",115,114,229,5198,5203,10401,0,0,0,0
"4574",2014-08-01,"sbur","transporte regular","voo internacional",0,0,0,0,0,0,0,0,0,0
"4575",2014-08-01,"sbur","transporte não regular","voo doméstico",322,321,643,2346,2461,4807,0,0,0,0
"4576",2014-08-01,"sbur","transporte não regular","voo internacional",1,1,2,0,0,0,0,0,0,0
"4577",2014-12-01,"sbbe","transporte regular","voo doméstico",1772,1794,3566,166960,176469,343429,49618,240682,290300,0
"4578",2014-12-01,"sbbe","transporte regular","voo internacional",41,40,81,6017,4234,10251,0,9,9,0
"4579",2014-12-01,"sbbe","transporte não regular","voo doméstico",494,470,964,5225,5379,10604,8500,0,8500,0
"4580",2014-12-01,"sbbe","transporte não regular","voo internacional",27,32,59,52,931,983,0,0,0,0
"4581",2014-12-01,"sbbg","transporte regular","voo doméstico",0,0,0,0,0,0,0,0,0,0
"4582",2014-12-01,"sbbg","transporte regular","voo internacional",0,0,0,0,0,0,0,0,0,0
"4583",2014-12-01,"sbbg","transporte não regular","voo doméstico",21,21,42,85,108,193,0,0,0,0
"4584",2014-12-01,"sbbg","transporte não regular","voo internacional",1,3,4,5,0,5,0,0,0,0
"4585",2014-12-01,"sbbh","transporte regular","voo doméstico",477,481,958,33525,20490,54015,0,0,0,0
"4586",2014-12-01,"sbbh","transporte regular","voo internacional",0,0,0,0,0,0,0,0,0,0
"4587",2014-12-01,"sbbh","transporte não regular","voo doméstico",1739,1777,3516,8373,7459,15832,0,0,0,0
"4588",2014-12-01,"sbbh","transporte não regular","voo internacional",1,2,3,11,6,17,0,0,0,0
"4589",2014-12-01,"sbbi","transporte regular","voo doméstico",0,0,0,0,0,0,0,0,0,0
"4590",2014-12-01,"sbbi","transporte regular","voo internacional",0,0,0,0,0,0,0,0,0,0
"4591",2014-12-01,"sbbi","transporte não regular","voo doméstico",1026,1042,2068,5158,5130,10288,0,0,0,0
"4592",2014-12-01,"sbbi","transporte não regular","voo internacional",1,1,2,0,0,0,0,0,0,0
"4593",2014-12-01,"sbbv","transporte regular","voo doméstico",117,117,234,13415,12152,25567,0,0,0,0
"4594",2014-12-01,"sbbv","transporte regular","voo internacional",0,0,0,0,0,0,0,0,0,0
"4595",2014-12-01,"sbbv","transporte não regular","voo doméstico",151,157,308,278,125,403,0,0,0,0
"4596",2014-12-01,"sbbv","transporte não regular","voo internacional",25,20,45,0,0,0,0,0,0,0
"4597",2014-12-01,"sbcg","transporte regular","voo doméstico",675,674,1349,76024,69772,145796,68874,117172,186046,0
"4598",2014-12-01,"sbcg","transporte regular","voo internacional",0,0,0,0,0,0,0,0,0,0
"4599",2014-12-01,"sbcg","transporte não regular","voo doméstico",271,276,547,2070,1552,3622,0,0,0,0
"4600",2014-12-01,"sbcg","transporte não regular","voo internacional",26,27,53,239,279,518,0,0,0,0
"4601",2014-12-01,"sbcj","transporte regular","voo doméstico",123,124,247,9973,7909,17882,0,0,0,0
"4602",2014-12-01,"sbcj","transporte regular","voo internacional",0,0,0,0,0,0,0,0,0,0
"4603",2014-12-01,"sbcj","transporte não regular","voo doméstico",90,89,179,1143,1017,2160,0,0,0,0
"4604",2014-12-01,"sbcj","transporte não regular","voo internacional",0,0,0,0,0,0,0,0,0,0
"4605",2014-12-01,"sbcr","transporte regular","voo doméstico",26,26,52,1448,1417,2865,0,0,0,0
"4606",2014-12-01,"sbcr","transporte regular","voo internacional",0,0,0,0,0,0,0,0,0,0
"4607",2014-12-01,"sbcr","transporte não regular","voo doméstico",30,30,60,80,51,131,0,0,0,0
"4608",2014-12-01,"sbcr","transporte não regular","voo internacional",2,3,5,3,3,6,0,0,0,0
"4609",2014-12-01,"sbct","transporte regular","voo doméstico",2994,2994,5988,326481,312768,639249,173455,0,173455,163393
"4610",2014-12-01,"sbct","transporte regular","voo internacional",102,100,202,6567,5682,12249,0,16127,16127,13518
"4611",2014-12-01,"sbct","transporte não regular","voo doméstico",211,220,431,607,579,1186,0,0,0,0
"4612",2014-12-01,"sbct","transporte não regular","voo internacional",15,19,34,23,8,31,0,0,0,0
"4613",2014-12-01,"sbcz","transporte regular","voo doméstico",30,30,60,1955,2443,4398,0,0,0,0
"4614",2014-12-01,"sbcz","transporte regular","voo internacional",0,0,0,0,0,0,0,0,0,0
"4615",2014-12-01,"sbcz","transporte não regular","voo doméstico",191,193,384,612,557,1169,0,0,0,0
"4616",2014-12-01,"sbcz","transporte não regular","voo internacional",1,1,2,0,0,0,0,0,0,0
"4617",2014-12-01,"sbeg","transporte regular","voo doméstico",1290,1290,2580,143195,115906,259101,0,0,0,0
"4618",2014-12-01,"sbeg","transporte regular","voo internacional",124,121,245,15650,9365,25015,0,0,0,0
"4619",2014-12-01,"sbeg","transporte não regular","voo doméstico",659,661,1320,14184,11400,25584,0,0,0,0
"4620",2014-12-01,"sbeg","transporte não regular","voo internacional",116,118,234,493,489,982,0,0,0,0
"4621",2014-12-01,"sbfi","transporte regular","voo doméstico",640,637,1277,78356,81388,159744,0,0,0,0
"4622",2014-12-01,"sbfi","transporte regular","voo internacional",30,30,60,4149,2519,6668,0,0,0,0
"4623",2014-12-01,"sbfi","transporte não regular","voo doméstico",172,174,346,1696,2131,3827,0,0,0,0
"4624",2014-12-01,"sbfi","transporte não regular","voo internacional",43,46,89,220,402,622,0,0,0,0
"4625",2014-12-01,"sbgo","transporte regular","voo doméstico",1488,1489,2977,150070,141473,291543,116640,147252,263892,170922
"4626",2014-12-01,"sbgo","transporte regular","voo internacional",0,0,0,0,0,0,0,0,0,0
"4627",2014-12-01,"sbgo","transporte não regular","voo doméstico",1012,1044,2056,4531,5010,9541,0,0,0,0
"4628",2014-12-01,"sbgo","transporte não regular","voo internacional",8,7,15,0,0,0,0,0,0,0
"4629",2014-12-01,"sbht","transporte regular","voo doméstico",231,232,463,11758,8841,20599,0,0,0,0
"4630",2014-12-01,"sbht","transporte regular","voo internacional",0,0,0,0,0,0,0,0,0,0
"4631",2014-12-01,"sbht","transporte não regular","voo doméstico",293,295,588,2983,2368,5351,3597,3350,6947,3363
"4632",2014-12-01,"sbht","transporte não regular","voo internacional",0,0,0,0,0,0,0,0,0,0
"4633",2014-12-01,"sbiz","transporte regular","voo doméstico",252,252,504,13795,13427,27222,0,0,0,0
"4634",2014-12-01,"sbiz","transporte regular","voo internacional",0,0,0,0,0,0,0,0,0,0
"4635",2014-12-01,"sbiz","transporte não regular","voo doméstico",163,161,324,432,516,948,0,0,0,0
"4636",2014-12-01,"sbiz","transporte não regular","voo internacional",0,0,0,0,0,0,0,0,0,0
"4637",2014-12-01,"sbjc","transporte regular","voo doméstico",0,0,0,0,0,0,0,0,0,0
"4638",2014-12-01,"sbjc","transporte regular","voo internacional",0,0,0,0,0,0,0,0,0,0
"4639",2014-12-01,"sbjc","transporte não regular","voo doméstico",482,482,964,932,707,1639,0,0,0,0
"4640",2014-12-01,"sbjc","transporte não regular","voo internacional",0,0,0,0,0,0,0,0,0,0
"4641",2014-12-01,"sbjr","transporte regular","voo doméstico",0,0,0,0,0,0,0,0,0,0
"4642",2014-12-01,"sbjr","transporte regular","voo internacional",0,0,0,0,0,0,0,0,0,0
"4643",2014-12-01,"sbjr","transporte não regular","voo doméstico",3125,3122,6247,11637,8310,19947,0,0,0,0
"4644",2014-12-01,"sbjr","transporte não regular","voo internacional",0,0,0,0,0,0,0,0,0,0
"4645",2014-12-01,"sbjv","transporte regular","voo doméstico",233,234,467,20310,20907,41217,0,0,0,0
"4646",2014-12-01,"sbjv","transporte regular","voo internacional",0,0,0,0,0,0,0,0,0,0
"4647",2014-12-01,"sbjv","transporte não regular","voo doméstico",221,220,441,157,146,303,0,0,0,0
"4648",2014-12-01,"sbjv","transporte não regular","voo internacional",0,0,0,0,0,0,0,0,0,0
"4649",2014-12-01,"sblo","transporte regular","voo doméstico",467,466,933,47638,46795,94433,0,0,0,0
"4650",2014-12-01,"sblo","transporte regular","voo internacional",0,0,0,0,0,0,0,0,0,0
"4651",2014-12-01,"sblo","transporte não regular","voo doméstico",544,543,1087,1849,1807,3656,0,0,0,0
"4652",2014-12-01,"sblo","transporte não regular","voo internacional",3,2,5,0,0,0,0,0,0,0
"4653",2014-12-01,"sbma","transporte regular","voo doméstico",324,325,649,17524,17828,35352,0,0,0,0
"4654",2014-12-01,"sbma","transporte regular","voo internacional",0,0,0,0,0,0,0,0,0,0
"4655",2014-12-01,"sbma","transporte não regular","voo doméstico",305,303,608,1081,1187,2268,0,0,0,0
"4656",2014-12-01,"sbma","transporte não regular","voo internacional",6,6,12,0,0,0,0,0,0,0
"4657",2014-12-01,"sbmk","transporte regular","voo doméstico",191,192,383,18095,18133,36228,0,0,0,0
"4658",2014-12-01,"sbmk","transporte regular","voo internacional",0,0,0,0,0,0,0,0,0,0
"4659",2014-12-01,"sbmk","transporte não regular","voo doméstico",230,232,462,25,24,49,0,0,0,0
"4660",2014-12-01,"sbmk","transporte não regular","voo internacional",0,0,0,0,0,0,0,0,0,0
"4661",2014-12-01,"sbmq","transporte regular","voo doméstico",345,346,691,36782,31209,67991,29350,31700,61050,1000
"4662",2014-12-01,"sbmq","transporte regular","voo internacional",0,0,0,0,0,0,0,0,0,0
"4663",2014-12-01,"sbmq","transporte não regular","voo doméstico",184,185,369,386,265,651,0,0,0,0
"4664",2014-12-01,"sbmq","transporte não regular","voo internacional",12,11,23,0,0,0,0,0,0,0
"4665",2014-12-01,"sbmt","transporte regular","voo doméstico",0,0,0,0,0,0,0,0,0,0
"4666",2014-12-01,"sbmt","transporte regular","voo internacional",0,0,0,0,0,0,0,0,0,0
"4667",2014-12-01,"sbmt","transporte não regular","voo doméstico",4006,4020,8026,6862,6676,13538,0,0,0,0
"4668",2014-12-01,"sbmt","transporte não regular","voo internacional",0,0,0,0,0,0,0,0,0,0
"4669",2014-12-01,"sbnf","transporte regular","voo doméstico",600,599,1199,58302,63302,121604,0,0,0,0
"4670",2014-12-01,"sbnf","transporte regular","voo internacional",0,0,0,0,0,0,0,0,0,0
"4671",2014-12-01,"sbnf","transporte não regular","voo doméstico",367,363,730,995,1141,2136,0,0,0,0
"4672",2014-12-01,"sbnf","transporte não regular","voo internacional",9,8,17,21,22,43,0,0,0,0
"4673",2014-12-01,"sbpb","transporte regular","voo doméstico",19,19,38,492,653,1145,0,0,0,0
"4674",2014-12-01,"sbpb","transporte regular","voo internacional",0,0,0,0,0,0,0,0,0,0
"4675",2014-12-01,"sbpb","transporte não regular","voo doméstico",93,82,175,191,430,621,0,0,0,0
"4676",2014-12-01,"sbpb","transporte não regular","voo internacional",0,0,0,0,0,0,0,0,0,0
"4677",2014-12-01,"sbpj","transporte regular","voo doméstico",346,350,696,28315,26998,55313,0,0,0,0
"4678",2014-12-01,"sbpj","transporte regular","voo internacional",0,0,0,0,0,0,0,0,0,0
"4679",2014-12-01,"sbpj","transporte não regular","voo doméstico",281,281,562,1287,1095,2382,0,0,0,0
"4680",2014-12-01,"sbpj","transporte não regular","voo internacional",6,6,12,0,0,0,0,0,0,0
"4681",2014-12-01,"sbpk","transporte regular","voo doméstico",43,43,86,3084,2135,5219,0,0,0,0
"4682",2014-12-01,"sbpk","transporte regular","voo internacional",0,0,0,0,0,0,0,0,0,0
"4683",2014-12-01,"sbpk","transporte não regular","voo doméstico",43,38,81,88,113,201,0,0,0,0
"4684",2014-12-01,"sbpk","transporte não regular","voo internacional",1,4,5,13,0,13,0,0,0,0
"4685",2014-12-01,"sbpl","transporte regular","voo doméstico",183,184,367,23144,23644,46788,0,0,0,0
"4686",2014-12-01,"sbpl","transporte regular","voo internacional",4,4,8,0,0,0,0,0,0,0
"4687",2014-12-01,"sbpl","transporte não regular","voo doméstico",65,67,132,121,280,401,0,0,0,0
"4688",2014-12-01,"sbpl","transporte não regular","voo internacional",0,0,0,0,0,0,0,0,0,0
"4689",2014-12-01,"sbpp","transporte regular","voo doméstico",0,0,0,0,0,0,0,0,0,0
"4690",2014-12-01,"sbpp","transporte regular","voo internacional",0,0,0,0,0,0,0,0,0,0
"4691",2014-12-01,"sbpp","transporte não regular","voo doméstico",75,75,150,158,158,316,0,0,0,0
"4692",2014-12-01,"sbpp","transporte não regular","voo internacional",10,11,21,10,13,23,0,0,0,0
"4693",2014-12-01,"sbpr","transporte regular","voo doméstico",0,0,0,0,0,0,0,0,0,0
"4694",2014-12-01,"sbpr","transporte regular","voo internacional",0,0,0,0,0,0,0,0,0,0
"4695",2014-12-01,"sbpr","transporte não regular","voo doméstico",886,895,1781,1077,983,2060,0,0,0,0
"4696",2014-12-01,"sbpr","transporte não regular","voo internacional",2,0,2,0,0,0,0,0,0,0
"4697",2014-12-01,"sbpv","transporte regular","voo doméstico",436,437,873,46690,39935,86625,55942,223879,279821,0
"4698",2014-12-01,"sbpv","transporte regular","voo internacional",0,0,0,0,0,0,0,0,0,0
"4699",2014-12-01,"sbpv","transporte não regular","voo doméstico",226,223,449,132,66,198,0,0,0,0
"4700",2014-12-01,"sbpv","transporte não regular","voo internacional",0,0,0,0,0,0,0,0,0,0
"4701",2014-12-01,"sbrb","transporte regular","voo doméstico",146,145,291,15270,13164,28434,0,0,0,1
"4702",2014-12-01,"sbrb","transporte regular","voo internacional",0,0,0,0,0,0,0,0,0,0
"4703",2014-12-01,"sbrb","transporte não regular","voo doméstico",169,170,339,588,405,993,0,0,0,0
"4704",2014-12-01,"sbrb","transporte não regular","voo internacional",0,0,0,0,0,0,0,0,0,0
"4705",2014-12-01,"sbrj","transporte regular","voo doméstico",4465,4479,8944,445894,474250,920144,0,0,0,0
"4706",2014-12-01,"sbrj","transporte regular","voo internacional",0,0,0,0,0,0,0,0,0,0
"4707",2014-12-01,"sbrj","transporte não regular","voo doméstico",728,708,1436,1921,1607,3528,0,0,0,0
"4708",2014-12-01,"sbrj","transporte não regular","voo internacional",2,2,4,0,0,0,0,0,0,0
"4709",2014-12-01,"sbsj","transporte regular","voo doméstico",17,18,35,58,91,149,0,0,0,0
"4710",2014-12-01,"sbsj","transporte regular","voo internacional",0,0,0,0,0,0,0,0,0,0
"4711",2014-12-01,"sbsj","transporte não regular","voo doméstico",571,558,1129,2126,1950,4076,0,0,0,0
"4712",2014-12-01,"sbsj","transporte não regular","voo internacional",4,32,36,51,13,64,0,0,0,0
"4713",2014-12-01,"sbsl","transporte regular","voo doméstico",726,699,1425,64919,81674,146593,0,2463,2463,163
"4714",2014-12-01,"sbsl","transporte regular","voo internacional",0,0,0,0,0,0,0,0,0,0
"4715",2014-12-01,"sbsl","transporte não regular","voo doméstico",270,297,567,6358,5479,11837,71778,175403,247181,0
"4716",2014-12-01,"sbsl","transporte não regular","voo internacional",2,0,2,0,0,0,0,0,0,0
"4717",2014-12-01,"sbsn","transporte regular","voo doméstico",428,440,868,27063,24711,51774,0,0,0,0
"4718",2014-12-01,"sbsn","transporte regular","voo internacional",0,0,0,0,0,0,0,0,0,0
"4719",2014-12-01,"sbsn","transporte não regular","voo doméstico",428,417,845,1924,2175,4099,0,0,0,0
"4720",2014-12-01,"sbsn","transporte não regular","voo internacional",0,0,0,0,0,0,0,0,0,0
"4721",2014-12-01,"sbsp","transporte regular","voo doméstico",7168,7211,14379,906524,819325,1725849,0,0,0,0
"4722",2014-12-01,"sbsp","transporte regular","voo internacional",0,0,0,0,0,0,0,0,0,0
"4723",2014-12-01,"sbsp","transporte não regular","voo doméstico",1997,1971,3968,13944,10866,24810,0,0,0,0
"4724",2014-12-01,"sbsp","transporte não regular","voo internacional",0,0,0,0,0,0,0,0,0,0
"4725",2014-12-01,"sbte","transporte regular","voo doméstico",499,506,1005,48846,59180,108026,28507,103095,131602,257392
"4726",2014-12-01,"sbte","transporte regular","voo internacional",0,0,0,0,0,0,0,0,0,0
"4727",2014-12-01,"sbte","transporte não regular","voo doméstico",245,244,489,2372,3444,5816,0,0,0,0
"4728",2014-12-01,"sbte","transporte não regular","voo internacional",0,0,0,0,0,0,0,0,0,0
"4729",2014-12-01,"sbtf","transporte regular","voo doméstico",55,55,110,2198,2177,4375,0,0,0,0
"4730",2014-12-01,"sbtf","transporte regular","voo internacional",0,0,0,0,0,0,0,0,0,0
"4731",2014-12-01,"sbtf","transporte não regular","voo doméstico",234,234,468,398,374,772,3465,5375,8840,23790
"4732",2014-12-01,"sbtf","transporte não regular","voo internacional",0,0,0,0,0,0,0,0,0,0
"4733",2014-12-01,"sbtt","transporte regular","voo doméstico",33,33,66,2905,3520,6425,0,0,0,0
"4734",2014-12-01,"sbtt","transporte regular","voo internacional",0,0,0,0,0,0,0,0,0,0
"4735",2014-12-01,"sbtt","transporte não regular","voo doméstico",171,174,345,689,702,1391,2188,2636,4824,520
"4736",2014-12-01,"sbtt","transporte não regular","voo internacional",6,2,8,1,10,11,0,0,0,0
"4737",2014-12-01,"sbuf","transporte regular","voo doméstico",23,23,46,1091,1346,2437,0,0,0,0
"4738",2014-12-01,"sbuf","transporte regular","voo internacional",0,0,0,0,0,0,0,0,0,0
"4739",2014-12-01,"sbuf","transporte não regular","voo doméstico",72,74,146,134,166,300,0,0,0,0
"4740",2014-12-01,"sbuf","transporte não regular","voo internacional",0,0,0,0,0,0,0,0,0,0
"4741",2014-12-01,"sbug","transporte regular","voo doméstico",0,0,0,0,0,0,0,0,0,0
"4742",2014-12-01,"sbug","transporte regular","voo internacional",0,0,0,0,0,0,0,0,0,0
"4743",2014-12-01,"sbug","transporte não regular","voo doméstico",9,9,18,15,22,37,0,0,0,0
"4744",2014-12-01,"sbug","transporte não regular","voo internacional",0,0,0,0,0,0,0,0,0,0
"4745",2014-12-01,"sbul","transporte regular","voo doméstico",561,570,1131,47415,45878,93293,0,0,0,0
"4746",2014-12-01,"sbul","transporte regular","voo internacional",0,0,0,0,0,0,0,0,0,0
"4747",2014-12-01,"sbul","transporte não regular","voo doméstico",495,490,985,1814,1847,3661,0,0,0,0
"4748",2014-12-01,"sbul","transporte não regular","voo internacional",0,0,0,0,0,0,0,0,0,0
"4749",2014-12-01,"sbur","transporte regular","voo doméstico",135,134,269,4645,5112,9757,0,0,0,0
"4750",2014-12-01,"sbur","transporte regular","voo internacional",0,0,0,0,0,0,0,0,0,0
"4751",2014-12-01,"sbur","transporte não regular","voo doméstico",162,167,329,571,658,1229,0,0,0,0
"4752",2014-12-01,"sbur","transporte não regular","voo internacional",1,1,2,0,0,0,0,0,0,0
"4753",2014-02-01,"sbbe","transporte regular","voo doméstico",1485,1496,2981,137901,127742,265643,3,0,3,0
"4754",2014-02-01,"sbbe","transporte regular","voo internacional",24,24,48,2768,3029,5797,0,6,6,0
"4755",2014-02-01,"sbbe","transporte não regular","voo doméstico",564,539,1103,3263,3902,7165,101863,363325,465188,0
"4756",2014-02-01,"sbbe","transporte não regular","voo internacional",15,17,32,63,28,91,0,0,0,0
"4757",2014-02-01,"sbbg","transporte regular","voo doméstico",0,0,0,0,0,0,0,0,0,0
"4758",2014-02-01,"sbbg","transporte regular","voo internacional",0,0,0,0,0,0,0,0,0,0
"4759",2014-02-01,"sbbg","transporte não regular","voo doméstico",43,43,86,104,81,185,0,0,0,0
"4760",2014-02-01,"sbbg","transporte não regular","voo internacional",2,2,4,2,2,4,0,0,0,0
"4761",2014-02-01,"sbbh","transporte regular","voo doméstico",517,520,1037,26147,28792,54939,0,0,0,0
"4762",2014-02-01,"sbbh","transporte regular","voo internacional",0,0,0,0,0,0,0,0,0,0
"4763",2014-02-01,"sbbh","transporte não regular","voo doméstico",2018,2012,4030,8639,8543,17182,0,0,0,0
"4764",2014-02-01,"sbbh","transporte não regular","voo internacional",4,4,8,29,29,58,0,0,0,0
"4765",2014-02-01,"sbbi","transporte regular","voo doméstico",0,0,0,0,0,0,0,0,0,0
"4766",2014-02-01,"sbbi","transporte regular","voo internacional",0,0,0,0,0,0,0,0,0,0
"4767",2014-02-01,"sbbi","transporte não regular","voo doméstico",1474,1480,2954,3489,3161,6650,0,0,0,0
"4768",2014-02-01,"sbbi","transporte não regular","voo internacional",0,0,0,0,0,0,0,0,0,0
"4769",2014-02-01,"sbbv","transporte regular","voo doméstico",140,140,280,14677,16732,31409,0,0,0,0
"4770",2014-02-01,"sbbv","transporte regular","voo internacional",0,0,0,0,0,0,0,0,0,0
"4771",2014-02-01,"sbbv","transporte não regular","voo doméstico",98,100,198,183,69,252,0,0,0,0
"4772",2014-02-01,"sbbv","transporte não regular","voo internacional",22,20,42,3,4,7,0,0,0,0
"4773",2014-02-01,"sbcg","transporte regular","voo doméstico",628,627,1255,58279,59545,117824,69162,139297,208459,0
"4774",2014-02-01,"sbcg","transporte regular","voo internacional",0,0,0,0,0,0,0,0,0,0
"4775",2014-02-01,"sbcg","transporte não regular","voo doméstico",344,342,686,542,665,1207,0,8266,8266,0
"4776",2014-02-01,"sbcg","transporte não regular","voo internacional",7,5,12,0,0,0,0,0,0,0
"4777",2014-02-01,"sbcj","transporte regular","voo doméstico",96,96,192,4725,4145,8870,0,0,0,0
"4778",2014-02-01,"sbcj","transporte regular","voo internacional",0,0,0,0,0,0,0,0,0,0
"4779",2014-02-01,"sbcj","transporte não regular","voo doméstico",68,69,137,614,552,1166,0,0,0,0
"4780",2014-02-01,"sbcj","transporte não regular","voo internacional",0,0,0,0,0,0,0,0,0,0
"4781",2014-02-01,"sbcr","transporte regular","voo doméstico",24,24,48,1181,1394,2575,0,0,0,0
"4782",2014-02-01,"sbcr","transporte regular","voo internacional",0,0,0,0,0,0,0,0,0,0
"4783",2014-02-01,"sbcr","transporte não regular","voo doméstico",32,30,62,61,55,116,0,0,0,0
"4784",2014-02-01,"sbcr","transporte não regular","voo internacional",1,2,3,4,0,4,0,0,0,0
"4785",2014-02-01,"sbct","transporte regular","voo doméstico",2763,2767,5530,272418,276514,548932,154222,0,154222,175031
"4786",2014-02-01,"sbct","transporte regular","voo internacional",111,110,221,4095,4739,8834,0,2438,2438,0
"4787",2014-02-01,"sbct","transporte não regular","voo doméstico",237,237,474,926,1054,1980,8964,73648,82612,10217
"4788",2014-02-01,"sbct","transporte não regular","voo internacional",13,10,23,19,38,57,0,0,0,0
"4789",2014-02-01,"sbcz","transporte regular","voo doméstico",28,28,56,2371,2262,4633,0,0,0,0
"4790",2014-02-01,"sbcz","transporte regular","voo internacional",0,0,0,0,0,0,0,0,0,0
"4791",2014-02-01,"sbcz","transporte não regular","voo doméstico",141,141,282,529,467,996,0,0,0,0
"4792",2014-02-01,"sbcz","transporte não regular","voo internacional",0,0,0,0,0,0,0,0,0,0
"4793",2014-02-01,"sbeg","transporte regular","voo doméstico",1233,1227,2460,112622,111120,223742,30,0,30,0
"4794",2014-02-01,"sbeg","transporte regular","voo internacional",104,113,217,7852,8440,16292,0,0,0,0
"4795",2014-02-01,"sbeg","transporte não regular","voo doméstico",653,658,1311,9045,8482,17527,0,0,0,0
"4796",2014-02-01,"sbeg","transporte não regular","voo internacional",120,117,237,9,0,9,0,0,0,0
"4797",2014-02-01,"sbfi","transporte regular","voo doméstico",523,525,1048,64518,65719,130237,0,0,0,0
"4798",2014-02-01,"sbfi","transporte regular","voo internacional",16,16,32,1842,2177,4019,0,0,0,0
"4799",2014-02-01,"sbfi","transporte não regular","voo doméstico",78,78,156,988,395,1383,0,0,0,0
"4800",2014-02-01,"sbfi","transporte não regular","voo internacional",35,35,70,543,679,1222,0,0,0,0
"4801",2014-02-01,"sbgo","transporte regular","voo doméstico",1293,1294,2587,122574,120656,243230,108003,190379,298382,275031
"4802",2014-02-01,"sbgo","transporte regular","voo internacional",0,0,0,0,0,0,0,0,0,0
"4803",2014-02-01,"sbgo","transporte não regular","voo doméstico",1192,1205,2397,4005,4501,8506,0,0,0,0
"4804",2014-02-01,"sbgo","transporte não regular","voo internacional",7,4,11,0,0,0,0,0,0,0
"4805",2014-02-01,"sbht","transporte regular","voo doméstico",185,183,368,8474,6635,15109,0,0,0,0
"4806",2014-02-01,"sbht","transporte regular","voo internacional",0,0,0,0,0,0,0,0,0,0
"4807",2014-02-01,"sbht","transporte não regular","voo doméstico",151,151,302,486,490,976,0,0,0,0
"4808",2014-02-01,"sbht","transporte não regular","voo internacional",0,0,0,0,0,0,0,0,0,0
"4809",2014-02-01,"sbiz","transporte regular","voo doméstico",149,148,297,10978,10390,21368,0,0,0,0
"4810",2014-02-01,"sbiz","transporte regular","voo internacional",0,0,0,0,0,0,0,0,0,0
"4811",2014-02-01,"sbiz","transporte não regular","voo doméstico",107,108,215,255,279,534,0,0,0,0
"4812",2014-02-01,"sbiz","transporte não regular","voo internacional",0,0,0,0,0,0,0,0,0,0
"4813",2014-02-01,"sbjc","transporte regular","voo doméstico",0,0,0,0,0,0,0,0,0,0
"4814",2014-02-01,"sbjc","transporte regular","voo internacional",0,0,0,0,0,0,0,0,0,0
"4815",2014-02-01,"sbjc","transporte não regular","voo doméstico",480,478,958,1101,920,2021,0,0,0,0
"4816",2014-02-01,"sbjc","transporte não regular","voo internacional",0,0,0,0,0,0,0,0,0,0
"4817",2014-02-01,"sbjr","transporte regular","voo doméstico",0,0,0,0,0,0,0,0,0,0
"4818",2014-02-01,"sbjr","transporte regular","voo internacional",0,0,0,0,0,0,0,0,0,0
"4819",2014-02-01,"sbjr","transporte não regular","voo doméstico",3523,3513,7036,6604,2420,9024,0,0,0,0
"4820",2014-02-01,"sbjr","transporte não regular","voo internacional",0,0,0,0,0,0,0,0,0,0
"4821",2014-02-01,"sbjv","transporte regular","voo doméstico",226,225,451,17700,18454,36154,0,0,0,0
"4822",2014-02-01,"sbjv","transporte regular","voo internacional",0,0,0,0,0,0,0,0,0,0
"4823",2014-02-01,"sbjv","transporte não regular","voo doméstico",254,252,506,107,263,370,0,0,0,0
"4824",2014-02-01,"sbjv","transporte não regular","voo internacional",1,1,2,4,4,8,0,0,0,0
"4825",2014-02-01,"sblo","transporte regular","voo doméstico",457,457,914,42267,42798,85065,0,0,0,0
"4826",2014-02-01,"sblo","transporte regular","voo internacional",0,0,0,0,0,0,0,0,0,0
"4827",2014-02-01,"sblo","transporte não regular","voo doméstico",630,630,1260,639,512,1151,0,0,0,0
"4828",2014-02-01,"sblo","transporte não regular","voo internacional",3,3,6,0,0,0,0,0,0,0
"4829",2014-02-01,"sbma","transporte regular","voo doméstico",334,331,665,17628,16413,34041,0,94,94,0
"4830",2014-02-01,"sbma","transporte regular","voo internacional",0,0,0,0,0,0,0,0,0,0
"4831",2014-02-01,"sbma","transporte não regular","voo doméstico",252,256,508,1345,1559,2904,0,0,0,0
"4832",2014-02-01,"sbma","transporte não regular","voo internacional",2,1,3,0,0,0,0,0,0,0
"4833",2014-02-01,"sbmk","transporte regular","voo doméstico",155,156,311,14030,13861,27891,0,0,0,0
"4834",2014-02-01,"sbmk","transporte regular","voo internacional",0,0,0,0,0,0,0,0,0,0
"4835",2014-02-01,"sbmk","transporte não regular","voo doméstico",216,211,427,17,97,114,0,0,0,0
"4836",2014-02-01,"sbmk","transporte não regular","voo internacional",0,0,0,0,0,0,0,0,0,0
"4837",2014-02-01,"sbmq","transporte regular","voo doméstico",319,321,640,29318,28399,57717,8270,26450,34720,0
"4838",2014-02-01,"sbmq","transporte regular","voo internacional",0,0,0,0,0,0,0,0,0,0
"4839",2014-02-01,"sbmq","transporte não regular","voo doméstico",176,173,349,418,295,713,0,0,0,0
"4840",2014-02-01,"sbmq","transporte não regular","voo internacional",6,6,12,0,0,0,0,0,0,0
"4841",2014-02-01,"sbmt","transporte regular","voo doméstico",0,0,0,0,0,0,0,0,0,0
"4842",2014-02-01,"sbmt","transporte regular","voo internacional",0,0,0,0,0,0,0,0,0,0
"4843",2014-02-01,"sbmt","transporte não regular","voo doméstico",5729,5732,11461,9267,8947,18214,0,0,0,0
"4844",2014-02-01,"sbmt","transporte não regular","voo internacional",0,0,0,0,0,0,0,0,0,0
"4845",2014-02-01,"sbnf","transporte regular","voo doméstico",508,509,1017,48816,50449,99265,0,0,0,0
"4846",2014-02-01,"sbnf","transporte regular","voo internacional",0,0,0,0,0,0,0,0,0,0
"4847",2014-02-01,"sbnf","transporte não regular","voo doméstico",332,326,658,814,929,1743,0,0,0,0
"4848",2014-02-01,"sbnf","transporte não regular","voo internacional",5,7,12,15,10,25,0,0,0,0
"4849",2014-02-01,"sbpb","transporte regular","voo doméstico",0,0,0,0,0,0,0,0,0,0
"4850",2014-02-01,"sbpb","transporte regular","voo internacional",0,0,0,0,0,0,0,0,0,0
"4851",2014-02-01,"sbpb","transporte não regular","voo doméstico",67,61,128,141,166,307,0,0,0,0
"4852",2014-02-01,"sbpb","transporte não regular","voo internacional",0,0,0,0,0,0,0,0,0,0
"4853",2014-02-01,"sbpj","transporte regular","voo doméstico",337,338,675,21488,20507,41995,0,0,0,0
"4854",2014-02-01,"sbpj","transporte regular","voo internacional",0,0,0,0,0,0,0,0,0,0
"4855",2014-02-01,"sbpj","transporte não regular","voo doméstico",323,322,645,470,302,772,0,0,0,0
"4856",2014-02-01,"sbpj","transporte não regular","voo internacional",4,6,10,0,0,0,0,0,0,0
"4857",2014-02-01,"sbpk","transporte regular","voo doméstico",46,46,92,2288,2134,4422,0,0,0,0
"4858",2014-02-01,"sbpk","transporte regular","voo internacional",0,0,0,0,0,0,0,0,0,0
"4859",2014-02-01,"sbpk","transporte não regular","voo doméstico",47,53,100,119,115,234,0,0,0,0
"4860",2014-02-01,"sbpk","transporte não regular","voo internacional",8,3,11,0,20,20,0,0,0,0
"4861",2014-02-01,"sbpl","transporte regular","voo doméstico",187,169,356,17052,17953,35005,0,0,0,0
"4862",2014-02-01,"sbpl","transporte regular","voo internacional",0,0,0,0,0,0,0,0,0,0
"4863",2014-02-01,"sbpl","transporte não regular","voo doméstico",71,92,163,1651,151,1802,0,0,0,0
"4864",2014-02-01,"sbpl","transporte não regular","voo internacional",0,0,0,0,0,0,0,0,0,0
"4865",2014-02-01,"sbpp","transporte regular","voo doméstico",0,0,0,0,0,0,0,0,0,0
"4866",2014-02-01,"sbpp","transporte regular","voo internacional",0,0,0,0,0,0,0,0,0,0
"4867",2014-02-01,"sbpp","transporte não regular","voo doméstico",77,73,150,158,154,312,0,0,0,0
"4868",2014-02-01,"sbpp","transporte não regular","voo internacional",6,6,12,9,10,19,0,0,0,0
"4869",2014-02-01,"sbpr","transporte regular","voo doméstico",0,0,0,0,0,0,0,0,0,0
"4870",2014-02-01,"sbpr","transporte regular","voo internacional",0,0,0,0,0,0,0,0,0,0
"4871",2014-02-01,"sbpr","transporte não regular","voo doméstico",1705,1710,3415,1806,1820,3626,0,0,0,0
"4872",2014-02-01,"sbpr","transporte não regular","voo internacional",4,2,6,0,0,0,0,0,0,0
"4873",2014-02-01,"sbpv","transporte regular","voo doméstico",404,405,809,34775,37628,72403,45387,178806,224193,0
"4874",2014-02-01,"sbpv","transporte regular","voo internacional",0,0,0,0,0,0,0,0,0,0
"4875",2014-02-01,"sbpv","transporte não regular","voo doméstico",329,327,656,82,129,211,0,0,0,0
"4876",2014-02-01,"sbpv","transporte não regular","voo internacional",3,3,6,0,0,0,0,0,0,0
"4877",2014-02-01,"sbrb","transporte regular","voo doméstico",147,149,296,15781,16495,32276,0,0,0,0
"4878",2014-02-01,"sbrb","transporte regular","voo internacional",0,0,0,0,0,0,0,0,0,0
"4879",2014-02-01,"sbrb","transporte não regular","voo doméstico",242,238,480,618,413,1031,0,0,0,0
"4880",2014-02-01,"sbrb","transporte não regular","voo internacional",0,0,0,0,0,0,0,0,0,0
"4881",2014-02-01,"sbrj","transporte regular","voo doméstico",3971,3976,7947,359274,366892,726166,0,0,0,0
"4882",2014-02-01,"sbrj","transporte regular","voo internacional",0,0,0,0,0,0,0,0,0,0
"4883",2014-02-01,"sbrj","transporte não regular","voo doméstico",1160,1155,2315,848,1149,1997,0,0,0,0
"4884",2014-02-01,"sbrj","transporte não regular","voo internacional",2,2,4,0,0,0,0,0,0,0
"4885",2014-02-01,"sbsj","transporte regular","voo doméstico",49,49,98,2295,2179,4474,0,0,0,0
"4886",2014-02-01,"sbsj","transporte regular","voo internacional",0,0,0,0,0,0,0,0,0,0
"4887",2014-02-01,"sbsj","transporte não regular","voo doméstico",572,556,1128,1381,1264,2645,0,0,0,0
"4888",2014-02-01,"sbsj","transporte não regular","voo internacional",7,14,21,33,18,51,0,0,0,0
"4889",2014-02-01,"sbsl","transporte regular","voo doméstico",634,636,1270,69352,67120,136472,0,0,0,0
"4890",2014-02-01,"sbsl","transporte regular","voo internacional",0,0,0,0,0,0,0,0,0,0
"4891",2014-02-01,"sbsl","transporte não regular","voo doméstico",340,337,677,1111,853,1964,74296,203519,277815,0
"4892",2014-02-01,"sbsl","transporte não regular","voo internacional",2,2,4,0,0,0,0,0,0,0
"4893",2014-02-01,"sbsn","transporte regular","voo doméstico",397,396,793,22867,20208,43075,0,0,0,0
"4894",2014-02-01,"sbsn","transporte regular","voo internacional",0,0,0,0,0,0,0,0,0,0
"4895",2014-02-01,"sbsn","transporte não regular","voo doméstico",361,368,729,732,412,1144,0,0,0,0
"4896",2014-02-01,"sbsn","transporte não regular","voo internacional",3,4,7,0,0,0,0,0,0,0
"4897",2014-02-01,"sbsp","transporte regular","voo doméstico",5998,6053,12051,667213,634662,1301875,0,0,0,0
"4898",2014-02-01,"sbsp","transporte regular","voo internacional",0,0,0,0,0,0,0,0,0,0
"4899",2014-02-01,"sbsp","transporte não regular","voo doméstico",2243,2185,4428,8464,9809,18273,0,0,0,0
"4900",2014-02-01,"sbsp","transporte não regular","voo internacional",0,0,0,0,0,0,0,0,0,0
"4901",2014-02-01,"sbte","transporte regular","voo doméstico",428,430,858,43599,38709,82308,17306,93310,110616,267291
"4902",2014-02-01,"sbte","transporte regular","voo internacional",0,0,0,0,0,0,0,0,0,0
"4903",2014-02-01,"sbte","transporte não regular","voo doméstico",269,271,540,1499,1649,3148,0,0,0,0
"4904",2014-02-01,"sbte","transporte não regular","voo internacional",1,2,3,0,0,0,0,0,0,0
"4905",2014-02-01,"sbtf","transporte regular","voo doméstico",79,80,159,3248,3471,6719,0,0,0,0
"4906",2014-02-01,"sbtf","transporte regular","voo internacional",0,0,0,0,0,0,0,0,0,0
"4907",2014-02-01,"sbtf","transporte não regular","voo doméstico",246,244,490,430,452,882,1841,4617,6458,19142
"4908",2014-02-01,"sbtf","transporte não regular","voo internacional",0,0,0,0,0,0,0,0,0,0
"4909",2014-02-01,"sbtt","transporte regular","voo doméstico",36,36,72,2138,2715,4853,0,0,0,0
"4910",2014-02-01,"sbtt","transporte regular","voo internacional",0,0,0,0,0,0,0,0,0,0
"4911",2014-02-01,"sbtt","transporte não regular","voo doméstico",118,115,233,524,555,1079,2505,4016,6521,852
"4912",2014-02-01,"sbtt","transporte não regular","voo internacional",5,5,10,11,11,22,0,0,0,0
"4913",2014-02-01,"sbuf","transporte regular","voo doméstico",12,12,24,728,691,1419,0,0,0,0
"4914",2014-02-01,"sbuf","transporte regular","voo internacional",0,0,0,0,0,0,0,0,0,0
"4915",2014-02-01,"sbuf","transporte não regular","voo doméstico",31,32,63,90,87,177,0,0,0,0
"4916",2014-02-01,"sbuf","transporte não regular","voo internacional",0,0,0,0,0,0,0,0,0,0
"4917",2014-02-01,"sbug","transporte regular","voo doméstico",0,0,0,0,0,0,0,0,0,0
"4918",2014-02-01,"sbug","transporte regular","voo internacional",0,0,0,0,0,0,0,0,0,0
"4919",2014-02-01,"sbug","transporte não regular","voo doméstico",5,4,9,6,5,11,0,0,0,0
"4920",2014-02-01,"sbug","transporte não regular","voo internacional",2,3,5,6,0,6,0,0,0,0
"4921",2014-02-01,"sbul","transporte regular","voo doméstico",481,481,962,41437,42251,83688,0,0,0,0
"4922",2014-02-01,"sbul","transporte regular","voo internacional",0,0,0,0,0,0,0,0,0,0
"4923",2014-02-01,"sbul","transporte não regular","voo doméstico",647,652,1299,1448,1340,2788,0,0,0,0
"4924",2014-02-01,"sbul","transporte não regular","voo internacional",2,2,4,7,7,14,0,0,0,0
"4925",2014-02-01,"sbur","transporte regular","voo doméstico",99,99,198,5097,5428,10525,0,0,0,0
"4926",2014-02-01,"sbur","transporte regular","voo internacional",0,0,0,0,0,0,0,0,0,0
"4927",2014-02-01,"sbur","transporte não regular","voo doméstico",236,233,469,1252,1392,2644,0,0,0,0
"4928",2014-02-01,"sbur","transporte não regular","voo internacional",1,1,2,0,0,0,0,0,0,0
"4929",2014-01-01,"sbbe","transporte regular","voo doméstico",1784,1788,3572,165020,157740,322760,24,0,24,0
"4930",2014-01-01,"sbbe","transporte regular","voo internacional",20,20,40,1760,1699,3459,0,13,13,0
"4931",2014-01-01,"sbbe","transporte não regular","voo doméstico",596,600,1196,4110,4155,8265,95021,351886,446907,0
"4932",2014-01-01,"sbbe","transporte não regular","voo internacional",23,21,44,41,64,105,0,0,0,0
"4933",2014-01-01,"sbbg","transporte regular","voo doméstico",0,0,0,0,0,0,0,0,0,0
"4934",2014-01-01,"sbbg","transporte regular","voo internacional",0,0,0,0,0,0,0,0,0,0
"4935",2014-01-01,"sbbg","transporte não regular","voo doméstico",16,14,30,73,75,148,0,0,0,0
"4936",2014-01-01,"sbbg","transporte não regular","voo internacional",2,4,6,24,6,30,0,0,0,0
"4937",2014-01-01,"sbbh","transporte regular","voo doméstico",506,513,1019,25258,29133,54391,0,0,0,0
"4938",2014-01-01,"sbbh","transporte regular","voo internacional",0,0,0,0,0,0,0,0,0,0
"4939",2014-01-01,"sbbh","transporte não regular","voo doméstico",1836,1813,3649,8714,8797,17511,0,0,0,0
"4940",2014-01-01,"sbbh","transporte não regular","voo internacional",3,3,6,22,22,44,0,0,0,0
"4941",2014-01-01,"sbbi","transporte regular","voo doméstico",0,0,0,0,0,0,0,0,0,0
"4942",2014-01-01,"sbbi","transporte regular","voo internacional",0,0,0,0,0,0,0,0,0,0
"4943",2014-01-01,"sbbi","transporte não regular","voo doméstico",1570,1565,3135,3034,5028,8062,0,0,0,0
"4944",2014-01-01,"sbbi","transporte não regular","voo internacional",0,0,0,0,0,0,0,0,0,0
"4945",2014-01-01,"sbbv","transporte regular","voo doméstico",158,158,316,18558,20111,38669,46,0,46,0
"4946",2014-01-01,"sbbv","transporte regular","voo internacional",0,0,0,0,0,0,0,0,0,0
"4947",2014-01-01,"sbbv","transporte não regular","voo doméstico",109,117,226,238,77,315,0,0,0,0
"4948",2014-01-01,"sbbv","transporte não regular","voo internacional",32,23,55,14,9,23,0,0,0,0
"4949",2014-01-01,"sbcg","transporte regular","voo doméstico",657,654,1311,70361,71394,141755,53872,108469,162341,0
"4950",2014-01-01,"sbcg","transporte regular","voo internacional",0,0,0,0,0,0,0,0,0,0
"4951",2014-01-01,"sbcg","transporte não regular","voo doméstico",313,315,628,1957,1643,3600,0,0,0,0
"4952",2014-01-01,"sbcg","transporte não regular","voo internacional",8,7,15,0,0,0,0,0,0,0
"4953",2014-01-01,"sbcj","transporte regular","voo doméstico",107,107,214,3858,4611,8469,0,0,0,0
"4954",2014-01-01,"sbcj","transporte regular","voo internacional",0,0,0,0,0,0,0,0,0,0
"4955",2014-01-01,"sbcj","transporte não regular","voo doméstico",86,85,171,792,861,1653,0,0,0,0
"4956",2014-01-01,"sbcj","transporte não regular","voo internacional",0,0,0,0,0,0,0,0,0,0
"4957",2014-01-01,"sbcr","transporte regular","voo doméstico",27,27,54,1443,1509,2952,0,0,0,0
"4958",2014-01-01,"sbcr","transporte regular","voo internacional",0,0,0,0,0,0,0,0,0,0
"4959",2014-01-01,"sbcr","transporte não regular","voo doméstico",26,26,52,58,40,98,0,0,0,0
"4960",2014-01-01,"sbcr","transporte não regular","voo internacional",5,5,10,10,8,18,0,0,0,0
"4961",2014-01-01,"sbct","transporte regular","voo doméstico",3005,3012,6017,297473,293981,591454,203488,0,203488,197212
"4962",2014-01-01,"sbct","transporte regular","voo internacional",114,114,228,5332,7555,12887,0,8121,8121,505
"4963",2014-01-01,"sbct","transporte não regular","voo doméstico",229,225,454,1808,2216,4024,0,24725,24725,0
"4964",2014-01-01,"sbct","transporte não regular","voo internacional",16,10,26,11,27,38,0,0,0,0
"4965",2014-01-01,"sbcz","transporte regular","voo doméstico",31,31,62,3173,2559,5732,0,0,0,0
"4966",2014-01-01,"sbcz","transporte regular","voo internacional",0,0,0,0,0,0,0,0,0,0
"4967",2014-01-01,"sbcz","transporte não regular","voo doméstico",146,148,294,563,553,1116,0,0,0,0
"4968",2014-01-01,"sbcz","transporte não regular","voo internacional",0,0,0,0,0,0,0,0,0,0
"4969",2014-01-01,"sbeg","transporte regular","voo doméstico",1385,1381,2766,127327,137064,264391,0,0,0,0
"4970",2014-01-01,"sbeg","transporte regular","voo internacional",121,129,250,10909,11694,22603,0,0,0,0
"4971",2014-01-01,"sbeg","transporte não regular","voo doméstico",648,651,1299,10904,11666,22570,0,0,0,0
"4972",2014-01-01,"sbeg","transporte não regular","voo internacional",140,125,265,309,208,517,0,0,0,0
"4973",2014-01-01,"sbfi","transporte regular","voo doméstico",572,571,1143,78246,73242,151488,0,0,0,0
"4974",2014-01-01,"sbfi","transporte regular","voo internacional",18,18,36,2124,2403,4527,0,0,0,0
"4975",2014-01-01,"sbfi","transporte não regular","voo doméstico",90,89,179,739,733,1472,0,0,0,0
"4976",2014-01-01,"sbfi","transporte não regular","voo internacional",41,41,82,292,286,578,0,0,0,0
"4977",2014-01-01,"sbgo","transporte regular","voo doméstico",1419,1421,2840,139825,145593,285418,94223,148697,242920,155361
"4978",2014-01-01,"sbgo","transporte regular","voo internacional",0,0,0,0,0,0,0,0,0,0
"4979",2014-01-01,"sbgo","transporte não regular","voo doméstico",1139,1109,2248,3927,4532,8459,0,0,0,0
"4980",2014-01-01,"sbgo","transporte não regular","voo internacional",2,2,4,0,0,0,0,0,0,0
"4981",2014-01-01,"sbht","transporte regular","voo doméstico",208,208,416,7199,8508,15707,0,0,0,0
"4982",2014-01-01,"sbht","transporte regular","voo internacional",0,0,0,0,0,0,0,0,0,0
"4983",2014-01-01,"sbht","transporte não regular","voo doméstico",167,167,334,327,1258,1585,0,0,0,0
"4984",2014-01-01,"sbht","transporte não regular","voo internacional",0,0,0,0,0,0,0,0,0,0
"4985",2014-01-01,"sbiz","transporte regular","voo doméstico",184,184,368,13255,14068,27323,0,0,0,0
"4986",2014-01-01,"sbiz","transporte regular","voo internacional",0,0,0,0,0,0,0,0,0,0
"4987",2014-01-01,"sbiz","transporte não regular","voo doméstico",138,139,277,369,394,763,0,0,0,0
"4988",2014-01-01,"sbiz","transporte não regular","voo internacional",0,0,0,0,0,0,0,0,0,0
"4989",2014-01-01,"sbjc","transporte regular","voo doméstico",0,0,0,0,0,0,0,0,0,0
"4990",2014-01-01,"sbjc","transporte regular","voo internacional",0,0,0,0,0,0,0,0,0,0
"4991",2014-01-01,"sbjc","transporte não regular","voo doméstico",513,515,1028,1152,869,2021,0,0,0,0
"4992",2014-01-01,"sbjc","transporte não regular","voo internacional",0,1,1,0,0,0,0,0,0,0
"4993",2014-01-01,"sbjr","transporte regular","voo doméstico",0,0,0,0,0,0,0,0,0,0
"4994",2014-01-01,"sbjr","transporte regular","voo internacional",0,0,0,0,0,0,0,0,0,0
"4995",2014-01-01,"sbjr","transporte não regular","voo doméstico",3734,3735,7469,7745,3073,10818,0,0,0,0
"4996",2014-01-01,"sbjr","transporte não regular","voo internacional",0,0,0,0,0,0,0,0,0,0
"4997",2014-01-01,"sbjv","transporte regular","voo doméstico",268,269,537,21882,19300,41182,0,0,0,0
"4998",2014-01-01,"sbjv","transporte regular","voo internacional",0,0,0,0,0,0,0,0,0,0
"4999",2014-01-01,"sbjv","transporte não regular","voo doméstico",353,353,706,110,398,508,0,0,0,0
"5000",2014-01-01,"sbjv","transporte não regular","voo internacional",0,0,0,0,0,0,0,0,0,0
"5001",2014-01-01,"sblo","transporte regular","voo doméstico",510,508,1018,49979,48205,98184,0,0,0,0
"5002",2014-01-01,"sblo","transporte regular","voo internacional",0,0,0,0,0,0,0,0,0,0
"5003",2014-01-01,"sblo","transporte não regular","voo doméstico",689,697,1386,514,533,1047,0,0,0,0
"5004",2014-01-01,"sblo","transporte não regular","voo internacional",2,2,4,0,0,0,0,0,0,0
"5005",2014-01-01,"sbma","transporte regular","voo doméstico",403,404,807,20144,20414,40558,8,0,8,0
"5006",2014-01-01,"sbma","transporte regular","voo internacional",0,0,0,0,0,0,0,0,0,0
"5007",2014-01-01,"sbma","transporte não regular","voo doméstico",233,232,465,761,852,1613,0,0,0,0
"5008",2014-01-01,"sbma","transporte não regular","voo internacional",2,2,4,0,0,0,0,0,0,0
"5009",2014-01-01,"sbmk","transporte regular","voo doméstico",171,172,343,16874,14476,31350,0,0,0,0
"5010",2014-01-01,"sbmk","transporte regular","voo internacional",0,0,0,0,0,0,0,0,0,0
"5011",2014-01-01,"sbmk","transporte não regular","voo doméstico",247,249,496,5,32,37,0,0,0,0
"5012",2014-01-01,"sbmk","transporte não regular","voo internacional",0,0,0,0,0,0,0,0,0,0
"5013",2014-01-01,"sbmq","transporte regular","voo doméstico",360,360,720,32865,36307,69172,10540,28230,38770,0
"5014",2014-01-01,"sbmq","transporte regular","voo internacional",0,0,0,0,0,0,0,0,0,0
"5015",2014-01-01,"sbmq","transporte não regular","voo doméstico",195,195,390,1884,1384,3268,0,0,0,0
"5016",2014-01-01,"sbmq","transporte não regular","voo internacional",8,7,15,0,0,0,0,0,0,0
"5017",2014-01-01,"sbmt","transporte regular","voo doméstico",0,0,0,0,0,0,0,0,0,0
"5018",2014-01-01,"sbmt","transporte regular","voo internacional",0,0,0,0,0,0,0,0,0,0
"5019",2014-01-01,"sbmt","transporte não regular","voo doméstico",5791,5766,11557,9301,9205,18506,0,0,0,0
"5020",2014-01-01,"sbmt","transporte não regular","voo internacional",0,0,0,0,0,0,0,0,0,0
"5021",2014-01-01,"sbnf","transporte regular","voo doméstico",638,636,1274,66899,58431,125330,0,0,0,0
"5022",2014-01-01,"sbnf","transporte regular","voo internacional",0,0,0,0,0,0,0,0,0,0
"5023",2014-01-01,"sbnf","transporte não regular","voo doméstico",394,399,793,1103,1394,2497,0,0,0,0
"5024",2014-01-01,"sbnf","transporte não regular","voo internacional",13,13,26,35,11,46,0,0,0,0
"5025",2014-01-01,"sbpb","transporte regular","voo doméstico",0,0,0,0,0,0,0,0,0,0
"5026",2014-01-01,"sbpb","transporte regular","voo internacional",0,0,0,0,0,0,0,0,0,0
"5027",2014-01-01,"sbpb","transporte não regular","voo doméstico",48,61,109,151,76,227,0,0,0,0
"5028",2014-01-01,"sbpb","transporte não regular","voo internacional",0,0,0,0,0,0,0,0,0,0
"5029",2014-01-01,"sbpj","transporte regular","voo doméstico",381,380,761,23707,24956,48663,0,0,0,0
"5030",2014-01-01,"sbpj","transporte regular","voo internacional",0,0,0,0,0,0,0,0,0,0
"5031",2014-01-01,"sbpj","transporte não regular","voo doméstico",319,319,638,395,256,651,0,0,0,0
"5032",2014-01-01,"sbpj","transporte não regular","voo internacional",8,6,14,0,0,0,0,0,0,0
"5033",2014-01-01,"sbpk","transporte regular","voo doméstico",40,39,79,2024,1748,3772,0,0,0,0
"5034",2014-01-01,"sbpk","transporte regular","voo internacional",0,0,0,0,0,0,0,0,0,0
"5035",2014-01-01,"sbpk","transporte não regular","voo doméstico",65,58,123,167,172,339,0,0,0,0
"5036",2014-01-01,"sbpk","transporte não regular","voo internacional",1,8,9,2,0,2,0,0,0,0
"5037",2014-01-01,"sbpl","transporte regular","voo doméstico",211,211,422,22179,22870,45049,0,0,0,0
"5038",2014-01-01,"sbpl","transporte regular","voo internacional",0,0,0,0,0,0,0,0,0,0
"5039",2014-01-01,"sbpl","transporte não regular","voo doméstico",101,101,202,182,69,251,0,0,0,0
"5040",2014-01-01,"sbpl","transporte não regular","voo internacional",0,0,0,0,0,0,0,0,0,0
"5041",2014-01-01,"sbpp","transporte regular","voo doméstico",0,0,0,0,0,0,0,0,0,0
"5042",2014-01-01,"sbpp","transporte regular","voo internacional",0,0,0,0,0,0,0,0,0,0
"5043",2014-01-01,"sbpp","transporte não regular","voo doméstico",65,64,129,143,135,278,0,0,0,0
"5044",2014-01-01,"sbpp","transporte não regular","voo internacional",3,4,7,12,9,21,0,0,0,0
"5045",2014-01-01,"sbpr","transporte regular","voo doméstico",0,1,1,1,0,1,0,0,0,0
"5046",2014-01-01,"sbpr","transporte regular","voo internacional",0,0,0,0,0,0,0,0,0,0
"5047",2014-01-01,"sbpr","transporte não regular","voo doméstico",1796,1776,3572,1956,1990,3946,0,0,0,0
"5048",2014-01-01,"sbpr","transporte não regular","voo internacional",0,0,0,0,0,0,0,0,0,0
"5049",2014-01-01,"sbpv","transporte regular","voo doméstico",474,473,947,42972,45676,88648,51056,187063,238119,0
"5050",2014-01-01,"sbpv","transporte regular","voo internacional",0,0,0,0,0,0,0,0,0,0
"5051",2014-01-01,"sbpv","transporte não regular","voo doméstico",244,247,491,41,0,41,0,0,0,0
"5052",2014-01-01,"sbpv","transporte não regular","voo internacional",1,1,2,0,0,0,0,0,0,0
"5053",2014-01-01,"sbrb","transporte regular","voo doméstico",166,164,330,17901,17074,34975,0,0,0,0
"5054",2014-01-01,"sbrb","transporte regular","voo internacional",0,0,0,0,0,0,0,0,0,0
"5055",2014-01-01,"sbrb","transporte não regular","voo doméstico",269,270,539,980,787,1767,0,0,0,0
"5056",2014-01-01,"sbrb","transporte não regular","voo internacional",0,0,0,0,0,0,0,0,0,0
"5057",2014-01-01,"sbrj","transporte regular","voo doméstico",4377,4387,8764,433019,375671,808690,0,0,0,0
"5058",2014-01-01,"sbrj","transporte regular","voo internacional",0,0,0,0,0,0,0,0,0,0
"5059",2014-01-01,"sbrj","transporte não regular","voo doméstico",1092,1081,2173,2295,1684,3979,0,0,0,0
"5060",2014-01-01,"sbrj","transporte não regular","voo internacional",2,2,4,0,0,0,0,0,0,0
"5061",2014-01-01,"sbsj","transporte regular","voo doméstico",30,32,62,1722,1623,3345,0,0,0,0
"5062",2014-01-01,"sbsj","transporte regular","voo internacional",0,0,0,0,0,0,0,0,0,0
"5063",2014-01-01,"sbsj","transporte não regular","voo doméstico",547,533,1080,805,1080,1885,0,0,0,0
"5064",2014-01-01,"sbsj","transporte não regular","voo internacional",2,5,7,9,4,13,0,0,0,0
"5065",2014-01-01,"sbsl","transporte regular","voo doméstico",788,785,1573,86532,80969,167501,0,0,0,0
"5066",2014-01-01,"sbsl","transporte regular","voo internacional",0,0,0,0,0,0,0,0,0,0
"5067",2014-01-01,"sbsl","transporte não regular","voo doméstico",435,440,875,6164,3915,10079,97120,197851,294971,0
"5068",2014-01-01,"sbsl","transporte não regular","voo internacional",2,3,5,0,0,0,0,0,0,0
"5069",2014-01-01,"sbsn","transporte regular","voo doméstico",439,438,877,28329,22541,50870,0,0,0,0
"5070",2014-01-01,"sbsn","transporte regular","voo internacional",0,0,0,0,0,0,0,0,0,0
"5071",2014-01-01,"sbsn","transporte não regular","voo doméstico",389,386,775,990,452,1442,0,0,0,0
"5072",2014-01-01,"sbsn","transporte não regular","voo internacional",3,2,5,0,0,0,0,0,0,0
"5073",2014-01-01,"sbsp","transporte regular","voo doméstico",6498,6580,13078,732003,775907,1507910,0,0,0,0
"5074",2014-01-01,"sbsp","transporte regular","voo internacional",0,0,0,0,0,0,0,0,0,0
"5075",2014-01-01,"sbsp","transporte não regular","voo doméstico",1989,1898,3887,11450,14687,26137,0,0,0,0
"5076",2014-01-01,"sbsp","transporte não regular","voo internacional",0,0,0,0,0,0,0,0,0,0
"5077",2014-01-01,"sbte","transporte regular","voo doméstico",488,489,977,52948,46601,99549,16962,86745,103707,276925
"5078",2014-01-01,"sbte","transporte regular","voo internacional",0,0,0,0,0,0,0,0,0,0
"5079",2014-01-01,"sbte","transporte não regular","voo doméstico",236,233,469,1499,1260,2759,0,0,0,0
"5080",2014-01-01,"sbte","transporte não regular","voo internacional",2,1,3,0,0,0,0,0,0,0
"5081",2014-01-01,"sbtf","transporte regular","voo doméstico",88,88,176,3862,3845,7707,0,0,0,0
"5082",2014-01-01,"sbtf","transporte regular","voo internacional",0,0,0,0,0,0,0,0,0,0
"5083",2014-01-01,"sbtf","transporte não regular","voo doméstico",235,235,470,398,341,739,2452,4767,7219,19874
"5084",2014-01-01,"sbtf","transporte não regular","voo internacional",0,0,0,0,0,0,0,0,0,0
"5085",2014-01-01,"sbtt","transporte regular","voo doméstico",31,31,62,2430,2809,5239,0,0,0,0
"5086",2014-01-01,"sbtt","transporte regular","voo internacional",0,0,0,0,0,0,0,0,0,0
"5087",2014-01-01,"sbtt","transporte não regular","voo doméstico",127,126,253,521,504,1025,2315,4007,6322,922
"5088",2014-01-01,"sbtt","transporte não regular","voo internacional",2,3,5,10,8,18,0,0,0,0
"5089",2014-01-01,"sbuf","transporte regular","voo doméstico",14,14,28,923,881,1804,0,0,0,0
"5090",2014-01-01,"sbuf","transporte regular","voo internacional",0,0,0,0,0,0,0,0,0,0
"5091",2014-01-01,"sbuf","transporte não regular","voo doméstico",41,41,82,90,88,178,0,0,0,0
"5092",2014-01-01,"sbuf","transporte não regular","voo internacional",0,0,0,0,0,0,0,0,0,0
"5093",2014-01-01,"sbug","transporte regular","voo doméstico",0,0,0,0,0,0,0,0,0,0
"5094",2014-01-01,"sbug","transporte regular","voo internacional",0,0,0,0,0,0,0,0,0,0
"5095",2014-01-01,"sbug","transporte não regular","voo doméstico",17,16,33,33,25,58,0,0,0,0
"5096",2014-01-01,"sbug","transporte não regular","voo internacional",2,3,5,0,0,0,0,0,0,0
"5097",2014-01-01,"sbul","transporte regular","voo doméstico",532,531,1063,47723,47907,95630,0,0,0,0
"5098",2014-01-01,"sbul","transporte regular","voo internacional",0,0,0,0,0,0,0,0,0,0
"5099",2014-01-01,"sbul","transporte não regular","voo doméstico",649,649,1298,1691,1781,3472,0,0,0,0
"5100",2014-01-01,"sbul","transporte não regular","voo internacional",0,0,0,0,0,0,0,0,0,0
"5101",2014-01-01,"sbur","transporte regular","voo doméstico",109,106,215,5029,5188,10217,0,0,0,0
"5102",2014-01-01,"sbur","transporte regular","voo internacional",0,0,0,0,0,0,0,0,0,0
"5103",2014-01-01,"sbur","transporte não regular","voo doméstico",171,175,346,1324,1242,2566,0,0,0,0
"5104",2014-01-01,"sbur","transporte não regular","voo internacional",4,4,8,0,0,0,0,0,0,0
"5105",2014-07-01,"sbbe","transporte regular","voo doméstico",1748,1749,3497,183515,180198,363713,18089,93936,112025,0
"5106",2014-07-01,"sbbe","transporte regular","voo internacional",43,43,86,5281,4550,9831,0,22,22,0
"5107",2014-07-01,"sbbe","transporte não regular","voo doméstico",611,602,1213,3321,3222,6543,64503,305220,369723,0
"5108",2014-07-01,"sbbe","transporte não regular","voo internacional",16,19,35,32,32,64,0,0,0,0
"5109",2014-07-01,"sbbg","transporte regular","voo doméstico",0,0,0,0,0,0,0,0,0,0
"5110",2014-07-01,"sbbg","transporte regular","voo internacional",0,0,0,0,0,0,0,0,0,0
"5111",2014-07-01,"sbbg","transporte não regular","voo doméstico",13,14,27,65,62,127,0,0,0,0
"5112",2014-07-01,"sbbg","transporte não regular","voo internacional",3,2,5,2,8,10,0,0,0,0
"5113",2014-07-01,"sbbh","transporte regular","voo doméstico",569,581,1150,27665,31987,59652,0,0,0,0
"5114",2014-07-01,"sbbh","transporte regular","voo internacional",0,0,0,0,0,0,0,0,0,0
"5115",2014-07-01,"sbbh","transporte não regular","voo doméstico",2391,2376,4767,11755,11989,23744,0,0,0,0
"5116",2014-07-01,"sbbh","transporte não regular","voo internacional",20,20,40,174,174,348,0,0,0,0
"5117",2014-07-01,"sbbi","transporte regular","voo doméstico",0,0,0,0,0,0,0,0,0,0
"5118",2014-07-01,"sbbi","transporte regular","voo internacional",0,0,0,0,0,0,0,0,0,0
"5119",2014-07-01,"sbbi","transporte não regular","voo doméstico",1379,1371,2750,5340,5335,10675,0,0,0,0
"5120",2014-07-01,"sbbi","transporte não regular","voo internacional",1,2,3,0,0,0,0,0,0,0
"5121",2014-07-01,"sbbv","transporte regular","voo doméstico",141,141,282,16946,16572,33518,0,0,0,0
"5122",2014-07-01,"sbbv","transporte regular","voo internacional",0,0,0,0,0,0,0,0,0,0
"5123",2014-07-01,"sbbv","transporte não regular","voo doméstico",94,96,190,173,54,227,0,0,0,0
"5124",2014-07-01,"sbbv","transporte não regular","voo internacional",21,16,37,16,5,21,0,0,0,0
"5125",2014-07-01,"sbcg","transporte regular","voo doméstico",693,699,1392,76048,72381,148429,60765,109873,170638,0
"5126",2014-07-01,"sbcg","transporte regular","voo internacional",13,13,26,455,363,818,0,0,0,0
"5127",2014-07-01,"sbcg","transporte não regular","voo doméstico",366,362,728,140,662,802,3839,0,3839,0
"5128",2014-07-01,"sbcg","transporte não regular","voo internacional",6,7,13,0,0,0,0,0,0,0
"5129",2014-07-01,"sbcj","transporte regular","voo doméstico",86,86,172,5925,5050,10975,0,0,0,0
"5130",2014-07-01,"sbcj","transporte regular","voo internacional",0,0,0,0,0,0,0,0,0,0
"5131",2014-07-01,"sbcj","transporte não regular","voo doméstico",133,133,266,1398,1127,2525,0,0,0,0
"5132",2014-07-01,"sbcj","transporte não regular","voo internacional",4,4,8,0,0,0,0,0,0,0
"5133",2014-07-01,"sbcr","transporte regular","voo doméstico",24,24,48,1428,1458,2886,0,0,0,0
"5134",2014-07-01,"sbcr","transporte regular","voo internacional",0,0,0,0,0,0,0,0,0,0
"5135",2014-07-01,"sbcr","transporte não regular","voo doméstico",33,33,66,97,73,170,0,0,0,0
"5136",2014-07-01,"sbcr","transporte não regular","voo internacional",5,6,11,9,5,14,0,0,0,0
"5137",2014-07-01,"sbct","transporte regular","voo doméstico",2910,2906,5816,295577,301845,597422,161027,0,161027,163309
"5138",2014-07-01,"sbct","transporte regular","voo internacional",126,126,252,6447,6314,12761,0,8753,8753,0
"5139",2014-07-01,"sbct","transporte não regular","voo doméstico",223,231,454,1329,1924,3253,0,0,0,0
"5140",2014-07-01,"sbct","transporte não regular","voo internacional",24,19,43,35,44,79,0,10397,10397,0
"5141",2014-07-01,"sbcz","transporte regular","voo doméstico",31,31,62,2804,2566,5370,0,0,0,0
"5142",2014-07-01,"sbcz","transporte regular","voo internacional",0,0,0,0,0,0,0,0,0,0
"5143",2014-07-01,"sbcz","transporte não regular","voo doméstico",236,231,467,877,859,1736,0,0,0,0
"5144",2014-07-01,"sbcz","transporte não regular","voo internacional",1,1,2,0,0,0,0,0,0,0
"5145",2014-07-01,"sbeg","transporte regular","voo doméstico",1353,1352,2705,131913,131066,262979,0,0,0,0
"5146",2014-07-01,"sbeg","transporte regular","voo internacional",137,137,274,10670,8842,19512,0,0,0,0
"5147",2014-07-01,"sbeg","transporte não regular","voo doméstico",669,686,1355,7009,6872,13881,0,0,0,0
"5148",2014-07-01,"sbeg","transporte não regular","voo internacional",177,169,346,407,377,784,0,0,0,0
"5149",2014-07-01,"sbfi","transporte regular","voo doméstico",614,611,1225,79216,82394,161610,0,0,0,0
"5150",2014-07-01,"sbfi","transporte regular","voo internacional",31,31,62,4197,3196,7393,0,0,0,0
"5151",2014-07-01,"sbfi","transporte não regular","voo doméstico",187,188,375,730,1669,2399,0,0,0,0
"5152",2014-07-01,"sbfi","transporte não regular","voo internacional",85,85,170,241,242,483,0,0,0,0
"5153",2014-07-01,"sbgo","transporte regular","voo doméstico",1385,1379,2764,146065,138930,284995,129629,173138,302767,162115
"5154",2014-07-01,"sbgo","transporte regular","voo internacional",0,0,0,0,0,0,0,0,0,0
"5155",2014-07-01,"sbgo","transporte não regular","voo doméstico",1270,1283,2553,5014,5535,10549,0,9829,9829,6397
"5156",2014-07-01,"sbgo","transporte não regular","voo internacional",7,6,13,0,0,0,0,0,0,0
"5157",2014-07-01,"sbht","transporte regular","voo doméstico",214,216,430,10281,9866,20147,0,0,0,0
"5158",2014-07-01,"sbht","transporte regular","voo internacional",0,0,0,0,0,0,0,0,0,0
"5159",2014-07-01,"sbht","transporte não regular","voo doméstico",230,230,460,983,846,1829,1135,1745,2880,1588
"5160",2014-07-01,"sbht","transporte não regular","voo internacional",0,0,0,0,0,0,0,0,0,0
"5161",2014-07-01,"sbiz","transporte regular","voo doméstico",238,239,477,18012,18172,36184,0,0,0,0
"5162",2014-07-01,"sbiz","transporte regular","voo internacional",0,0,0,0,0,0,0,0,0,0
"5163",2014-07-01,"sbiz","transporte não regular","voo doméstico",175,170,345,520,500,1020,0,0,0,0
"5164",2014-07-01,"sbiz","transporte não regular","voo internacional",0,0,0,0,0,0,0,0,0,0
"5165",2014-07-01,"sbjc","transporte regular","voo doméstico",0,0,0,0,0,0,0,0,0,0
"5166",2014-07-01,"sbjc","transporte regular","voo internacional",0,0,0,0,0,0,0,0,0,0
"5167",2014-07-01,"sbjc","transporte não regular","voo doméstico",551,559,1110,1255,1027,2282,0,0,0,0
"5168",2014-07-01,"sbjc","transporte não regular","voo internacional",0,0,0,0,0,0,0,0,0,0
"5169",2014-07-01,"sbjr","transporte regular","voo doméstico",0,0,0,0,0,0,0,0,0,0
"5170",2014-07-01,"sbjr","transporte regular","voo internacional",0,0,0,0,0,0,0,0,0,0
"5171",2014-07-01,"sbjr","transporte não regular","voo doméstico",3000,3014,6014,9187,5366,14553,0,0,0,0
"5172",2014-07-01,"sbjr","transporte não regular","voo internacional",0,0,0,0,0,0,0,0,0,0
"5173",2014-07-01,"sbjv","transporte regular","voo doméstico",236,236,472,21138,21189,42327,0,0,0,0
"5174",2014-07-01,"sbjv","transporte regular","voo internacional",0,0,0,0,0,0,0,0,0,0
"5175",2014-07-01,"sbjv","transporte não regular","voo doméstico",301,300,601,590,179,769,0,0,0,0
"5176",2014-07-01,"sbjv","transporte não regular","voo internacional",0,0,0,0,0,0,0,0,0,0
"5177",2014-07-01,"sblo","transporte regular","voo doméstico",427,429,856,45858,45318,91176,0,0,0,0
"5178",2014-07-01,"sblo","transporte regular","voo internacional",0,0,0,0,0,0,0,0,0,0
"5179",2014-07-01,"sblo","transporte não regular","voo doméstico",828,834,1662,4145,4364,8509,0,0,0,0
"5180",2014-07-01,"sblo","transporte não regular","voo internacional",5,4,9,0,0,0,0,0,0,0
"5181",2014-07-01,"sbma","transporte regular","voo doméstico",347,347,694,20616,19900,40516,0,0,0,0
"5182",2014-07-01,"sbma","transporte regular","voo internacional",0,0,0,0,0,0,0,0,0,0
"5183",2014-07-01,"sbma","transporte não regular","voo doméstico",351,356,707,1493,1329,2822,0,0,0,0
"5184",2014-07-01,"sbma","transporte não regular","voo internacional",3,3,6,0,0,0,0,0,0,0
"5185",2014-07-01,"sbmk","transporte regular","voo doméstico",197,198,395,15304,14653,29957,0,0,0,0
"5186",2014-07-01,"sbmk","transporte regular","voo internacional",0,0,0,0,0,0,0,0,0,0
"5187",2014-07-01,"sbmk","transporte não regular","voo doméstico",350,347,697,31,64,95,0,0,0,0
"5188",2014-07-01,"sbmk","transporte não regular","voo internacional",0,0,0,0,0,0,0,0,0,0
"5189",2014-07-01,"sbmq","transporte regular","voo doméstico",360,363,723,37351,33312,70663,19850,37880,57730,0
"5190",2014-07-01,"sbmq","transporte regular","voo internacional",0,0,0,0,0,0,0,0,0,0
"5191",2014-07-01,"sbmq","transporte não regular","voo doméstico",242,244,486,530,251,781,0,0,0,0
"5192",2014-07-01,"sbmq","transporte não regular","voo internacional",11,12,23,0,0,0,0,0,0,0
"5193",2014-07-01,"sbmt","transporte regular","voo doméstico",0,0,0,0,0,0,0,0,0,0
"5194",2014-07-01,"sbmt","transporte regular","voo internacional",0,0,0,0,0,0,0,0,0,0
"5195",2014-07-01,"sbmt","transporte não regular","voo doméstico",4037,4056,8093,6563,5997,12560,0,0,0,0
"5196",2014-07-01,"sbmt","transporte não regular","voo internacional",0,0,0,0,0,0,0,0,0,0
"5197",2014-07-01,"sbnf","transporte regular","voo doméstico",562,561,1123,56339,54138,110477,0,0,0,0
"5198",2014-07-01,"sbnf","transporte regular","voo internacional",0,0,0,0,0,0,0,0,0,0
"5199",2014-07-01,"sbnf","transporte não regular","voo doméstico",257,253,510,442,447,889,0,0,0,0
"5200",2014-07-01,"sbnf","transporte não regular","voo internacional",5,7,12,6,0,6,0,0,0,0
"5201",2014-07-01,"sbpb","transporte regular","voo doméstico",20,20,40,835,900,1735,0,0,0,0
"5202",2014-07-01,"sbpb","transporte regular","voo internacional",0,0,0,0,0,0,0,0,0,0
"5203",2014-07-01,"sbpb","transporte não regular","voo doméstico",106,105,211,240,234,474,0,0,0,0
"5204",2014-07-01,"sbpb","transporte não regular","voo internacional",1,1,2,0,0,0,0,0,0,0
"5205",2014-07-01,"sbpj","transporte regular","voo doméstico",370,371,741,32119,31227,63346,0,0,0,0
"5206",2014-07-01,"sbpj","transporte regular","voo internacional",0,0,0,0,0,0,0,0,0,0
"5207",2014-07-01,"sbpj","transporte não regular","voo doméstico",427,424,851,717,489,1206,0,0,0,0
"5208",2014-07-01,"sbpj","transporte não regular","voo internacional",3,3,6,0,0,0,0,0,0,0
"5209",2014-07-01,"sbpk","transporte regular","voo doméstico",46,46,92,2091,1930,4021,0,0,0,0
"5210",2014-07-01,"sbpk","transporte regular","voo internacional",0,0,0,0,0,0,0,0,0,0
"5211",2014-07-01,"sbpk","transporte não regular","voo doméstico",34,32,66,95,102,197,0,0,0,0
"5212",2014-07-01,"sbpk","transporte não regular","voo internacional",1,3,4,13,6,19,0,0,0,0
"5213",2014-07-01,"sbpl","transporte regular","voo doméstico",213,212,425,22604,21645,44249,0,0,0,0
"5214",2014-07-01,"sbpl","transporte regular","voo internacional",4,4,8,0,0,0,0,0,0,0
"5215",2014-07-01,"sbpl","transporte não regular","voo doméstico",131,128,259,124,115,239,0,0,0,0
"5216",2014-07-01,"sbpl","transporte não regular","voo internacional",0,0,0,0,0,0,0,0,0,0
"5217",2014-07-01,"sbpp","transporte regular","voo doméstico",0,0,0,0,0,0,0,0,0,0
"5218",2014-07-01,"sbpp","transporte regular","voo internacional",0,0,0,0,0,0,0,0,0,0
"5219",2014-07-01,"sbpp","transporte não regular","voo doméstico",90,89,179,138,136,274,0,0,0,0
"5220",2014-07-01,"sbpp","transporte não regular","voo internacional",9,8,17,4,8,12,0,0,0,0
"5221",2014-07-01,"sbpr","transporte regular","voo doméstico",0,0,0,0,0,0,0,0,0,0
"5222",2014-07-01,"sbpr","transporte regular","voo internacional",0,0,0,0,0,0,0,0,0,0
"5223",2014-07-01,"sbpr","transporte não regular","voo doméstico",1267,1263,2530,1485,1523,3008,0,0,0,0
"5224",2014-07-01,"sbpr","transporte não regular","voo internacional",0,0,0,0,0,0,0,0,0,0
"5225",2014-07-01,"sbpv","transporte regular","voo doméstico",446,448,894,40845,38021,78866,0,0,0,0
"5226",2014-07-01,"sbpv","transporte regular","voo internacional",0,0,0,0,0,0,0,0,0,0
"5227",2014-07-01,"sbpv","transporte não regular","voo doméstico",243,240,483,0,0,0,0,0,0,0
"5228",2014-07-01,"sbpv","transporte não regular","voo internacional",0,0,0,0,0,0,0,0,0,0
"5229",2014-07-01,"sbrb","transporte regular","voo doméstico",159,160,319,17749,17843,35592,0,0,0,0
"5230",2014-07-01,"sbrb","transporte regular","voo internacional",0,0,0,0,0,0,0,0,0,0
"5231",2014-07-01,"sbrb","transporte não regular","voo doméstico",274,269,543,956,650,1606,0,0,0,0
"5232",2014-07-01,"sbrb","transporte não regular","voo internacional",0,0,0,0,0,0,0,0,0,0
"5233",2014-07-01,"sbrj","transporte regular","voo doméstico",4331,4340,8671,409251,399468,808719,0,0,0,0
"5234",2014-07-01,"sbrj","transporte regular","voo internacional",0,0,0,0,0,0,0,0,0,0
"5235",2014-07-01,"sbrj","transporte não regular","voo doméstico",1054,1044,2098,1802,1685,3487,0,0,0,0
"5236",2014-07-01,"sbrj","transporte não regular","voo internacional",10,11,21,0,0,0,0,0,0,0
"5237",2014-07-01,"sbsj","transporte regular","voo doméstico",56,56,112,2793,2756,5549,0,0,0,0
"5238",2014-07-01,"sbsj","transporte regular","voo internacional",0,0,0,0,0,0,0,0,0,0
"5239",2014-07-01,"sbsj","transporte não regular","voo doméstico",465,455,920,910,831,1741,0,0,0,0
"5240",2014-07-01,"sbsj","transporte não regular","voo internacional",15,28,43,172,141,313,0,0,0,0
"5241",2014-07-01,"sbsl","transporte regular","voo doméstico",749,749,1498,81287,84578,165865,0,4,4,0
"5242",2014-07-01,"sbsl","transporte regular","voo internacional",0,0,0,0,0,0,0,0,0,0
"5243",2014-07-01,"sbsl","transporte não regular","voo doméstico",413,412,825,1873,1472,3345,97977,225301,323278,0
"5244",2014-07-01,"sbsl","transporte não regular","voo internacional",3,2,5,0,0,0,0,0,0,0
"5245",2014-07-01,"sbsn","transporte regular","voo doméstico",437,437,874,29587,26806,56393,0,0,0,0
"5246",2014-07-01,"sbsn","transporte regular","voo internacional",0,0,0,0,0,0,0,0,0,0
"5247",2014-07-01,"sbsn","transporte não regular","voo doméstico",371,370,741,654,441,1095,0,0,0,0
"5248",2014-07-01,"sbsn","transporte não regular","voo internacional",1,1,2,0,0,0,0,0,0,0
"5249",2014-07-01,"sbsp","transporte regular","voo doméstico",6169,6218,12387,718083,726895,1444978,0,0,0,0
"5250",2014-07-01,"sbsp","transporte regular","voo internacional",0,0,0,0,0,0,0,0,0,0
"5251",2014-07-01,"sbsp","transporte não regular","voo doméstico",2047,2009,4056,18068,15855,33923,0,0,0,0
"5252",2014-07-01,"sbsp","transporte não regular","voo internacional",0,0,0,0,0,0,0,0,0,0
"5253",2014-07-01,"sbte","transporte regular","voo doméstico",488,488,976,53714,51660,105374,36114,92045,128159,315692
"5254",2014-07-01,"sbte","transporte regular","voo internacional",0,0,0,0,0,0,0,0,0,0
"5255",2014-07-01,"sbte","transporte não regular","voo doméstico",366,368,734,1866,1940,3806,0,0,0,0
"5256",2014-07-01,"sbte","transporte não regular","voo internacional",0,0,0,0,0,0,0,0,0,0
"5257",2014-07-01,"sbtf","transporte regular","voo doméstico",66,67,133,3236,3410,6646,0,0,0,0
"5258",2014-07-01,"sbtf","transporte regular","voo internacional",0,0,0,0,0,0,0,0,0,0
"5259",2014-07-01,"sbtf","transporte não regular","voo doméstico",308,308,616,603,564,1167,2144,4878,7022,23334
"5260",2014-07-01,"sbtf","transporte não regular","voo internacional",0,0,0,0,0,0,0,0,0,0
"5261",2014-07-01,"sbtt","transporte regular","voo doméstico",35,35,70,2453,3247,5700,0,0,0,0
"5262",2014-07-01,"sbtt","transporte regular","voo internacional",0,0,0,0,0,0,0,0,0,0
"5263",2014-07-01,"sbtt","transporte não regular","voo doméstico",154,155,309,694,643,1337,1989,3460,5449,788
"5264",2014-07-01,"sbtt","transporte não regular","voo internacional",1,2,3,3,1,4,0,0,0,0
"5265",2014-07-01,"sbuf","transporte regular","voo doméstico",23,23,46,1367,1241,2608,0,0,0,0
"5266",2014-07-01,"sbuf","transporte regular","voo internacional",0,0,0,0,0,0,0,0,0,0
"5267",2014-07-01,"sbuf","transporte não regular","voo doméstico",66,64,130,187,157,344,0,0,0,0
"5268",2014-07-01,"sbuf","transporte não regular","voo internacional",0,0,0,0,0,0,0,0,0,0
"5269",2014-07-01,"sbug","transporte regular","voo doméstico",0,0,0,0,0,0,0,0,0,0
"5270",2014-07-01,"sbug","transporte regular","voo internacional",0,0,0,0,0,0,0,0,0,0
"5271",2014-07-01,"sbug","transporte não regular","voo doméstico",15,14,29,58,29,87,0,0,0,0
"5272",2014-07-01,"sbug","transporte não regular","voo internacional",0,1,1,0,0,0,0,0,0,0
"5273",2014-07-01,"sbul","transporte regular","voo doméstico",619,616,1235,45918,44462,90380,0,0,0,0
"5274",2014-07-01,"sbul","transporte regular","voo internacional",0,0,0,0,0,0,0,0,0,0
"5275",2014-07-01,"sbul","transporte não regular","voo doméstico",613,628,1241,1752,1431,3183,0,0,0,0
"5276",2014-07-01,"sbul","transporte não regular","voo internacional",3,4,7,23,15,38,0,0,0,0
"5277",2014-07-01,"sbur","transporte regular","voo doméstico",79,78,157,3509,3342,6851,0,0,0,0
"5278",2014-07-01,"sbur","transporte regular","voo internacional",0,0,0,0,0,0,0,0,0,0
"5279",2014-07-01,"sbur","transporte não regular","voo doméstico",291,291,582,3283,3262,6545,0,0,0,0
"5280",2014-07-01,"sbur","transporte não regular","voo internacional",1,1,2,0,0,0,0,0,0,0
"5281",2014-06-01,"sbbe","transporte regular","voo doméstico",1503,1505,3008,135550,137503,273053,39,0,39,0
"5282",2014-06-01,"sbbe","transporte regular","voo internacional",41,38,79,4128,4009,8137,0,7,7,0
"5283",2014-06-01,"sbbe","transporte não regular","voo doméstico",539,537,1076,2451,2570,5021,74950,339366,414316,0
"5284",2014-06-01,"sbbe","transporte não regular","voo internacional",21,20,41,16,44,60,0,0,0,0
"5285",2014-06-01,"sbbg","transporte regular","voo doméstico",0,0,0,0,0,0,0,0,0,0
"5286",2014-06-01,"sbbg","transporte regular","voo internacional",0,0,0,0,0,0,0,0,0,0
"5287",2014-06-01,"sbbg","transporte não regular","voo doméstico",14,14,28,58,57,115,0,0,0,0
"5288",2014-06-01,"sbbg","transporte não regular","voo internacional",1,1,2,0,4,4,0,0,0,0
"5289",2014-06-01,"sbbh","transporte regular","voo doméstico",503,505,1008,25330,28489,53819,0,0,0,0
"5290",2014-06-01,"sbbh","transporte regular","voo internacional",0,0,0,0,0,0,0,0,0,0
"5291",2014-06-01,"sbbh","transporte não regular","voo doméstico",2070,2068,4138,10815,10050,20865,0,0,0,0
"5292",2014-06-01,"sbbh","transporte não regular","voo internacional",29,29,58,162,169,331,0,0,0,0
"5293",2014-06-01,"sbbi","transporte regular","voo doméstico",0,0,0,0,0,0,0,0,0,0
"5294",2014-06-01,"sbbi","transporte regular","voo internacional",0,0,0,0,0,0,0,0,0,0
"5295",2014-06-01,"sbbi","transporte não regular","voo doméstico",1036,1053,2089,3850,4510,8360,0,0,0,0
"5296",2014-06-01,"sbbi","transporte não regular","voo internacional",7,6,13,0,0,0,0,0,0,0
"5297",2014-06-01,"sbbv","transporte regular","voo doméstico",111,113,224,12910,12541,25451,0,0,0,0
"5298",2014-06-01,"sbbv","transporte regular","voo internacional",0,0,0,0,0,0,0,0,0,0
"5299",2014-06-01,"sbbv","transporte não regular","voo doméstico",79,82,161,375,460,835,0,0,0,0
"5300",2014-06-01,"sbbv","transporte não regular","voo internacional",26,22,48,12,81,93,0,0,0,0
"5301",2014-06-01,"sbcg","transporte regular","voo doméstico",649,649,1298,62586,62544,125130,46599,76801,123400,0
"5302",2014-06-01,"sbcg","transporte regular","voo internacional",12,12,24,244,344,588,0,0,0,0
"5303",2014-06-01,"sbcg","transporte não regular","voo doméstico",295,298,593,334,368,702,20380,42325,62705,0
"5304",2014-06-01,"sbcg","transporte não regular","voo internacional",14,13,27,0,0,0,0,0,0,0
"5305",2014-06-01,"sbcj","transporte regular","voo doméstico",82,82,164,4652,4189,8841,0,0,0,0
"5306",2014-06-01,"sbcj","transporte regular","voo internacional",0,0,0,0,0,0,0,0,0,0
"5307",2014-06-01,"sbcj","transporte não regular","voo doméstico",130,130,260,913,991,1904,0,0,0,0
"5308",2014-06-01,"sbcj","transporte não regular","voo internacional",0,0,0,0,0,0,0,0,0,0
"5309",2014-06-01,"sbcr","transporte regular","voo doméstico",25,25,50,1361,1472,2833,0,0,0,0
"5310",2014-06-01,"sbcr","transporte regular","voo internacional",0,0,0,0,0,0,0,0,0,0
"5311",2014-06-01,"sbcr","transporte não regular","voo doméstico",42,42,84,145,132,277,0,0,0,0
"5312",2014-06-01,"sbcr","transporte não regular","voo internacional",7,7,14,13,13,26,0,0,0,0
"5313",2014-06-01,"sbct","transporte regular","voo doméstico",2591,2597,5188,271821,265952,537773,149175,0,149175,156861
"5314",2014-06-01,"sbct","transporte regular","voo internacional",128,126,254,6751,6276,13027,0,9051,9051,0
"5315",2014-06-01,"sbct","transporte não regular","voo doméstico",242,240,482,2699,2216,4915,0,0,0,0
"5316",2014-06-01,"sbct","transporte não regular","voo internacional",41,41,82,1514,582,2096,0,0,0,0
"5317",2014-06-01,"sbcz","transporte regular","voo doméstico",26,27,53,2155,2304,4459,0,0,0,0
"5318",2014-06-01,"sbcz","transporte regular","voo internacional",0,0,0,0,0,0,0,0,0,0
"5319",2014-06-01,"sbcz","transporte não regular","voo doméstico",211,210,421,789,701,1490,0,0,0,0
"5320",2014-06-01,"sbcz","transporte não regular","voo internacional",0,0,0,0,0,0,0,0,0,0
"5321",2014-06-01,"sbeg","transporte regular","voo doméstico",1215,1229,2444,125984,115264,241248,0,0,0,0
"5322",2014-06-01,"sbeg","transporte regular","voo internacional",124,124,248,8870,10358,19228,0,0,0,0
"5323",2014-06-01,"sbeg","transporte não regular","voo doméstico",772,750,1522,12928,12449,25377,0,0,0,0
"5324",2014-06-01,"sbeg","transporte não regular","voo internacional",183,195,378,1240,717,1957,0,0,0,0
"5325",2014-06-01,"sbfi","transporte regular","voo doméstico",547,538,1085,69791,67947,137738,0,0,0,0
"5326",2014-06-01,"sbfi","transporte regular","voo internacional",30,30,60,3050,3507,6557,0,0,0,0
"5327",2014-06-01,"sbfi","transporte não regular","voo doméstico",164,164,328,2222,2069,4291,0,0,0,0
"5328",2014-06-01,"sbfi","transporte não regular","voo internacional",71,80,151,175,201,376,0,0,0,0
"5329",2014-06-01,"sbgo","transporte regular","voo doméstico",1229,1215,2444,110841,115574,226415,111419,155118,266537,149606
"5330",2014-06-01,"sbgo","transporte regular","voo internacional",0,0,0,0,0,0,0,0,0,0
"5331",2014-06-01,"sbgo","transporte não regular","voo doméstico",1191,1200,2391,3932,4866,8798,0,0,0,0
"5332",2014-06-01,"sbgo","transporte não regular","voo internacional",2,2,4,0,0,0,0,0,0,0
"5333",2014-06-01,"sbht","transporte regular","voo doméstico",191,191,382,7329,7721,15050,0,0,0,0
"5334",2014-06-01,"sbht","transporte regular","voo internacional",0,0,0,0,0,0,0,0,0,0
"5335",2014-06-01,"sbht","transporte não regular","voo doméstico",153,151,304,546,524,1070,950,750,1700,290
"5336",2014-06-01,"sbht","transporte não regular","voo internacional",2,2,4,0,0,0,0,0,0,0
"5337",2014-06-01,"sbiz","transporte regular","voo doméstico",212,211,423,14217,14538,28755,0,0,0,0
"5338",2014-06-01,"sbiz","transporte regular","voo internacional",0,0,0,0,0,0,0,0,0,0
"5339",2014-06-01,"sbiz","transporte não regular","voo doméstico",169,176,345,498,530,1028,0,0,0,0
"5340",2014-06-01,"sbiz","transporte não regular","voo internacional",0,0,0,0,0,0,0,0,0,0
"5341",2014-06-01,"sbjc","transporte regular","voo doméstico",1,0,1,0,3,3,0,0,0,0
"5342",2014-06-01,"sbjc","transporte regular","voo internacional",0,0,0,0,0,0,0,0,0,0
"5343",2014-06-01,"sbjc","transporte não regular","voo doméstico",519,508,1027,1141,1012,2153,0,0,0,0
"5344",2014-06-01,"sbjc","transporte não regular","voo internacional",0,0,0,0,0,0,0,0,0,0
"5345",2014-06-01,"sbjr","transporte regular","voo doméstico",0,0,0,0,0,0,0,0,0,0
"5346",2014-06-01,"sbjr","transporte regular","voo internacional",0,0,0,0,0,0,0,0,0,0
"5347",2014-06-01,"sbjr","transporte não regular","voo doméstico",2947,2937,5884,8951,4912,13863,0,0,0,0
"5348",2014-06-01,"sbjr","transporte não regular","voo internacional",0,0,0,0,0,0,0,0,0,0
"5349",2014-06-01,"sbjv","transporte regular","voo doméstico",179,184,363,14902,14560,29462,0,0,0,0
"5350",2014-06-01,"sbjv","transporte regular","voo internacional",0,0,0,0,0,0,0,0,0,0
"5351",2014-06-01,"sbjv","transporte não regular","voo doméstico",234,233,467,202,1257,1459,0,0,0,0
"5352",2014-06-01,"sbjv","transporte não regular","voo internacional",0,0,0,0,0,0,0,0,0,0
"5353",2014-06-01,"sblo","transporte regular","voo doméstico",395,392,787,40640,39530,80170,0,0,0,0
"5354",2014-06-01,"sblo","transporte regular","voo internacional",0,0,0,0,0,0,0,0,0,0
"5355",2014-06-01,"sblo","transporte não regular","voo doméstico",718,719,1437,2844,2979,5823,0,0,0,0
"5356",2014-06-01,"sblo","transporte não regular","voo internacional",5,6,11,0,0,0,0,0,0,0
"5357",2014-06-01,"sbma","transporte regular","voo doméstico",310,312,622,17685,18460,36145,0,0,0,0
"5358",2014-06-01,"sbma","transporte regular","voo internacional",0,0,0,0,0,0,0,0,0,0
"5359",2014-06-01,"sbma","transporte não regular","voo doméstico",322,314,636,939,942,1881,0,0,0,0
"5360",2014-06-01,"sbma","transporte não regular","voo internacional",2,2,4,0,0,0,0,0,0,0
"5361",2014-06-01,"sbmk","transporte regular","voo doméstico",180,179,359,13285,13758,27043,0,0,0,0
"5362",2014-06-01,"sbmk","transporte regular","voo internacional",0,0,0,0,0,0,0,0,0,0
"5363",2014-06-01,"sbmk","transporte não regular","voo doméstico",311,317,628,11,5,16,0,0,0,0
"5364",2014-06-01,"sbmk","transporte não regular","voo internacional",0,0,0,0,0,0,0,0,0,0
"5365",2014-06-01,"sbmq","transporte regular","voo doméstico",308,305,613,28027,26515,54542,15160,37202,52362,0
"5366",2014-06-01,"sbmq","transporte regular","voo internacional",0,0,0,0,0,0,0,0,0,0
"5367",2014-06-01,"sbmq","transporte não regular","voo doméstico",192,197,389,265,249,514,0,0,0,0
"5368",2014-06-01,"sbmq","transporte não regular","voo internacional",6,2,8,0,0,0,0,0,0,0
"5369",2014-06-01,"sbmt","transporte regular","voo doméstico",0,0,0,0,0,0,0,0,0,0
"5370",2014-06-01,"sbmt","transporte regular","voo internacional",0,0,0,0,0,0,0,0,0,0
"5371",2014-06-01,"sbmt","transporte não regular","voo doméstico",4000,3987,7987,6627,5990,12617,0,0,0,0
"5372",2014-06-01,"sbmt","transporte não regular","voo internacional",0,0,0,0,0,0,0,0,0,0
"5373",2014-06-01,"sbnf","transporte regular","voo doméstico",482,485,967,41908,42405,84313,0,0,0,0
"5374",2014-06-01,"sbnf","transporte regular","voo internacional",0,0,0,0,0,0,0,0,0,0
"5375",2014-06-01,"sbnf","transporte não regular","voo doméstico",188,188,376,445,498,943,0,0,0,0
"5376",2014-06-01,"sbnf","transporte não regular","voo internacional",3,2,5,0,0,0,0,0,0,0
"5377",2014-06-01,"sbpb","transporte regular","voo doméstico",21,21,42,807,883,1690,0,0,0,0
"5378",2014-06-01,"sbpb","transporte regular","voo internacional",0,0,0,0,0,0,0,0,0,0
"5379",2014-06-01,"sbpb","transporte não regular","voo doméstico",92,92,184,201,190,391,0,0,0,0
"5380",2014-06-01,"sbpb","transporte não regular","voo internacional",0,0,0,0,0,0,0,0,0,0
"5381",2014-06-01,"sbpj","transporte regular","voo doméstico",336,337,673,24292,24758,49050,0,0,0,0
"5382",2014-06-01,"sbpj","transporte regular","voo internacional",0,0,0,0,0,0,0,0,0,0
"5383",2014-06-01,"sbpj","transporte não regular","voo doméstico",361,351,712,503,364,867,0,0,0,0
"5384",2014-06-01,"sbpj","transporte não regular","voo internacional",1,1,2,0,0,0,0,0,0,0
"5385",2014-06-01,"sbpk","transporte regular","voo doméstico",41,42,83,1686,1630,3316,0,0,0,0
"5386",2014-06-01,"sbpk","transporte regular","voo internacional",0,0,0,0,0,0,0,0,0,0
"5387",2014-06-01,"sbpk","transporte não regular","voo doméstico",50,51,101,145,160,305,0,0,0,0
"5388",2014-06-01,"sbpk","transporte não regular","voo internacional",8,7,15,15,11,26,0,0,0,0
"5389",2014-06-01,"sbpl","transporte regular","voo doméstico",190,188,378,18499,20366,38865,0,0,0,0
"5390",2014-06-01,"sbpl","transporte regular","voo internacional",3,3,6,0,0,0,0,0,0,0
"5391",2014-06-01,"sbpl","transporte não regular","voo doméstico",120,124,244,341,202,543,0,0,0,0
"5392",2014-06-01,"sbpl","transporte não regular","voo internacional",2,2,4,0,0,0,0,0,0,0
"5393",2014-06-01,"sbpp","transporte regular","voo doméstico",0,0,0,0,0,0,0,0,0,0
"5394",2014-06-01,"sbpp","transporte regular","voo internacional",0,0,0,0,0,0,0,0,0,0
"5395",2014-06-01,"sbpp","transporte não regular","voo doméstico",84,81,165,162,173,335,0,0,0,0
"5396",2014-06-01,"sbpp","transporte não regular","voo internacional",6,7,13,10,8,18,0,0,0,0
"5397",2014-06-01,"sbpr","transporte regular","voo doméstico",0,0,0,0,0,0,0,0,0,0
"5398",2014-06-01,"sbpr","transporte regular","voo internacional",0,0,0,0,0,0,0,0,0,0
"5399",2014-06-01,"sbpr","transporte não regular","voo doméstico",1029,1038,2067,1240,1223,2463,0,0,0,0
"5400",2014-06-01,"sbpr","transporte não regular","voo internacional",1,1,2,0,0,0,0,0,0,0
"5401",2014-06-01,"sbpv","transporte regular","voo doméstico",396,397,793,32591,31338,63929,50200,205244,255444,0
"5402",2014-06-01,"sbpv","transporte regular","voo internacional",0,0,0,0,0,0,0,0,0,0
"5403",2014-06-01,"sbpv","transporte não regular","voo doméstico",272,272,544,38,0,38,0,0,0,0
"5404",2014-06-01,"sbpv","transporte não regular","voo internacional",3,3,6,0,0,0,0,0,0,0
"5405",2014-06-01,"sbrb","transporte regular","voo doméstico",153,152,305,13918,14543,28461,0,0,0,0
"5406",2014-06-01,"sbrb","transporte regular","voo internacional",0,0,0,0,0,0,0,0,0,0
"5407",2014-06-01,"sbrb","transporte não regular","voo doméstico",259,262,521,826,560,1386,0,0,0,0
"5408",2014-06-01,"sbrb","transporte não regular","voo internacional",2,2,4,0,0,0,0,0,0,0
"5409",2014-06-01,"sbrj","transporte regular","voo doméstico",3609,3626,7235,352544,347115,699659,0,0,0,0
"5410",2014-06-01,"sbrj","transporte regular","voo internacional",0,0,0,0,0,0,0,0,0,0
"5411",2014-06-01,"sbrj","transporte não regular","voo doméstico",834,816,1650,2599,3262,5861,0,0,0,0
"5412",2014-06-01,"sbrj","transporte não regular","voo internacional",19,18,37,0,0,0,0,0,0,0
"5413",2014-06-01,"sbsj","transporte regular","voo doméstico",56,55,111,2794,3194,5988,0,0,0,0
"5414",2014-06-01,"sbsj","transporte regular","voo internacional",0,0,0,0,0,0,0,0,0,0
"5415",2014-06-01,"sbsj","transporte não regular","voo doméstico",460,452,912,871,628,1499,0,0,0,0
"5416",2014-06-01,"sbsj","transporte não regular","voo internacional",9,16,25,28,26,54,0,0,0,0
"5417",2014-06-01,"sbsl","transporte regular","voo doméstico",641,651,1292,67876,71205,139081,1943,0,1943,0
"5418",2014-06-01,"sbsl","transporte regular","voo internacional",0,0,0,0,0,0,0,0,0,0
"5419",2014-06-01,"sbsl","transporte não regular","voo doméstico",318,304,622,749,1420,2169,86340,183618,269958,0
"5420",2014-06-01,"sbsl","transporte não regular","voo internacional",1,0,1,0,0,0,0,0,0,0
"5421",2014-06-01,"sbsn","transporte regular","voo doméstico",402,402,804,21947,19759,41706,0,0,0,0
"5422",2014-06-01,"sbsn","transporte regular","voo internacional",0,0,0,0,0,0,0,0,0,0
"5423",2014-06-01,"sbsn","transporte não regular","voo doméstico",320,318,638,491,396,887,0,0,0,0
"5424",2014-06-01,"sbsn","transporte não regular","voo internacional",0,0,0,0,0,0,0,0,0,0
"5425",2014-06-01,"sbsp","transporte regular","voo doméstico",5189,5246,10435,620180,586023,1206203,0,0,0,0
"5426",2014-06-01,"sbsp","transporte regular","voo internacional",0,0,0,0,0,0,0,0,0,0
"5427",2014-06-01,"sbsp","transporte não regular","voo doméstico",2140,2080,4220,17059,12588,29647,0,0,0,0
"5428",2014-06-01,"sbsp","transporte não regular","voo internacional",0,0,0,0,0,0,0,0,0,0
"5429",2014-06-01,"sbte","transporte regular","voo doméstico",449,449,898,42053,47760,89813,28791,81676,110467,248248
"5430",2014-06-01,"sbte","transporte regular","voo internacional",0,0,0,0,0,0,0,0,0,0
"5431",2014-06-01,"sbte","transporte não regular","voo doméstico",331,331,662,1927,2059,3986,0,0,0,0
"5432",2014-06-01,"sbte","transporte não regular","voo internacional",1,1,2,0,0,0,0,0,0,0
"5433",2014-06-01,"sbtf","transporte regular","voo doméstico",61,64,125,2853,2763,5616,0,0,0,0
"5434",2014-06-01,"sbtf","transporte regular","voo internacional",0,0,0,0,0,0,0,0,0,0
"5435",2014-06-01,"sbtf","transporte não regular","voo doméstico",229,225,454,523,614,1137,1810,4108,5918,20842
"5436",2014-06-01,"sbtf","transporte não regular","voo internacional",0,0,0,0,0,0,0,0,0,0
"5437",2014-06-01,"sbtt","transporte regular","voo doméstico",30,31,61,2784,2788,5572,0,0,0,0
"5438",2014-06-01,"sbtt","transporte regular","voo internacional",0,0,0,0,0,0,0,0,0,0
"5439",2014-06-01,"sbtt","transporte não regular","voo doméstico",127,126,253,540,548,1088,1772,2512,4284,611
"5440",2014-06-01,"sbtt","transporte não regular","voo internacional",5,6,11,24,21,45,0,0,0,0
"5441",2014-06-01,"sbuf","transporte regular","voo doméstico",19,21,40,1054,1069,2123,0,0,0,0
"5442",2014-06-01,"sbuf","transporte regular","voo internacional",0,0,0,0,0,0,0,0,0,0
"5443",2014-06-01,"sbuf","transporte não regular","voo doméstico",48,51,99,357,466,823,0,0,0,0
"5444",2014-06-01,"sbuf","transporte não regular","voo internacional",0,0,0,0,0,0,0,0,0,0
"5445",2014-06-01,"sbug","transporte regular","voo doméstico",0,0,0,0,0,0,0,0,0,0
"5446",2014-06-01,"sbug","transporte regular","voo internacional",0,0,0,0,0,0,0,0,0,0
"5447",2014-06-01,"sbug","transporte não regular","voo doméstico",18,17,35,30,41,71,0,0,0,0
"5448",2014-06-01,"sbug","transporte não regular","voo internacional",2,3,5,0,0,0,0,0,0,0
"5449",2014-06-01,"sbul","transporte regular","voo doméstico",570,567,1137,40982,41319,82301,0,0,0,0
"5450",2014-06-01,"sbul","transporte regular","voo internacional",0,0,0,0,0,0,0,0,0,0
"5451",2014-06-01,"sbul","transporte não regular","voo doméstico",621,616,1237,1260,1184,2444,0,0,0,0
"5452",2014-06-01,"sbul","transporte não regular","voo internacional",1,0,1,0,5,5,0,0,0,0
"5453",2014-06-01,"sbur","transporte regular","voo doméstico",72,73,145,3242,3102,6344,0,0,0,0
"5454",2014-06-01,"sbur","transporte regular","voo internacional",0,0,0,0,0,0,0,0,0,0
"5455",2014-06-01,"sbur","transporte não regular","voo doméstico",255,261,516,3228,3063,6291,0,0,0,0
"5456",2014-06-01,"sbur","transporte não regular","voo internacional",1,1,2,0,0,0,0,0,0,0
"5457",2014-05-01,"sbbe","transporte regular","voo doméstico",1628,1632,3260,150475,147052,297527,8,0,8,0
"5458",2014-05-01,"sbbe","transporte regular","voo internacional",27,26,53,2697,3182,5879,0,132,132,0
"5459",2014-05-01,"sbbe","transporte não regular","voo doméstico",566,564,1130,2739,2974,5713,87974,399573,487547,0
"5460",2014-05-01,"sbbe","transporte não regular","voo internacional",9,7,16,16,16,32,0,0,0,0
"5461",2014-05-01,"sbbg","transporte regular","voo doméstico",0,0,0,0,0,0,0,0,0,0
"5462",2014-05-01,"sbbg","transporte regular","voo internacional",0,0,0,0,0,0,0,0,0,0
"5463",2014-05-01,"sbbg","transporte não regular","voo doméstico",17,17,34,60,61,121,0,0,0,0
"5464",2014-05-01,"sbbg","transporte não regular","voo internacional",2,3,5,10,4,14,0,0,0,0
"5465",2014-05-01,"sbbh","transporte regular","voo doméstico",536,547,1083,26384,30222,56606,0,0,0,0
"5466",2014-05-01,"sbbh","transporte regular","voo internacional",0,0,0,0,0,0,0,0,0,0
"5467",2014-05-01,"sbbh","transporte não regular","voo doméstico",2395,2393,4788,10711,10812,21523,0,0,0,0
"5468",2014-05-01,"sbbh","transporte não regular","voo internacional",24,24,48,96,96,192,0,0,0,0
"5469",2014-05-01,"sbbi","transporte regular","voo doméstico",0,0,0,0,0,0,0,0,0,0
"5470",2014-05-01,"sbbi","transporte regular","voo internacional",0,0,0,0,0,0,0,0,0,0
"5471",2014-05-01,"sbbi","transporte não regular","voo doméstico",1562,1566,3128,5395,5016,10411,0,0,0,0
"5472",2014-05-01,"sbbi","transporte não regular","voo internacional",5,5,10,0,0,0,0,0,0,0
"5473",2014-05-01,"sbbv","transporte regular","voo doméstico",132,132,264,14503,14684,29187,0,0,0,0
"5474",2014-05-01,"sbbv","transporte regular","voo internacional",1,1,2,0,0,0,0,0,0,0
"5475",2014-05-01,"sbbv","transporte não regular","voo doméstico",93,98,191,304,140,444,0,0,0,0
"5476",2014-05-01,"sbbv","transporte não regular","voo internacional",25,18,43,0,10,10,0,0,0,0
"5477",2014-05-01,"sbcg","transporte regular","voo doméstico",678,672,1350,70922,68029,138951,2156,30201,32357,0
"5478",2014-05-01,"sbcg","transporte regular","voo internacional",0,0,0,0,0,0,0,0,0,0
"5479",2014-05-01,"sbcg","transporte não regular","voo doméstico",404,406,810,1610,1694,3304,73052,130644,203696,0
"5480",2014-05-01,"sbcg","transporte não regular","voo internacional",14,14,28,0,0,0,0,0,0,0
"5481",2014-05-01,"sbcj","transporte regular","voo doméstico",94,95,189,4773,4286,9059,0,0,0,0
"5482",2014-05-01,"sbcj","transporte regular","voo internacional",0,0,0,0,0,0,0,0,0,0
"5483",2014-05-01,"sbcj","transporte não regular","voo doméstico",96,95,191,1342,1163,2505,0,0,0,0
"5484",2014-05-01,"sbcj","transporte não regular","voo internacional",0,0,0,0,0,0,0,0,0,0
"5485",2014-05-01,"sbcr","transporte regular","voo doméstico",26,26,52,1534,1544,3078,0,0,0,0
"5486",2014-05-01,"sbcr","transporte regular","voo internacional",0,0,0,0,0,0,0,0,0,0
"5487",2014-05-01,"sbcr","transporte não regular","voo doméstico",41,41,82,110,76,186,0,0,0,0
"5488",2014-05-01,"sbcr","transporte não regular","voo internacional",4,5,9,11,6,17,0,0,0,0
"5489",2014-05-01,"sbct","transporte regular","voo doméstico",2897,2930,5827,304478,303828,608306,119920,0,119920,126661
"5490",2014-05-01,"sbct","transporte regular","voo internacional",138,136,274,5842,6263,12105,0,0,0,0
"5491",2014-05-01,"sbct","transporte não regular","voo doméstico",241,213,454,1075,3066,4141,0,0,0,0
"5492",2014-05-01,"sbct","transporte não regular","voo internacional",16,17,33,77,105,182,0,0,0,0
"5493",2014-05-01,"sbcz","transporte regular","voo doméstico",31,31,62,2804,2504,5308,0,0,0,0
"5494",2014-05-01,"sbcz","transporte regular","voo internacional",0,0,0,0,0,0,0,0,0,0
"5495",2014-05-01,"sbcz","transporte não regular","voo doméstico",158,162,320,553,539,1092,0,0,0,0
"5496",2014-05-01,"sbcz","transporte não regular","voo internacional",1,1,2,0,0,0,0,0,0,0
"5497",2014-05-01,"sbeg","transporte regular","voo doméstico",1273,1253,2526,116149,112852,229001,0,0,0,0
"5498",2014-05-01,"sbeg","transporte regular","voo internacional",117,123,240,7972,9258,17230,0,0,0,0
"5499",2014-05-01,"sbeg","transporte não regular","voo doméstico",697,697,1394,8099,8418,16517,0,0,0,0
"5500",2014-05-01,"sbeg","transporte não regular","voo internacional",128,134,262,529,551,1080,0,0,0,0
"5501",2014-05-01,"sbfi","transporte regular","voo doméstico",580,564,1144,68396,69884,138280,0,0,0,0
"5502",2014-05-01,"sbfi","transporte regular","voo internacional",31,31,62,3409,3915,7324,0,0,0,0
"5503",2014-05-01,"sbfi","transporte não regular","voo doméstico",182,194,376,4621,3444,8065,0,0,0,0
"5504",2014-05-01,"sbfi","transporte não regular","voo internacional",49,51,100,42,57,99,0,0,0,0
"5505",2014-05-01,"sbgo","transporte regular","voo doméstico",1398,1399,2797,138082,139956,278038,123413,182369,305782,196336
"5506",2014-05-01,"sbgo","transporte regular","voo internacional",0,0,0,0,0,0,0,0,0,0
"5507",2014-05-01,"sbgo","transporte não regular","voo doméstico",1703,1700,3403,5351,6178,11529,923,0,923,0
"5508",2014-05-01,"sbgo","transporte não regular","voo internacional",6,7,13,0,0,0,0,0,0,0
"5509",2014-05-01,"sbht","transporte regular","voo doméstico",171,171,342,7421,8570,15991,0,0,0,0
"5510",2014-05-01,"sbht","transporte regular","voo internacional",0,0,0,0,0,0,0,0,0,0
"5511",2014-05-01,"sbht","transporte não regular","voo doméstico",192,194,386,676,590,1266,1108,2235,3343,585
"5512",2014-05-01,"sbht","transporte não regular","voo internacional",1,1,2,0,0,0,0,0,0,0
"5513",2014-05-01,"sbiz","transporte regular","voo doméstico",227,227,454,14726,14595,29321,0,0,0,0
"5514",2014-05-01,"sbiz","transporte regular","voo internacional",0,0,0,0,0,0,0,0,0,0
"5515",2014-05-01,"sbiz","transporte não regular","voo doméstico",166,161,327,432,421,853,0,0,0,0
"5516",2014-05-01,"sbiz","transporte não regular","voo internacional",1,0,1,0,0,0,0,0,0,0
"5517",2014-05-01,"sbjc","transporte regular","voo doméstico",0,0,0,0,0,0,0,0,0,0
"5518",2014-05-01,"sbjc","transporte regular","voo internacional",0,0,0,0,0,0,0,0,0,0
"5519",2014-05-01,"sbjc","transporte não regular","voo doméstico",476,475,951,1167,996,2163,0,0,0,0
"5520",2014-05-01,"sbjc","transporte não regular","voo internacional",0,0,0,0,0,0,0,0,0,0
"5521",2014-05-01,"sbjr","transporte regular","voo doméstico",0,0,0,0,0,0,0,0,0,0
"5522",2014-05-01,"sbjr","transporte regular","voo internacional",0,0,0,0,0,0,0,0,0,0
"5523",2014-05-01,"sbjr","transporte não regular","voo doméstico",3440,3447,6887,9033,4842,13875,0,0,0,0
"5524",2014-05-01,"sbjr","transporte não regular","voo internacional",0,0,0,0,0,0,0,0,0,0
"5525",2014-05-01,"sbjv","transporte regular","voo doméstico",227,226,453,19740,18915,38655,0,0,0,0
"5526",2014-05-01,"sbjv","transporte regular","voo internacional",0,0,0,0,0,0,0,0,0,0
"5527",2014-05-01,"sbjv","transporte não regular","voo doméstico",336,336,672,98,221,319,0,0,0,0
"5528",2014-05-01,"sbjv","transporte não regular","voo internacional",0,0,0,0,0,0,0,0,0,0
"5529",2014-05-01,"sblo","transporte regular","voo doméstico",445,445,890,45990,45752,91742,0,0,0,0
"5530",2014-05-01,"sblo","transporte regular","voo internacional",0,0,0,0,0,0,0,0,0,0
"5531",2014-05-01,"sblo","transporte não regular","voo doméstico",761,753,1514,2499,3045,5544,0,0,0,0
"5532",2014-05-01,"sblo","transporte não regular","voo internacional",4,3,7,0,0,0,0,0,0,0
"5533",2014-05-01,"sbma","transporte regular","voo doméstico",334,336,670,20645,19676,40321,0,0,0,0
"5534",2014-05-01,"sbma","transporte regular","voo internacional",0,0,0,0,0,0,0,0,0,0
"5535",2014-05-01,"sbma","transporte não regular","voo doméstico",314,311,625,936,896,1832,0,0,0,0
"5536",2014-05-01,"sbma","transporte não regular","voo internacional",0,0,0,0,0,0,0,0,0,0
"5537",2014-05-01,"sbmk","transporte regular","voo doméstico",187,188,375,13778,13571,27349,0,0,0,0
"5538",2014-05-01,"sbmk","transporte regular","voo internacional",0,0,0,0,0,0,0,0,0,0
"5539",2014-05-01,"sbmk","transporte não regular","voo doméstico",326,322,648,17,34,51,0,0,0,0
"5540",2014-05-01,"sbmk","transporte não regular","voo internacional",0,1,1,0,0,0,0,0,0,0
"5541",2014-05-01,"sbmq","transporte regular","voo doméstico",330,330,660,29821,30096,59917,11550,25070,36620,0
"5542",2014-05-01,"sbmq","transporte regular","voo internacional",0,0,0,0,0,0,0,0,0,0
"5543",2014-05-01,"sbmq","transporte não regular","voo doméstico",229,228,457,840,572,1412,0,0,0,0
"5544",2014-05-01,"sbmq","transporte não regular","voo internacional",5,7,12,0,0,0,0,0,0,0
"5545",2014-05-01,"sbmt","transporte regular","voo doméstico",0,0,0,0,0,0,0,0,0,0
"5546",2014-05-01,"sbmt","transporte regular","voo internacional",0,0,0,0,0,0,0,0,0,0
"5547",2014-05-01,"sbmt","transporte não regular","voo doméstico",5341,5382,10723,8669,7833,16502,0,0,0,0
"5548",2014-05-01,"sbmt","transporte não regular","voo internacional",0,0,0,0,0,0,0,0,0,0
"5549",2014-05-01,"sbnf","transporte regular","voo doméstico",553,554,1107,55563,53837,109400,0,0,0,0
"5550",2014-05-01,"sbnf","transporte regular","voo internacional",0,0,0,0,0,0,0,0,0,0
"5551",2014-05-01,"sbnf","transporte não regular","voo doméstico",262,260,522,845,941,1786,0,0,0,0
"5552",2014-05-01,"sbnf","transporte não regular","voo internacional",5,3,8,0,2,2,0,0,0,0
"5553",2014-05-01,"sbpb","transporte regular","voo doméstico",23,23,46,993,997,1990,0,0,0,0
"5554",2014-05-01,"sbpb","transporte regular","voo internacional",0,0,0,0,0,0,0,0,0,0
"5555",2014-05-01,"sbpb","transporte não regular","voo doméstico",72,70,142,171,178,349,0,0,0,0
"5556",2014-05-01,"sbpb","transporte não regular","voo internacional",0,0,0,0,0,0,0,0,0,0
"5557",2014-05-01,"sbpj","transporte regular","voo doméstico",343,341,684,28298,27943,56241,0,0,0,0
"5558",2014-05-01,"sbpj","transporte regular","voo internacional",0,0,0,0,0,0,0,0,0,0
"5559",2014-05-01,"sbpj","transporte não regular","voo doméstico",369,376,745,759,455,1214,0,0,0,0
"5560",2014-05-01,"sbpj","transporte não regular","voo internacional",4,3,7,0,0,0,0,0,0,0
"5561",2014-05-01,"sbpk","transporte regular","voo doméstico",43,43,86,2138,2022,4160,0,0,0,0
"5562",2014-05-01,"sbpk","transporte regular","voo internacional",0,0,0,0,0,0,0,0,0,0
"5563",2014-05-01,"sbpk","transporte não regular","voo doméstico",41,39,80,72,134,206,0,0,0,0
"5564",2014-05-01,"sbpk","transporte não regular","voo internacional",3,4,7,8,7,15,0,0,0,0
"5565",2014-05-01,"sbpl","transporte regular","voo doméstico",202,196,398,20208,20970,41178,0,0,0,0
"5566",2014-05-01,"sbpl","transporte regular","voo internacional",2,2,4,0,0,0,0,0,0,0
"5567",2014-05-01,"sbpl","transporte não regular","voo doméstico",126,130,256,891,117,1008,0,0,0,0
"5568",2014-05-01,"sbpl","transporte não regular","voo internacional",0,0,0,0,0,0,0,0,0,0
"5569",2014-05-01,"sbpp","transporte regular","voo doméstico",0,0,0,0,0,0,0,0,0,0
"5570",2014-05-01,"sbpp","transporte regular","voo internacional",0,0,0,0,0,0,0,0,0,0
"5571",2014-05-01,"sbpp","transporte não regular","voo doméstico",87,90,177,156,150,306,0,0,0,0
"5572",2014-05-01,"sbpp","transporte não regular","voo internacional",7,6,13,14,9,23,0,0,0,0
"5573",2014-05-01,"sbpr","transporte regular","voo doméstico",0,0,0,0,0,0,0,0,0,0
"5574",2014-05-01,"sbpr","transporte regular","voo internacional",0,0,0,0,0,0,0,0,0,0
"5575",2014-05-01,"sbpr","transporte não regular","voo doméstico",2061,2069,4130,2431,2232,4663,0,0,0,0
"5576",2014-05-01,"sbpr","transporte não regular","voo internacional",0,0,0,0,0,0,0,0,0,0
"5577",2014-05-01,"sbpv","transporte regular","voo doméstico",426,425,851,34948,34977,69925,47626,206195,253821,0
"5578",2014-05-01,"sbpv","transporte regular","voo internacional",0,0,0,0,0,0,0,0,0,0
"5579",2014-05-01,"sbpv","transporte não regular","voo doméstico",309,313,622,324,300,624,0,0,0,0
"5580",2014-05-01,"sbpv","transporte não regular","voo internacional",1,1,2,0,0,0,0,0,0,0
"5581",2014-05-01,"sbrb","transporte regular","voo doméstico",162,162,324,16445,16869,33314,0,0,0,0
"5582",2014-05-01,"sbrb","transporte regular","voo internacional",0,0,0,0,0,0,0,0,0,0
"5583",2014-05-01,"sbrb","transporte não regular","voo doméstico",267,265,532,723,423,1146,0,0,0,0
"5584",2014-05-01,"sbrb","transporte não regular","voo internacional",1,1,2,0,0,0,0,0,0,0
"5585",2014-05-01,"sbrj","transporte regular","voo doméstico",4218,4231,8449,404394,396938,801332,0,0,0,0
"5586",2014-05-01,"sbrj","transporte regular","voo internacional",0,0,0,0,0,0,0,0,0,0
"5587",2014-05-01,"sbrj","transporte não regular","voo doméstico",1027,1020,2047,1477,1456,2933,0,0,0,0
"5588",2014-05-01,"sbrj","transporte não regular","voo internacional",8,8,16,0,0,0,0,0,0,0
"5589",2014-05-01,"sbsj","transporte regular","voo doméstico",52,52,104,3215,3164,6379,0,0,0,0
"5590",2014-05-01,"sbsj","transporte regular","voo internacional",0,0,0,0,0,0,0,0,0,0
"5591",2014-05-01,"sbsj","transporte não regular","voo doméstico",590,570,1160,1331,1285,2616,0,0,0,0
"5592",2014-05-01,"sbsj","transporte não regular","voo internacional",8,18,26,81,36,117,0,0,0,0
"5593",2014-05-01,"sbsl","transporte regular","voo doméstico",689,715,1404,73238,72712,145950,0,0,0,0
"5594",2014-05-01,"sbsl","transporte regular","voo internacional",0,0,0,0,0,0,0,0,0,0
"5595",2014-05-01,"sbsl","transporte não regular","voo doméstico",327,304,631,2331,4518,6849,104092,226247,330339,0
"5596",2014-05-01,"sbsl","transporte não regular","voo internacional",3,2,5,36,36,72,0,0,0,0
"5597",2014-05-01,"sbsn","transporte regular","voo doméstico",419,418,837,22118,20927,43045,0,0,0,0
"5598",2014-05-01,"sbsn","transporte regular","voo internacional",0,0,0,0,0,0,0,0,0,0
"5599",2014-05-01,"sbsn","transporte não regular","voo doméstico",301,304,605,828,580,1408,0,0,0,0
"5600",2014-05-01,"sbsn","transporte não regular","voo internacional",8,9,17,0,0,0,0,0,0,0
"5601",2014-05-01,"sbsp","transporte regular","voo doméstico",6479,6516,12995,744374,737546,1481920,0,0,0,0
"5602",2014-05-01,"sbsp","transporte regular","voo internacional",0,0,0,0,0,0,0,0,0,0
"5603",2014-05-01,"sbsp","transporte não regular","voo doméstico",2153,2089,4242,9703,8733,18436,0,0,0,0
"5604",2014-05-01,"sbsp","transporte não regular","voo internacional",0,0,0,0,0,0,0,0,0,0
"5605",2014-05-01,"sbte","transporte regular","voo doméstico",442,443,885,47082,46090,93172,28889,104582,133471,243549
"5606",2014-05-01,"sbte","transporte regular","voo internacional",0,0,0,0,0,0,0,0,0,0
"5607",2014-05-01,"sbte","transporte não regular","voo doméstico",325,321,646,1663,2014,3677,0,0,0,0
"5608",2014-05-01,"sbte","transporte não regular","voo internacional",1,1,2,0,0,0,0,0,0,0
"5609",2014-05-01,"sbtf","transporte regular","voo doméstico",69,72,141,2910,2920,5830,0,0,0,0
"5610",2014-05-01,"sbtf","transporte regular","voo internacional",0,0,0,0,0,0,0,0,0,0
"5611",2014-05-01,"sbtf","transporte não regular","voo doméstico",288,287,575,767,782,1549,2329,3822,6151,24627
"5612",2014-05-01,"sbtf","transporte não regular","voo internacional",0,0,0,0,0,0,0,0,0,0
"5613",2014-05-01,"sbtt","transporte regular","voo doméstico",33,32,65,2309,2623,4932,0,0,0,0
"5614",2014-05-01,"sbtt","transporte regular","voo internacional",0,0,0,0,0,0,0,0,0,0
"5615",2014-05-01,"sbtt","transporte não regular","voo doméstico",139,140,279,766,575,1341,1616,2859,4475,606
"5616",2014-05-01,"sbtt","transporte não regular","voo internacional",3,0,3,0,9,9,0,0,0,0
"5617",2014-05-01,"sbuf","transporte regular","voo doméstico",20,20,40,1046,1044,2090,0,0,0,0
"5618",2014-05-01,"sbuf","transporte regular","voo internacional",0,0,0,0,0,0,0,0,0,0
"5619",2014-05-01,"sbuf","transporte não regular","voo doméstico",41,39,80,142,134,276,0,0,0,0
"5620",2014-05-01,"sbuf","transporte não regular","voo internacional",0,0,0,0,0,0,0,0,0,0
"5621",2014-05-01,"sbug","transporte regular","voo doméstico",0,0,0,0,0,0,0,0,0,0
"5622",2014-05-01,"sbug","transporte regular","voo internacional",0,0,0,0,0,0,0,0,0,0
"5623",2014-05-01,"sbug","transporte não regular","voo doméstico",27,27,54,27,21,48,0,0,0,0
"5624",2014-05-01,"sbug","transporte não regular","voo internacional",3,3,6,1,1,2,0,0,0,0
"5625",2014-05-01,"sbul","transporte regular","voo doméstico",588,589,1177,48651,48455,97106,0,0,0,0
"5626",2014-05-01,"sbul","transporte regular","voo internacional",0,0,0,0,0,0,0,0,0,0
"5627",2014-05-01,"sbul","transporte não regular","voo doméstico",834,831,1665,1756,1723,3479,0,0,0,0
"5628",2014-05-01,"sbul","transporte não regular","voo internacional",3,2,5,16,12,28,0,0,0,0
"5629",2014-05-01,"sbur","transporte regular","voo doméstico",80,80,160,4446,4326,8772,0,0,0,0
"5630",2014-05-01,"sbur","transporte regular","voo internacional",0,0,0,0,0,0,0,0,0,0
"5631",2014-05-01,"sbur","transporte não regular","voo doméstico",472,475,947,3132,2824,5956,0,0,0,0
"5632",2014-05-01,"sbur","transporte não regular","voo internacional",2,2,4,0,0,0,0,0,0,0
"5633",2014-03-01,"sbbe","transporte regular","voo doméstico",1605,1604,3209,135965,135107,271072,0,20778,20778,0
"5634",2014-03-01,"sbbe","transporte regular","voo internacional",27,27,54,3079,2967,6046,0,51,51,0
"5635",2014-03-01,"sbbe","transporte não regular","voo doméstico",538,540,1078,4083,3854,7937,84062,353794,437856,0
"5636",2014-03-01,"sbbe","transporte não regular","voo internacional",15,16,31,52,32,84,0,0,0,0
"5637",2014-03-01,"sbbg","transporte regular","voo doméstico",0,0,0,0,0,0,0,0,0,0
"5638",2014-03-01,"sbbg","transporte regular","voo internacional",0,0,0,0,0,0,0,0,0,0
"5639",2014-03-01,"sbbg","transporte não regular","voo doméstico",28,30,58,73,65,138,0,0,0,0
"5640",2014-03-01,"sbbg","transporte não regular","voo internacional",1,0,1,0,7,7,0,0,0,0
"5641",2014-03-01,"sbbh","transporte regular","voo doméstico",507,508,1015,25302,28013,53315,0,0,0,0
"5642",2014-03-01,"sbbh","transporte regular","voo internacional",0,0,0,0,0,0,0,0,0,0
"5643",2014-03-01,"sbbh","transporte não regular","voo doméstico",1977,1957,3934,9230,9197,18427,0,0,0,0
"5644",2014-03-01,"sbbh","transporte não regular","voo internacional",3,3,6,20,20,40,0,0,0,0
"5645",2014-03-01,"sbbi","transporte regular","voo doméstico",0,0,0,0,0,0,0,0,0,0
"5646",2014-03-01,"sbbi","transporte regular","voo internacional",0,0,0,0,0,0,0,0,0,0
"5647",2014-03-01,"sbbi","transporte não regular","voo doméstico",1347,1341,2688,5371,5136,10507,0,0,0,0
"5648",2014-03-01,"sbbi","transporte não regular","voo internacional",0,0,0,0,0,0,0,0,0,0
"5649",2014-03-01,"sbbv","transporte regular","voo doméstico",130,130,260,14295,15206,29501,0,0,0,0
"5650",2014-03-01,"sbbv","transporte regular","voo internacional",0,0,0,0,0,0,0,0,0,0
"5651",2014-03-01,"sbbv","transporte não regular","voo doméstico",149,159,308,288,131,419,0,0,0,0
"5652",2014-03-01,"sbbv","transporte não regular","voo internacional",19,5,24,4,2,6,0,0,0,0
"5653",2014-03-01,"sbcg","transporte regular","voo doméstico",652,655,1307,62769,61099,123868,67855,129379,197234,0
"5654",2014-03-01,"sbcg","transporte regular","voo internacional",0,0,0,0,0,0,0,0,0,0
"5655",2014-03-01,"sbcg","transporte não regular","voo doméstico",360,358,718,1016,1498,2514,3082,0,3082,0
"5656",2014-03-01,"sbcg","transporte não regular","voo internacional",5,7,12,0,0,0,0,0,0,0
"5657",2014-03-01,"sbcj","transporte regular","voo doméstico",99,99,198,3966,4181,8147,0,0,0,0
"5658",2014-03-01,"sbcj","transporte regular","voo internacional",0,0,0,0,0,0,0,0,0,0
"5659",2014-03-01,"sbcj","transporte não regular","voo doméstico",104,103,207,1227,1355,2582,0,0,0,0
"5660",2014-03-01,"sbcj","transporte não regular","voo internacional",1,1,2,0,0,0,0,0,0,0
"5661",2014-03-01,"sbcr","transporte regular","voo doméstico",25,25,50,1248,1316,2564,0,0,0,0
"5662",2014-03-01,"sbcr","transporte regular","voo internacional",0,0,0,0,0,0,0,0,0,0
"5663",2014-03-01,"sbcr","transporte não regular","voo doméstico",32,32,64,61,56,117,0,0,0,0
"5664",2014-03-01,"sbcr","transporte não regular","voo internacional",2,3,5,8,3,11,0,0,0,0
"5665",2014-03-01,"sbct","transporte regular","voo doméstico",2936,2944,5880,297350,291672,589022,208533,0,208533,180444
"5666",2014-03-01,"sbct","transporte regular","voo internacional",138,138,276,5661,6204,11865,0,10671,10671,0
"5667",2014-03-01,"sbct","transporte não regular","voo doméstico",222,217,439,917,1067,1984,0,0,0,0
"5668",2014-03-01,"sbct","transporte não regular","voo internacional",24,19,43,178,259,437,0,0,0,0
"5669",2014-03-01,"sbcz","transporte regular","voo doméstico",31,31,62,2689,2422,5111,0,0,0,0
"5670",2014-03-01,"sbcz","transporte regular","voo internacional",0,0,0,0,0,0,0,0,0,0
"5671",2014-03-01,"sbcz","transporte não regular","voo doméstico",96,95,191,438,357,795,0,0,0,0
"5672",2014-03-01,"sbcz","transporte não regular","voo internacional",0,0,0,0,0,0,0,0,0,0
"5673",2014-03-01,"sbeg","transporte regular","voo doméstico",1291,1280,2571,111963,112375,224338,0,1969,1969,0
"5674",2014-03-01,"sbeg","transporte regular","voo internacional",118,122,240,8269,9138,17407,0,0,0,0
"5675",2014-03-01,"sbeg","transporte não regular","voo doméstico",670,682,1352,8990,8089,17079,0,0,0,0
"5676",2014-03-01,"sbeg","transporte não regular","voo internacional",148,147,295,311,193,504,0,0,0,0
"5677",2014-03-01,"sbfi","transporte regular","voo doméstico",571,567,1138,74069,72473,146542,0,0,0,0
"5678",2014-03-01,"sbfi","transporte regular","voo internacional",17,17,34,2189,2379,4568,0,0,0,0
"5679",2014-03-01,"sbfi","transporte não regular","voo doméstico",106,114,220,1287,1535,2822,0,0,0,0
"5680",2014-03-01,"sbfi","transporte não regular","voo internacional",40,38,78,221,93,314,0,0,0,0
"5681",2014-03-01,"sbgo","transporte regular","voo doméstico",1350,1350,2700,127723,127939,255662,93340,120819,214159,160018
"5682",2014-03-01,"sbgo","transporte regular","voo internacional",0,0,0,0,0,0,0,0,0,0
"5683",2014-03-01,"sbgo","transporte não regular","voo doméstico",1189,1159,2348,3620,4237,7857,0,0,0,0
"5684",2014-03-01,"sbgo","transporte não regular","voo internacional",5,2,7,0,0,0,0,0,0,0
"5685",2014-03-01,"sbht","transporte regular","voo doméstico",180,180,360,8301,7937,16238,0,0,0,0
"5686",2014-03-01,"sbht","transporte regular","voo internacional",0,0,0,0,0,0,0,0,0,0
"5687",2014-03-01,"sbht","transporte não regular","voo doméstico",183,183,366,811,870,1681,3495,6040,9535,0
"5688",2014-03-01,"sbht","transporte não regular","voo internacional",1,1,2,0,0,0,0,0,0,0
"5689",2014-03-01,"sbiz","transporte regular","voo doméstico",209,210,419,12810,11968,24778,0,0,0,0
"5690",2014-03-01,"sbiz","transporte regular","voo internacional",0,0,0,0,0,0,0,0,0,0
"5691",2014-03-01,"sbiz","transporte não regular","voo doméstico",107,101,208,294,264,558,0,0,0,0
"5692",2014-03-01,"sbiz","transporte não regular","voo internacional",0,0,0,0,0,0,0,0,0,0
"5693",2014-03-01,"sbjc","transporte regular","voo doméstico",0,0,0,0,0,0,0,0,0,0
"5694",2014-03-01,"sbjc","transporte regular","voo internacional",0,0,0,0,0,0,0,0,0,0
"5695",2014-03-01,"sbjc","transporte não regular","voo doméstico",405,404,809,947,847,1794,0,0,0,0
"5696",2014-03-01,"sbjc","transporte não regular","voo internacional",0,0,0,0,0,0,0,0,0,0
"5697",2014-03-01,"sbjr","transporte regular","voo doméstico",0,0,0,0,0,0,0,0,0,0
"5698",2014-03-01,"sbjr","transporte regular","voo internacional",0,0,0,0,0,0,0,0,0,0
"5699",2014-03-01,"sbjr","transporte não regular","voo doméstico",3476,3470,6946,7569,3533,11102,0,0,0,0
"5700",2014-03-01,"sbjr","transporte não regular","voo internacional",0,0,0,0,0,0,0,0,0,0
"5701",2014-03-01,"sbjv","transporte regular","voo doméstico",236,237,473,20636,18986,39622,0,0,0,0
"5702",2014-03-01,"sbjv","transporte regular","voo internacional",0,0,0,0,0,0,0,0,0,0
"5703",2014-03-01,"sbjv","transporte não regular","voo doméstico",329,330,659,216,203,419,0,0,0,0
"5704",2014-03-01,"sbjv","transporte não regular","voo internacional",2,1,3,1,7,8,0,0,0,0
"5705",2014-03-01,"sblo","transporte regular","voo doméstico",481,482,963,45840,44373,90213,0,0,0,0
"5706",2014-03-01,"sblo","transporte regular","voo internacional",0,0,0,0,0,0,0,0,0,0
"5707",2014-03-01,"sblo","transporte não regular","voo doméstico",579,576,1155,548,925,1473,0,0,0,0
"5708",2014-03-01,"sblo","transporte não regular","voo internacional",3,2,5,0,0,0,0,0,0,0
"5709",2014-03-01,"sbma","transporte regular","voo doméstico",345,347,692,17417,17126,34543,12,0,12,0
"5710",2014-03-01,"sbma","transporte regular","voo internacional",0,0,0,0,0,0,0,0,0,0
"5711",2014-03-01,"sbma","transporte não regular","voo doméstico",250,251,501,1283,1602,2885,0,0,0,0
"5712",2014-03-01,"sbma","transporte não regular","voo internacional",1,1,2,0,0,0,0,0,0,0
"5713",2014-03-01,"sbmk","transporte regular","voo doméstico",162,161,323,13558,13212,26770,0,0,0,0
"5714",2014-03-01,"sbmk","transporte regular","voo internacional",0,0,0,0,0,0,0,0,0,0
"5715",2014-03-01,"sbmk","transporte não regular","voo doméstico",230,231,461,37,42,79,0,0,0,0
"5716",2014-03-01,"sbmk","transporte não regular","voo internacional",0,0,0,0,0,0,0,0,0,0
"5717",2014-03-01,"sbmq","transporte regular","voo doméstico",320,323,643,26040,28084,54124,10930,29350,40280,0
"5718",2014-03-01,"sbmq","transporte regular","voo internacional",0,0,0,0,0,0,0,0,0,0
"5719",2014-03-01,"sbmq","transporte não regular","voo doméstico",163,166,329,559,321,880,0,0,0,0
"5720",2014-03-01,"sbmq","transporte não regular","voo internacional",12,8,20,0,0,0,0,0,0,0
"5721",2014-03-01,"sbmt","transporte regular","voo doméstico",0,0,0,0,0,0,0,0,0,0
"5722",2014-03-01,"sbmt","transporte regular","voo internacional",0,0,0,0,0,0,0,0,0,0
"5723",2014-03-01,"sbmt","transporte não regular","voo doméstico",5394,5366,10760,8588,8544,17132,0,0,0,0
"5724",2014-03-01,"sbmt","transporte não regular","voo internacional",0,0,0,0,0,0,0,0,0,0
"5725",2014-03-01,"sbnf","transporte regular","voo doméstico",521,523,1044,54869,51091,105960,0,0,0,0
"5726",2014-03-01,"sbnf","transporte regular","voo internacional",0,0,0,0,0,0,0,0,0,0
"5727",2014-03-01,"sbnf","transporte não regular","voo doméstico",339,342,681,928,725,1653,0,0,0,0
"5728",2014-03-01,"sbnf","transporte não regular","voo internacional",6,5,11,12,8,20,0,0,0,0
"5729",2014-03-01,"sbpb","transporte regular","voo doméstico",0,0,0,0,0,0,0,0,0,0
"5730",2014-03-01,"sbpb","transporte regular","voo internacional",0,0,0,0,0,0,0,0,0,0
"5731",2014-03-01,"sbpb","transporte não regular","voo doméstico",93,99,192,248,226,474,0,0,0,0
"5732",2014-03-01,"sbpb","transporte não regular","voo internacional",0,0,0,0,0,0,0,0,0,0
"5733",2014-03-01,"sbpj","transporte regular","voo doméstico",335,337,672,23389,22180,45569,0,0,0,0
"5734",2014-03-01,"sbpj","transporte regular","voo internacional",0,0,0,0,0,0,0,0,0,0
"5735",2014-03-01,"sbpj","transporte não regular","voo doméstico",344,348,692,598,352,950,0,0,0,0
"5736",2014-03-01,"sbpj","transporte não regular","voo internacional",4,4,8,0,0,0,0,0,0,0
"5737",2014-03-01,"sbpk","transporte regular","voo doméstico",43,43,86,2424,2361,4785,0,0,0,0
"5738",2014-03-01,"sbpk","transporte regular","voo internacional",0,0,0,0,0,0,0,0,0,0
"5739",2014-03-01,"sbpk","transporte não regular","voo doméstico",74,71,145,194,201,395,0,0,0,0
"5740",2014-03-01,"sbpk","transporte não regular","voo internacional",6,9,15,38,30,68,0,0,0,0
"5741",2014-03-01,"sbpl","transporte regular","voo doméstico",202,183,385,16904,19108,36012,0,0,0,0
"5742",2014-03-01,"sbpl","transporte regular","voo internacional",4,4,8,0,0,0,0,0,0,0
"5743",2014-03-01,"sbpl","transporte não regular","voo doméstico",99,116,215,1268,120,1388,0,0,0,0
"5744",2014-03-01,"sbpl","transporte não regular","voo internacional",2,2,4,0,0,0,0,0,0,0
"5745",2014-03-01,"sbpp","transporte regular","voo doméstico",0,0,0,0,0,0,0,0,0,0
"5746",2014-03-01,"sbpp","transporte regular","voo internacional",0,0,0,0,0,0,0,0,0,0
"5747",2014-03-01,"sbpp","transporte não regular","voo doméstico",99,102,201,169,163,332,0,0,0,0
"5748",2014-03-01,"sbpp","transporte não regular","voo internacional",7,5,12,6,12,18,0,0,0,0
"5749",2014-03-01,"sbpr","transporte regular","voo doméstico",0,0,0,0,0,0,0,0,0,0
"5750",2014-03-01,"sbpr","transporte regular","voo internacional",0,0,0,0,0,0,0,0,0,0
"5751",2014-03-01,"sbpr","transporte não regular","voo doméstico",1457,1452,2909,1498,1546,3044,0,0,0,0
"5752",2014-03-01,"sbpr","transporte não regular","voo internacional",0,0,0,0,0,0,0,0,0,0
"5753",2014-03-01,"sbpv","transporte regular","voo doméstico",445,443,888,34668,34111,68779,52982,180630,233612,0
"5754",2014-03-01,"sbpv","transporte regular","voo internacional",0,0,0,0,0,0,0,0,0,0
"5755",2014-03-01,"sbpv","transporte não regular","voo doméstico",497,492,989,0,0,0,0,16674,16674,0
"5756",2014-03-01,"sbpv","transporte não regular","voo internacional",0,0,0,0,0,0,0,0,0,0
"5757",2014-03-01,"sbrb","transporte regular","voo doméstico",164,163,327,17512,17701,35213,0,0,0,0
"5758",2014-03-01,"sbrb","transporte regular","voo internacional",0,0,0,0,0,0,0,0,0,0
"5759",2014-03-01,"sbrb","transporte não regular","voo doméstico",308,311,619,650,463,1113,0,0,0,0
"5760",2014-03-01,"sbrb","transporte não regular","voo internacional",2,1,3,0,0,0,0,0,0,0
"5761",2014-03-01,"sbrj","transporte regular","voo doméstico",4122,4157,8279,390832,368238,759070,0,0,0,0
"5762",2014-03-01,"sbrj","transporte regular","voo internacional",0,0,0,0,0,0,0,0,0,0
"5763",2014-03-01,"sbrj","transporte não regular","voo doméstico",1036,1007,2043,1706,3268,4974,0,0,0,0
"5764",2014-03-01,"sbrj","transporte não regular","voo internacional",5,5,10,0,0,0,0,0,0,0
"5765",2014-03-01,"sbsj","transporte regular","voo doméstico",53,51,104,2631,2637,5268,0,0,0,0
"5766",2014-03-01,"sbsj","transporte regular","voo internacional",0,0,0,0,0,0,0,0,0,0
"5767",2014-03-01,"sbsj","transporte não regular","voo doméstico",609,588,1197,1263,1262,2525,0,0,0,0
"5768",2014-03-01,"sbsj","transporte não regular","voo internacional",5,16,21,37,8,45,0,0,0,0
"5769",2014-03-01,"sbsl","transporte regular","voo doméstico",707,735,1442,69773,66525,136298,0,9,9,0
"5770",2014-03-01,"sbsl","transporte regular","voo internacional",0,0,0,0,0,0,0,0,0,0
"5771",2014-03-01,"sbsl","transporte não regular","voo doméstico",378,350,728,3781,5284,9065,76512,205410,281922,0
"5772",2014-03-01,"sbsl","transporte não regular","voo internacional",4,2,6,0,0,0,0,0,0,0
"5773",2014-03-01,"sbsn","transporte regular","voo doméstico",420,421,841,22384,18644,41028,0,0,0,0
"5774",2014-03-01,"sbsn","transporte regular","voo internacional",0,0,0,0,0,0,0,0,0,0
"5775",2014-03-01,"sbsn","transporte não regular","voo doméstico",328,327,655,822,454,1276,0,0,0,0
"5776",2014-03-01,"sbsn","transporte não regular","voo internacional",0,0,0,0,0,0,0,0,0,0
"5777",2014-03-01,"sbsp","transporte regular","voo doméstico",6428,6484,12912,697577,709637,1407214,0,0,0,0
"5778",2014-03-01,"sbsp","transporte regular","voo internacional",0,0,0,0,0,0,0,0,0,0
"5779",2014-03-01,"sbsp","transporte não regular","voo doméstico",2166,2070,4236,10331,10648,20979,0,0,0,0
"5780",2014-03-01,"sbsp","transporte não regular","voo internacional",0,0,0,0,0,0,0,0,0,0
"5781",2014-03-01,"sbte","transporte regular","voo doméstico",452,452,904,42347,40828,83175,24224,91935,116159,346097
"5782",2014-03-01,"sbte","transporte regular","voo internacional",0,0,0,0,0,0,0,0,0,0
"5783",2014-03-01,"sbte","transporte não regular","voo doméstico",260,254,514,1412,1456,2868,0,0,0,0
"5784",2014-03-01,"sbte","transporte não regular","voo internacional",2,2,4,0,0,0,0,0,0,0
"5785",2014-03-01,"sbtf","transporte regular","voo doméstico",85,89,174,3177,3266,6443,0,0,0,0
"5786",2014-03-01,"sbtf","transporte regular","voo internacional",0,0,0,0,0,0,0,0,0,0
"5787",2014-03-01,"sbtf","transporte não regular","voo doméstico",245,242,487,471,451,922,1939,4356,6295,24345
"5788",2014-03-01,"sbtf","transporte não regular","voo internacional",0,0,0,0,0,0,0,0,0,0
"5789",2014-03-01,"sbtt","transporte regular","voo doméstico",33,32,65,2149,2488,4637,0,0,0,0
"5790",2014-03-01,"sbtt","transporte regular","voo internacional",0,0,0,0,0,0,0,0,0,0
"5791",2014-03-01,"sbtt","transporte não regular","voo doméstico",118,119,237,554,513,1067,1509,2800,4309,732
"5792",2014-03-01,"sbtt","transporte não regular","voo internacional",4,4,8,12,17,29,0,0,0,0
"5793",2014-03-01,"sbuf","transporte regular","voo doméstico",11,11,22,647,637,1284,0,0,0,0
"5794",2014-03-01,"sbuf","transporte regular","voo internacional",0,0,0,0,0,0,0,0,0,0
"5795",2014-03-01,"sbuf","transporte não regular","voo doméstico",79,77,156,210,251,461,0,0,0,0
"5796",2014-03-01,"sbuf","transporte não regular","voo internacional",0,0,0,0,0,0,0,0,0,0
"5797",2014-03-01,"sbug","transporte regular","voo doméstico",0,0,0,0,0,0,0,0,0,0
"5798",2014-03-01,"sbug","transporte regular","voo internacional",0,0,0,0,0,0,0,0,0,0
"5799",2014-03-01,"sbug","transporte não regular","voo doméstico",8,9,17,9,13,22,0,0,0,0
"5800",2014-03-01,"sbug","transporte não regular","voo internacional",3,2,5,0,0,0,0,0,0,0
"5801",2014-03-01,"sbul","transporte regular","voo doméstico",488,485,973,43343,42683,86026,0,0,0,0
"5802",2014-03-01,"sbul","transporte regular","voo internacional",0,0,0,0,0,0,0,0,0,0
"5803",2014-03-01,"sbul","transporte não regular","voo doméstico",607,608,1215,1451,1247,2698,0,0,0,0
"5804",2014-03-01,"sbul","transporte não regular","voo internacional",0,0,0,0,0,0,0,0,0,0
"5805",2014-03-01,"sbur","transporte regular","voo doméstico",97,97,194,4966,4722,9688,0,0,0,0
"5806",2014-03-01,"sbur","transporte regular","voo internacional",0,0,0,0,0,0,0,0,0,0
"5807",2014-03-01,"sbur","transporte não regular","voo doméstico",190,194,384,1486,1137,2623,0,0,0,0
"5808",2014-03-01,"sbur","transporte não regular","voo internacional",1,1,2,0,0,0,0,0,0,0
"5809",2014-11-01,"sbbe","transporte regular","voo doméstico",1608,1624,3232,154778,152517,307295,97866,367263,465129,2826
"5810",2014-11-01,"sbbe","transporte regular","voo internacional",37,37,74,5671,3879,9550,0,17,17,0
"5811",2014-11-01,"sbbe","transporte não regular","voo doméstico",546,527,1073,4840,5741,10581,0,0,0,0
"5812",2014-11-01,"sbbe","transporte não regular","voo internacional",24,22,46,44,44,88,0,0,0,0
"5813",2014-11-01,"sbbg","transporte regular","voo doméstico",0,0,0,0,0,0,0,0,0,0
"5814",2014-11-01,"sbbg","transporte regular","voo internacional",0,0,0,0,0,0,0,0,0,0
"5815",2014-11-01,"sbbg","transporte não regular","voo doméstico",17,16,33,69,68,137,0,0,0,0
"5816",2014-11-01,"sbbg","transporte não regular","voo internacional",1,0,1,0,1,1,0,0,0,0
"5817",2014-11-01,"sbbh","transporte regular","voo doméstico",535,551,1086,44108,27661,71769,0,0,0,0
"5818",2014-11-01,"sbbh","transporte regular","voo internacional",0,0,0,0,0,0,0,0,0,0
"5819",2014-11-01,"sbbh","transporte não regular","voo doméstico",1803,1775,3578,9168,9186,18354,0,0,0,0
"5820",2014-11-01,"sbbh","transporte não regular","voo internacional",4,3,7,14,19,33,0,0,0,0
"5821",2014-11-01,"sbbi","transporte regular","voo doméstico",0,0,0,0,0,0,0,0,0,0
"5822",2014-11-01,"sbbi","transporte regular","voo internacional",0,0,0,0,0,0,0,0,0,0
"5823",2014-11-01,"sbbi","transporte não regular","voo doméstico",1136,1126,2262,5718,5647,11365,0,0,0,0
"5824",2014-11-01,"sbbi","transporte não regular","voo internacional",2,2,4,0,0,0,0,0,0,0
"5825",2014-11-01,"sbbv","transporte regular","voo doméstico",115,115,230,14988,14855,29843,0,0,0,0
"5826",2014-11-01,"sbbv","transporte regular","voo internacional",0,1,1,0,0,0,0,0,0,0
"5827",2014-11-01,"sbbv","transporte não regular","voo doméstico",104,114,218,82,31,113,0,0,0,0
"5828",2014-11-01,"sbbv","transporte não regular","voo internacional",27,16,43,0,5,5,0,0,0,0
"5829",2014-11-01,"sbcg","transporte regular","voo doméstico",609,604,1213,71735,62095,133830,46764,61421,108185,0
"5830",2014-11-01,"sbcg","transporte regular","voo internacional",8,7,15,120,118,238,0,0,0,0
"5831",2014-11-01,"sbcg","transporte não regular","voo doméstico",357,360,717,1663,1177,2840,0,0,0,0
"5832",2014-11-01,"sbcg","transporte não regular","voo internacional",22,21,43,50,46,96,0,0,0,0
"5833",2014-11-01,"sbcj","transporte regular","voo doméstico",114,114,228,7427,6667,14094,0,0,0,0
"5834",2014-11-01,"sbcj","transporte regular","voo internacional",0,0,0,0,0,0,0,0,0,0
"5835",2014-11-01,"sbcj","transporte não regular","voo doméstico",93,92,185,829,911,1740,0,0,0,0
"5836",2014-11-01,"sbcj","transporte não regular","voo internacional",1,1,2,0,0,0,0,0,0,0
"5837",2014-11-01,"sbcr","transporte regular","voo doméstico",24,24,48,1412,1352,2764,0,0,0,0
"5838",2014-11-01,"sbcr","transporte regular","voo internacional",0,0,0,0,0,0,0,0,0,0
"5839",2014-11-01,"sbcr","transporte não regular","voo doméstico",47,48,95,176,77,253,0,0,0,0
"5840",2014-11-01,"sbcr","transporte não regular","voo internacional",4,3,7,1,2,3,0,0,0,0
"5841",2014-11-01,"sbct","transporte regular","voo doméstico",2948,2957,5905,313176,313546,626722,171264,0,171264,153883
"5842",2014-11-01,"sbct","transporte regular","voo internacional",110,110,220,5414,7392,12806,0,0,0,0
"5843",2014-11-01,"sbct","transporte não regular","voo doméstico",222,209,431,885,1762,2647,0,0,0,0
"5844",2014-11-01,"sbct","transporte não regular","voo internacional",13,11,24,36,28,64,0,0,0,0
"5845",2014-11-01,"sbcz","transporte regular","voo doméstico",29,29,58,1853,1705,3558,0,0,0,0
"5846",2014-11-01,"sbcz","transporte regular","voo internacional",0,0,0,0,0,0,0,0,0,0
"5847",2014-11-01,"sbcz","transporte não regular","voo doméstico",167,164,331,654,511,1165,0,0,0,0
"5848",2014-11-01,"sbcz","transporte não regular","voo internacional",2,2,4,32,32,64,0,0,0,0
"5849",2014-11-01,"sbeg","transporte regular","voo doméstico",1190,1171,2361,122185,118952,241137,0,0,0,0
"5850",2014-11-01,"sbeg","transporte regular","voo internacional",120,128,248,10049,9376,19425,0,0,0,0
"5851",2014-11-01,"sbeg","transporte não regular","voo doméstico",726,751,1477,8615,7889,16504,0,0,0,0
"5852",2014-11-01,"sbeg","transporte não regular","voo internacional",107,100,207,396,418,814,0,0,0,0
"5853",2014-11-01,"sbfi","transporte regular","voo doméstico",596,592,1188,77583,77654,155237,0,0,0,0
"5854",2014-11-01,"sbfi","transporte regular","voo internacional",30,30,60,3812,3189,7001,0,0,0,0
"5855",2014-11-01,"sbfi","transporte não regular","voo doméstico",139,139,278,1698,1154,2852,0,0,0,0
"5856",2014-11-01,"sbfi","transporte não regular","voo internacional",31,36,67,42,195,237,0,0,0,0
"5857",2014-11-01,"sbgo","transporte regular","voo doméstico",1457,1458,2915,140129,138885,279014,111818,153559,265377,161485
"5858",2014-11-01,"sbgo","transporte regular","voo internacional",0,0,0,0,0,0,0,0,0,0
"5859",2014-11-01,"sbgo","transporte não regular","voo doméstico",1153,1148,2301,3799,4832,8631,0,0,0,0
"5860",2014-11-01,"sbgo","transporte não regular","voo internacional",7,6,13,0,0,0,0,0,0,0
"5861",2014-11-01,"sbht","transporte regular","voo doméstico",230,228,458,9935,9980,19915,0,0,0,0
"5862",2014-11-01,"sbht","transporte regular","voo internacional",0,0,0,0,0,0,0,0,0,0
"5863",2014-11-01,"sbht","transporte não regular","voo doméstico",310,310,620,2780,2498,5278,1630,2260,3890,410
"5864",2014-11-01,"sbht","transporte não regular","voo internacional",1,1,2,0,0,0,0,0,0,0
"5865",2014-11-01,"sbiz","transporte regular","voo doméstico",235,235,470,14616,14294,28910,0,0,0,0
"5866",2014-11-01,"sbiz","transporte regular","voo internacional",0,0,0,0,0,0,0,0,0,0
"5867",2014-11-01,"sbiz","transporte não regular","voo doméstico",150,150,300,447,400,847,0,0,0,0
"5868",2014-11-01,"sbiz","transporte não regular","voo internacional",0,0,0,0,0,0,0,0,0,0
"5869",2014-11-01,"sbjc","transporte regular","voo doméstico",0,0,0,0,0,0,0,0,0,0
"5870",2014-11-01,"sbjc","transporte regular","voo internacional",0,0,0,0,0,0,0,0,0,0
"5871",2014-11-01,"sbjc","transporte não regular","voo doméstico",432,428,860,804,506,1310,0,0,0,0
"5872",2014-11-01,"sbjc","transporte não regular","voo internacional",0,2,2,0,0,0,0,0,0,0
"5873",2014-11-01,"sbjr","transporte regular","voo doméstico",0,0,0,0,0,0,0,0,0,0
"5874",2014-11-01,"sbjr","transporte regular","voo internacional",0,0,0,0,0,0,0,0,0,0
"5875",2014-11-01,"sbjr","transporte não regular","voo doméstico",2761,2753,5514,11743,8182,19925,0,0,0,0
"5876",2014-11-01,"sbjr","transporte não regular","voo internacional",0,0,0,0,0,0,0,0,0,0
"5877",2014-11-01,"sbjv","transporte regular","voo doméstico",251,249,500,22015,21298,43313,0,0,0,0
"5878",2014-11-01,"sbjv","transporte regular","voo internacional",0,0,0,0,0,0,0,0,0,0
"5879",2014-11-01,"sbjv","transporte não regular","voo doméstico",245,244,489,48,268,316,0,0,0,0
"5880",2014-11-01,"sbjv","transporte não regular","voo internacional",0,0,0,0,0,0,0,0,0,0
"5881",2014-11-01,"sblo","transporte regular","voo doméstico",482,482,964,45195,43722,88917,0,0,0,0
"5882",2014-11-01,"sblo","transporte regular","voo internacional",0,0,0,0,0,0,0,0,0,0
"5883",2014-11-01,"sblo","transporte não regular","voo doméstico",724,726,1450,958,845,1803,0,0,0,0
"5884",2014-11-01,"sblo","transporte não regular","voo internacional",1,1,2,0,0,0,0,0,0,0
"5885",2014-11-01,"sbma","transporte regular","voo doméstico",331,331,662,14322,14913,29235,0,70,70,0
"5886",2014-11-01,"sbma","transporte regular","voo internacional",0,0,0,0,0,0,0,0,0,0
"5887",2014-11-01,"sbma","transporte não regular","voo doméstico",287,290,577,1090,1125,2215,0,0,0,0
"5888",2014-11-01,"sbma","transporte não regular","voo internacional",1,1,2,0,0,0,0,0,0,0
"5889",2014-11-01,"sbmk","transporte regular","voo doméstico",200,195,395,16098,15847,31945,0,0,0,0
"5890",2014-11-01,"sbmk","transporte regular","voo internacional",0,0,0,0,0,0,0,0,0,0
"5891",2014-11-01,"sbmk","transporte não regular","voo doméstico",196,202,398,75,4,79,0,0,0,0
"5892",2014-11-01,"sbmk","transporte não regular","voo internacional",0,0,0,0,0,0,0,0,0,0
"5893",2014-11-01,"sbmq","transporte regular","voo doméstico",328,325,653,31634,30691,62325,19500,35400,54900,0
"5894",2014-11-01,"sbmq","transporte regular","voo internacional",0,0,0,0,0,0,0,0,0,0
"5895",2014-11-01,"sbmq","transporte não regular","voo doméstico",231,237,468,490,479,969,0,0,0,0
"5896",2014-11-01,"sbmq","transporte não regular","voo internacional",8,6,14,0,0,0,0,0,0,0
"5897",2014-11-01,"sbmt","transporte regular","voo doméstico",0,0,0,0,0,0,0,0,0,0
"5898",2014-11-01,"sbmt","transporte regular","voo internacional",0,0,0,0,0,0,0,0,0,0
"5899",2014-11-01,"sbmt","transporte não regular","voo doméstico",4558,4543,9101,7560,7510,15070,0,0,0,0
"5900",2014-11-01,"sbmt","transporte não regular","voo internacional",0,0,0,0,0,0,0,0,0,0
"5901",2014-11-01,"sbnf","transporte regular","voo doméstico",561,560,1121,57772,59253,117025,425,0,425,0
"5902",2014-11-01,"sbnf","transporte regular","voo internacional",0,0,0,0,0,0,0,0,0,0
"5903",2014-11-01,"sbnf","transporte não regular","voo doméstico",323,327,650,1043,940,1983,0,0,0,0
"5904",2014-11-01,"sbnf","transporte não regular","voo internacional",5,5,10,4,11,15,0,0,0,0
"5905",2014-11-01,"sbpb","transporte regular","voo doméstico",24,24,48,673,777,1450,0,0,0,0
"5906",2014-11-01,"sbpb","transporte regular","voo internacional",0,0,0,0,0,0,0,0,0,0
"5907",2014-11-01,"sbpb","transporte não regular","voo doméstico",53,52,105,90,108,198,0,0,0,0
"5908",2014-11-01,"sbpb","transporte não regular","voo internacional",0,0,0,0,0,0,0,0,0,0
"5909",2014-11-01,"sbpj","transporte regular","voo doméstico",342,339,681,25919,25476,51395,0,0,0,0
"5910",2014-11-01,"sbpj","transporte regular","voo internacional",0,0,0,0,0,0,0,0,0,0
"5911",2014-11-01,"sbpj","transporte não regular","voo doméstico",267,265,532,531,437,968,0,0,0,0
"5912",2014-11-01,"sbpj","transporte não regular","voo internacional",2,2,4,0,0,0,0,0,0,0
"5913",2014-11-01,"sbpk","transporte regular","voo doméstico",48,48,96,2891,2776,5667,0,0,0,0
"5914",2014-11-01,"sbpk","transporte regular","voo internacional",0,0,0,0,0,0,0,0,0,0
"5915",2014-11-01,"sbpk","transporte não regular","voo doméstico",43,44,87,75,83,158,0,0,0,0
"5916",2014-11-01,"sbpk","transporte não regular","voo internacional",8,8,16,6,7,13,0,0,0,0
"5917",2014-11-01,"sbpl","transporte regular","voo doméstico",196,196,392,21099,20148,41247,0,0,0,0
"5918",2014-11-01,"sbpl","transporte regular","voo internacional",3,3,6,0,0,0,0,0,0,0
"5919",2014-11-01,"sbpl","transporte não regular","voo doméstico",89,90,179,65,64,129,0,0,0,0
"5920",2014-11-01,"sbpl","transporte não regular","voo internacional",4,4,8,0,0,0,0,0,0,0
"5921",2014-11-01,"sbpp","transporte regular","voo doméstico",0,0,0,0,0,0,0,0,0,0
"5922",2014-11-01,"sbpp","transporte regular","voo internacional",0,0,0,0,0,0,0,0,0,0
"5923",2014-11-01,"sbpp","transporte não regular","voo doméstico",94,96,190,180,146,326,0,0,0,0
"5924",2014-11-01,"sbpp","transporte não regular","voo internacional",9,7,16,9,17,26,0,0,0,0
"5925",2014-11-01,"sbpr","transporte regular","voo doméstico",0,0,0,0,0,0,0,0,0,0
"5926",2014-11-01,"sbpr","transporte regular","voo internacional",0,0,0,0,0,0,0,0,0,0
"5927",2014-11-01,"sbpr","transporte não regular","voo doméstico",1142,1156,2298,1319,1262,2581,0,0,0,0
"5928",2014-11-01,"sbpr","transporte não regular","voo internacional",0,0,0,0,0,0,0,0,0,0
"5929",2014-11-01,"sbpv","transporte regular","voo doméstico",391,393,784,37721,34891,72612,56863,223772,280635,0
"5930",2014-11-01,"sbpv","transporte regular","voo internacional",0,0,0,0,0,0,0,0,0,0
"5931",2014-11-01,"sbpv","transporte não regular","voo doméstico",218,219,437,0,0,0,0,0,0,0
"5932",2014-11-01,"sbpv","transporte não regular","voo internacional",2,2,4,0,0,0,0,0,0,0
"5933",2014-11-01,"sbrb","transporte regular","voo doméstico",126,128,254,11976,11511,23487,0,0,0,0
"5934",2014-11-01,"sbrb","transporte regular","voo internacional",0,0,0,0,0,0,0,0,0,0
"5935",2014-11-01,"sbrb","transporte não regular","voo doméstico",201,207,408,528,420,948,0,0,0,0
"5936",2014-11-01,"sbrb","transporte não regular","voo internacional",1,0,1,0,0,0,0,0,0,0
"5937",2014-11-01,"sbrj","transporte regular","voo doméstico",4317,4315,8632,450057,445915,895972,0,0,0,0
"5938",2014-11-01,"sbrj","transporte regular","voo internacional",0,0,0,0,0,0,0,0,0,0
"5939",2014-11-01,"sbrj","transporte não regular","voo doméstico",732,742,1474,5255,2185,7440,0,0,0,0
"5940",2014-11-01,"sbrj","transporte não regular","voo internacional",1,1,2,0,0,0,0,0,0,0
"5941",2014-11-01,"sbsj","transporte regular","voo doméstico",44,44,88,667,559,1226,0,0,0,0
"5942",2014-11-01,"sbsj","transporte regular","voo internacional",1,1,2,0,0,0,0,0,0,0
"5943",2014-11-01,"sbsj","transporte não regular","voo doméstico",568,563,1131,1757,1267,3024,0,0,0,0
"5944",2014-11-01,"sbsj","transporte não regular","voo internacional",2,20,22,49,6,55,0,0,0,0
"5945",2014-11-01,"sbsl","transporte regular","voo doméstico",712,711,1423,70136,74711,144847,0,255,255,294
"5946",2014-11-01,"sbsl","transporte regular","voo internacional",0,0,0,0,0,0,0,0,0,0
"5947",2014-11-01,"sbsl","transporte não regular","voo doméstico",255,256,511,877,677,1554,83790,269711,353501,0
"5948",2014-11-01,"sbsl","transporte não regular","voo internacional",1,1,2,0,0,0,0,0,0,0
"5949",2014-11-01,"sbsn","transporte regular","voo doméstico",461,460,921,28827,24928,53755,0,0,0,0
"5950",2014-11-01,"sbsn","transporte regular","voo internacional",0,0,0,0,0,0,0,0,0,0
"5951",2014-11-01,"sbsn","transporte não regular","voo doméstico",392,395,787,1329,921,2250,0,0,0,0
"5952",2014-11-01,"sbsn","transporte não regular","voo internacional",1,1,2,0,0,0,0,0,0,0
"5953",2014-11-01,"sbsp","transporte regular","voo doméstico",6760,6832,13592,826466,807131,1633597,0,0,0,0
"5954",2014-11-01,"sbsp","transporte regular","voo internacional",0,0,0,0,0,0,0,0,0,0
"5955",2014-11-01,"sbsp","transporte não regular","voo doméstico",2097,2013,4110,10731,10462,21193,0,0,0,0
"5956",2014-11-01,"sbsp","transporte não regular","voo internacional",0,0,0,0,0,0,0,0,0,0
"5957",2014-11-01,"sbte","transporte regular","voo doméstico",477,475,952,47572,48009,95581,30294,91505,121799,282470
"5958",2014-11-01,"sbte","transporte regular","voo internacional",0,0,0,0,0,0,0,0,0,0
"5959",2014-11-01,"sbte","transporte não regular","voo doméstico",217,218,435,1038,1035,2073,0,0,0,0
"5960",2014-11-01,"sbte","transporte não regular","voo internacional",0,0,0,0,0,0,0,0,0,0
"5961",2014-11-01,"sbtf","transporte regular","voo doméstico",53,53,106,2253,2258,4511,0,0,0,0
"5962",2014-11-01,"sbtf","transporte regular","voo internacional",0,0,0,0,0,0,0,0,0,0
"5963",2014-11-01,"sbtf","transporte não regular","voo doméstico",181,181,362,267,219,486,3452,3291,6743,23445
"5964",2014-11-01,"sbtf","transporte não regular","voo internacional",0,0,0,0,0,0,0,0,0,0
"5965",2014-11-01,"sbtt","transporte regular","voo doméstico",32,32,64,2372,2913,5285,0,0,0,0
"5966",2014-11-01,"sbtt","transporte regular","voo internacional",0,0,0,0,0,0,0,0,0,0
"5967",2014-11-01,"sbtt","transporte não regular","voo doméstico",139,137,276,525,533,1058,1460,2736,4196,356
"5968",2014-11-01,"sbtt","transporte não regular","voo internacional",6,7,13,17,13,30,0,0,0,0
"5969",2014-11-01,"sbuf","transporte regular","voo doméstico",21,21,42,1086,1108,2194,0,0,0,0
"5970",2014-11-01,"sbuf","transporte regular","voo internacional",0,0,0,0,0,0,0,0,0,0
"5971",2014-11-01,"sbuf","transporte não regular","voo doméstico",64,65,129,101,84,185,0,0,0,0
"5972",2014-11-01,"sbuf","transporte não regular","voo internacional",0,0,0,0,0,0,0,0,0,0
"5973",2014-11-01,"sbug","transporte regular","voo doméstico",0,0,0,0,0,0,0,0,0,0
"5974",2014-11-01,"sbug","transporte regular","voo internacional",0,0,0,0,0,0,0,0,0,0
"5975",2014-11-01,"sbug","transporte não regular","voo doméstico",11,11,22,19,16,35,0,0,0,0
"5976",2014-11-01,"sbug","transporte não regular","voo internacional",0,0,0,0,0,0,0,0,0,0
"5977",2014-11-01,"sbul","transporte regular","voo doméstico",585,583,1168,46845,46310,93155,0,0,0,0
"5978",2014-11-01,"sbul","transporte regular","voo internacional",0,0,0,0,0,0,0,0,0,0
"5979",2014-11-01,"sbul","transporte não regular","voo doméstico",506,506,1012,1037,989,2026,0,0,0,0
"5980",2014-11-01,"sbul","transporte não regular","voo internacional",2,2,4,17,17,34,0,0,0,0
"5981",2014-11-01,"sbur","transporte regular","voo doméstico",133,133,266,5618,5572,11190,0,0,0,0
"5982",2014-11-01,"sbur","transporte regular","voo internacional",0,0,0,0,0,0,0,0,0,0
"5983",2014-11-01,"sbur","transporte não regular","voo doméstico",154,156,310,499,783,1282,0,0,0,0
"5984",2014-11-01,"sbur","transporte não regular","voo internacional",0,0,0,0,0,0,0,0,0,0
"5985",2014-10-01,"sbbe","transporte regular","voo doméstico",1772,1776,3548,163422,164354,327776,103974,494633,598607,0
"5986",2014-10-01,"sbbe","transporte regular","voo internacional",37,38,75,4282,4025,8307,0,46,46,0
"5987",2014-10-01,"sbbe","transporte não regular","voo doméstico",749,744,1493,5886,6668,12554,0,0,0,0
"5988",2014-10-01,"sbbe","transporte não regular","voo internacional",18,13,31,24,52,76,0,0,0,0
"5989",2014-10-01,"sbbg","transporte regular","voo doméstico",0,0,0,0,0,0,0,0,0,0
"5990",2014-10-01,"sbbg","transporte regular","voo internacional",0,0,0,0,0,0,0,0,0,0
"5991",2014-10-01,"sbbg","transporte não regular","voo doméstico",17,16,33,72,80,152,0,0,0,0
"5992",2014-10-01,"sbbg","transporte não regular","voo internacional",3,4,7,11,8,19,0,0,0,0
"5993",2014-10-01,"sbbh","transporte regular","voo doméstico",620,624,1244,31984,35012,66996,0,0,0,0
"5994",2014-10-01,"sbbh","transporte regular","voo internacional",0,0,0,0,0,0,0,0,0,0
"5995",2014-10-01,"sbbh","transporte não regular","voo doméstico",2233,2232,4465,10389,10296,20685,0,0,0,0
"5996",2014-10-01,"sbbh","transporte não regular","voo internacional",0,0,0,0,0,0,0,0,0,0
"5997",2014-10-01,"sbbi","transporte regular","voo doméstico",0,0,0,0,0,0,0,0,0,0
"5998",2014-10-01,"sbbi","transporte regular","voo internacional",0,0,0,0,0,0,0,0,0,0
"5999",2014-10-01,"sbbi","transporte não regular","voo doméstico",1432,1449,2881,8034,8345,16379,0,0,0,0
"6000",2014-10-01,"sbbi","transporte não regular","voo internacional",1,1,2,0,0,0,0,0,0,0
"6001",2014-10-01,"sbbv","transporte regular","voo doméstico",122,122,244,15493,14528,30021,0,0,0,0
"6002",2014-10-01,"sbbv","transporte regular","voo internacional",0,0,0,0,0,0,0,0,0,0
"6003",2014-10-01,"sbbv","transporte não regular","voo doméstico",144,161,305,517,369,886,0,0,0,0
"6004",2014-10-01,"sbbv","transporte não regular","voo internacional",34,18,52,5,11,16,0,0,0,0
"6005",2014-10-01,"sbcg","transporte regular","voo doméstico",650,641,1291,70531,63998,134529,63313,125465,188778,0
"6006",2014-10-01,"sbcg","transporte regular","voo internacional",14,14,28,178,208,386,0,0,0,0
"6007",2014-10-01,"sbcg","transporte não regular","voo doméstico",378,390,768,2175,1260,3435,3229,7141,10370,0
"6008",2014-10-01,"sbcg","transporte não regular","voo internacional",9,9,18,0,67,67,0,0,0,0
"6009",2014-10-01,"sbcj","transporte regular","voo doméstico",106,105,211,6508,6296,12804,0,0,0,0
"6010",2014-10-01,"sbcj","transporte regular","voo internacional",0,0,0,0,0,0,0,0,0,0
"6011",2014-10-01,"sbcj","transporte não regular","voo doméstico",117,119,236,1982,1928,3910,0,0,0,0
"6012",2014-10-01,"sbcj","transporte não regular","voo internacional",0,0,0,0,0,0,0,0,0,0
"6013",2014-10-01,"sbcr","transporte regular","voo doméstico",25,25,50,1616,1486,3102,0,0,0,0
"6014",2014-10-01,"sbcr","transporte regular","voo internacional",0,0,0,0,0,0,0,0,0,0
"6015",2014-10-01,"sbcr","transporte não regular","voo doméstico",74,73,147,237,234,471,0,0,0,0
"6016",2014-10-01,"sbcr","transporte não regular","voo internacional",4,4,8,9,8,17,0,0,0,0
"6017",2014-10-01,"sbct","transporte regular","voo doméstico",3111,3113,6224,320267,319045,639312,190128,0,190128,160534
"6018",2014-10-01,"sbct","transporte regular","voo internacional",113,113,226,6002,5721,11723,0,4905,4905,0
"6019",2014-10-01,"sbct","transporte não regular","voo doméstico",215,217,432,638,676,1314,0,0,0,0
"6020",2014-10-01,"sbct","transporte não regular","voo internacional",21,20,41,167,169,336,0,8775,8775,0
"6021",2014-10-01,"sbcz","transporte regular","voo doméstico",23,23,46,1726,1661,3387,0,0,0,0
"6022",2014-10-01,"sbcz","transporte regular","voo internacional",0,0,0,0,0,0,0,0,0,0
"6023",2014-10-01,"sbcz","transporte não regular","voo doméstico",317,320,637,1067,1067,2134,0,0,0,0
"6024",2014-10-01,"sbcz","transporte não regular","voo internacional",1,2,3,0,0,0,0,0,0,0
"6025",2014-10-01,"sbeg","transporte regular","voo doméstico",1230,1221,2451,125594,119869,245463,0,0,0,0
"6026",2014-10-01,"sbeg","transporte regular","voo internacional",130,136,266,13833,10349,24182,0,0,0,0
"6027",2014-10-01,"sbeg","transporte não regular","voo doméstico",1034,1023,2057,11646,10675,22321,0,0,0,0
"6028",2014-10-01,"sbeg","transporte não regular","voo internacional",112,115,227,282,276,558,0,0,0,0
"6029",2014-10-01,"sbfi","transporte regular","voo doméstico",619,618,1237,78663,80650,159313,0,0,0,0
"6030",2014-10-01,"sbfi","transporte regular","voo internacional",30,30,60,3760,3973,7733,0,0,0,0
"6031",2014-10-01,"sbfi","transporte não regular","voo doméstico",133,131,264,585,888,1473,0,0,0,0
"6032",2014-10-01,"sbfi","transporte não regular","voo internacional",41,38,79,193,86,279,0,0,0,0
"6033",2014-10-01,"sbgo","transporte regular","voo doméstico",1557,1560,3117,144669,141281,285950,118612,175030,293642,172434
"6034",2014-10-01,"sbgo","transporte regular","voo internacional",0,0,0,0,0,0,0,0,0,0
"6035",2014-10-01,"sbgo","transporte não regular","voo doméstico",1349,1357,2706,3937,5244,9181,0,0,0,0
"6036",2014-10-01,"sbgo","transporte não regular","voo internacional",2,2,4,0,0,0,0,0,0,0
"6037",2014-10-01,"sbht","transporte regular","voo doméstico",242,245,487,11651,10106,21757,0,0,0,0
"6038",2014-10-01,"sbht","transporte regular","voo internacional",0,0,0,0,0,0,0,0,0,0
"6039",2014-10-01,"sbht","transporte não regular","voo doméstico",351,349,700,2407,2330,4737,3418,5763,9181,874
"6040",2014-10-01,"sbht","transporte não regular","voo internacional",0,0,0,0,0,0,0,0,0,0
"6041",2014-10-01,"sbiz","transporte regular","voo doméstico",241,242,483,15721,15160,30881,0,0,0,0
"6042",2014-10-01,"sbiz","transporte regular","voo internacional",0,0,0,0,0,0,0,0,0,0
"6043",2014-10-01,"sbiz","transporte não regular","voo doméstico",226,232,458,757,649,1406,0,0,0,0
"6044",2014-10-01,"sbiz","transporte não regular","voo internacional",0,0,0,0,0,0,0,0,0,0
"6045",2014-10-01,"sbjc","transporte regular","voo doméstico",2,1,3,3,5,8,0,0,0,0
"6046",2014-10-01,"sbjc","transporte regular","voo internacional",0,0,0,0,0,0,0,0,0,0
"6047",2014-10-01,"sbjc","transporte não regular","voo doméstico",561,563,1124,861,614,1475,0,0,0,0
"6048",2014-10-01,"sbjc","transporte não regular","voo internacional",2,0,2,0,0,0,0,0,0,0
"6049",2014-10-01,"sbjr","transporte regular","voo doméstico",0,0,0,0,0,0,0,0,0,0
"6050",2014-10-01,"sbjr","transporte regular","voo internacional",0,0,0,0,0,0,0,0,0,0
"6051",2014-10-01,"sbjr","transporte não regular","voo doméstico",3024,3027,6051,9875,6669,16544,0,0,0,0
"6052",2014-10-01,"sbjr","transporte não regular","voo internacional",0,0,0,0,0,0,0,0,0,0
"6053",2014-10-01,"sbjv","transporte regular","voo doméstico",265,266,531,23977,24411,48388,0,0,0,0
"6054",2014-10-01,"sbjv","transporte regular","voo internacional",0,0,0,0,0,0,0,0,0,0
"6055",2014-10-01,"sbjv","transporte não regular","voo doméstico",309,308,617,1013,1030,2043,0,0,0,0
"6056",2014-10-01,"sbjv","transporte não regular","voo internacional",0,0,0,0,0,0,0,0,0,0
"6057",2014-10-01,"sblo","transporte regular","voo doméstico",525,528,1053,49440,48952,98392,0,0,0,0
"6058",2014-10-01,"sblo","transporte regular","voo internacional",0,0,0,0,0,0,0,0,0,0
"6059",2014-10-01,"sblo","transporte não regular","voo doméstico",764,762,1526,202,484,686,0,0,0,0
"6060",2014-10-01,"sblo","transporte não regular","voo internacional",3,3,6,0,0,0,0,0,0,0
"6061",2014-10-01,"sbma","transporte regular","voo doméstico",358,357,715,15691,15075,30766,0,0,0,0
"6062",2014-10-01,"sbma","transporte regular","voo internacional",0,0,0,0,0,0,0,0,0,0
"6063",2014-10-01,"sbma","transporte não regular","voo doméstico",362,365,727,1303,1329,2632,0,0,0,0
"6064",2014-10-01,"sbma","transporte não regular","voo internacional",1,1,2,0,0,0,0,0,0,0
"6065",2014-10-01,"sbmk","transporte regular","voo doméstico",217,218,435,18666,18063,36729,0,0,0,0
"6066",2014-10-01,"sbmk","transporte regular","voo internacional",0,0,0,0,0,0,0,0,0,0
"6067",2014-10-01,"sbmk","transporte não regular","voo doméstico",273,269,542,132,113,245,0,0,0,0
"6068",2014-10-01,"sbmk","transporte não regular","voo internacional",0,0,0,0,0,0,0,0,0,0
"6069",2014-10-01,"sbmq","transporte regular","voo doméstico",362,358,720,31436,29826,61262,21100,39700,60800,0
"6070",2014-10-01,"sbmq","transporte regular","voo internacional",0,0,0,0,0,0,0,0,0,0
"6071",2014-10-01,"sbmq","transporte não regular","voo doméstico",310,315,625,733,575,1308,0,0,0,0
"6072",2014-10-01,"sbmq","transporte não regular","voo internacional",7,5,12,0,0,0,0,0,0,0
"6073",2014-10-01,"sbmt","transporte regular","voo doméstico",0,0,0,0,0,0,0,0,0,0
"6074",2014-10-01,"sbmt","transporte regular","voo internacional",0,0,0,0,0,0,0,0,0,0
"6075",2014-10-01,"sbmt","transporte não regular","voo doméstico",4768,4790,9558,7971,7374,15345,0,0,0,0
"6076",2014-10-01,"sbmt","transporte não regular","voo internacional",0,0,0,0,0,0,0,0,0,0
"6077",2014-10-01,"sbnf","transporte regular","voo doméstico",615,615,1230,62787,65243,128030,688,0,688,0
"6078",2014-10-01,"sbnf","transporte regular","voo internacional",0,0,0,0,0,0,0,0,0,0
"6079",2014-10-01,"sbnf","transporte não regular","voo doméstico",239,237,476,704,646,1350,0,0,0,0
"6080",2014-10-01,"sbnf","transporte não regular","voo internacional",5,4,9,9,0,9,0,0,0,0
"6081",2014-10-01,"sbpb","transporte regular","voo doméstico",21,21,42,610,673,1283,0,0,0,0
"6082",2014-10-01,"sbpb","transporte regular","voo internacional",0,0,0,0,0,0,0,0,0,0
"6083",2014-10-01,"sbpb","transporte não regular","voo doméstico",71,71,142,146,138,284,0,0,0,0
"6084",2014-10-01,"sbpb","transporte não regular","voo internacional",0,0,0,0,0,0,0,0,0,0
"6085",2014-10-01,"sbpj","transporte regular","voo doméstico",361,359,720,26963,25813,52776,0,0,0,0
"6086",2014-10-01,"sbpj","transporte regular","voo internacional",0,0,0,0,0,0,0,0,0,0
"6087",2014-10-01,"sbpj","transporte não regular","voo doméstico",328,336,664,518,407,925,0,0,0,0
"6088",2014-10-01,"sbpj","transporte não regular","voo internacional",3,3,6,0,0,0,0,0,0,0
"6089",2014-10-01,"sbpk","transporte regular","voo doméstico",51,51,102,2758,2549,5307,0,0,0,0
"6090",2014-10-01,"sbpk","transporte regular","voo internacional",0,0,0,0,0,0,0,0,0,0
"6091",2014-10-01,"sbpk","transporte não regular","voo doméstico",42,43,85,102,108,210,0,0,0,0
"6092",2014-10-01,"sbpk","transporte não regular","voo internacional",6,5,11,10,17,27,0,0,0,0
"6093",2014-10-01,"sbpl","transporte regular","voo doméstico",211,210,421,22530,21990,44520,0,0,0,0
"6094",2014-10-01,"sbpl","transporte regular","voo internacional",5,5,10,0,0,0,0,0,0,0
"6095",2014-10-01,"sbpl","transporte não regular","voo doméstico",103,102,205,99,92,191,0,0,0,0
"6096",2014-10-01,"sbpl","transporte não regular","voo internacional",4,4,8,0,0,0,0,0,0,0
"6097",2014-10-01,"sbpp","transporte regular","voo doméstico",0,0,0,0,0,0,0,0,0,0
"6098",2014-10-01,"sbpp","transporte regular","voo internacional",0,0,0,0,0,0,0,0,0,0
"6099",2014-10-01,"sbpp","transporte não regular","voo doméstico",103,104,207,173,165,338,0,0,0,0
"6100",2014-10-01,"sbpp","transporte não regular","voo internacional",14,13,27,9,11,20,0,0,0,0
"6101",2014-10-01,"sbpr","transporte regular","voo doméstico",0,1,1,3,0,3,0,0,0,0
"6102",2014-10-01,"sbpr","transporte regular","voo internacional",0,0,0,0,0,0,0,0,0,0
"6103",2014-10-01,"sbpr","transporte não regular","voo doméstico",1377,1382,2759,1664,1481,3145,0,0,0,0
"6104",2014-10-01,"sbpr","transporte não regular","voo internacional",0,0,0,0,0,0,0,0,0,0
"6105",2014-10-01,"sbpv","transporte regular","voo doméstico",394,393,787,36951,35870,72821,53636,214473,268109,0
"6106",2014-10-01,"sbpv","transporte regular","voo internacional",0,0,0,0,0,0,0,0,0,0
"6107",2014-10-01,"sbpv","transporte não regular","voo doméstico",213,207,420,0,0,0,0,0,0,0
"6108",2014-10-01,"sbpv","transporte não regular","voo internacional",2,2,4,0,0,0,0,0,0,0
"6109",2014-10-01,"sbrb","transporte regular","voo doméstico",118,116,234,12808,11943,24751,0,0,0,0
"6110",2014-10-01,"sbrb","transporte regular","voo internacional",0,0,0,0,0,0,0,0,0,0
"6111",2014-10-01,"sbrb","transporte não regular","voo doméstico",202,195,397,500,545,1045,0,0,0,0
"6112",2014-10-01,"sbrb","transporte não regular","voo internacional",1,1,2,0,0,0,0,0,0,0
"6113",2014-10-01,"sbrj","transporte regular","voo doméstico",4660,4667,9327,459583,459209,918792,0,0,0,0
"6114",2014-10-01,"sbrj","transporte regular","voo internacional",0,0,0,0,0,0,0,0,0,0
"6115",2014-10-01,"sbrj","transporte não regular","voo doméstico",908,904,1812,2637,1670,4307,0,0,0,0
"6116",2014-10-01,"sbrj","transporte não regular","voo internacional",3,3,6,0,0,0,0,0,0,0
"6117",2014-10-01,"sbsj","transporte regular","voo doméstico",79,79,158,2879,2964,5843,0,0,0,0
"6118",2014-10-01,"sbsj","transporte regular","voo internacional",0,0,0,0,0,0,0,0,0,0
"6119",2014-10-01,"sbsj","transporte não regular","voo doméstico",618,599,1217,2237,2281,4518,0,0,0,0
"6120",2014-10-01,"sbsj","transporte não regular","voo internacional",1,10,11,3,0,3,0,0,0,0
"6121",2014-10-01,"sbsl","transporte regular","voo doméstico",735,737,1472,73819,76310,150129,173,1602,1775,9
"6122",2014-10-01,"sbsl","transporte regular","voo internacional",0,0,0,0,0,0,0,0,0,0
"6123",2014-10-01,"sbsl","transporte não regular","voo doméstico",380,378,758,1317,1398,2715,80999,252917,333916,0
"6124",2014-10-01,"sbsl","transporte não regular","voo internacional",0,0,0,0,0,0,0,0,0,0
"6125",2014-10-01,"sbsn","transporte regular","voo doméstico",488,489,977,29398,25933,55331,0,0,0,0
"6126",2014-10-01,"sbsn","transporte regular","voo internacional",0,0,0,0,0,0,0,0,0,0
"6127",2014-10-01,"sbsn","transporte não regular","voo doméstico",478,476,954,1685,1483,3168,0,0,0,0
"6128",2014-10-01,"sbsn","transporte não regular","voo internacional",2,2,4,0,0,0,0,0,0,0
"6129",2014-10-01,"sbsp","transporte regular","voo doméstico",6795,6842,13637,806492,800133,1606625,0,0,0,0
"6130",2014-10-01,"sbsp","transporte regular","voo internacional",0,0,0,0,0,0,0,0,0,0
"6131",2014-10-01,"sbsp","transporte não regular","voo doméstico",2119,2082,4201,11166,9370,20536,0,0,0,0
"6132",2014-10-01,"sbsp","transporte não regular","voo internacional",0,0,0,0,0,0,0,0,0,0
"6133",2014-10-01,"sbte","transporte regular","voo doméstico",465,468,933,48141,46899,95040,32394,93842,126236,298550
"6134",2014-10-01,"sbte","transporte regular","voo internacional",0,0,0,0,0,0,0,0,0,0
"6135",2014-10-01,"sbte","transporte não regular","voo doméstico",305,302,607,1611,1738,3349,0,0,0,0
"6136",2014-10-01,"sbte","transporte não regular","voo internacional",0,0,0,0,0,0,0,0,0,0
"6137",2014-10-01,"sbtf","transporte regular","voo doméstico",57,57,114,2591,2582,5173,0,0,0,0
"6138",2014-10-01,"sbtf","transporte regular","voo internacional",0,0,0,0,0,0,0,0,0,0
"6139",2014-10-01,"sbtf","transporte não regular","voo doméstico",311,312,623,436,367,803,2090,3641,5731,21022
"6140",2014-10-01,"sbtf","transporte não regular","voo internacional",0,0,0,0,0,0,0,0,0,0
"6141",2014-10-01,"sbtt","transporte regular","voo doméstico",35,35,70,2510,2748,5258,0,0,0,0
"6142",2014-10-01,"sbtt","transporte regular","voo internacional",1,1,2,0,0,0,0,0,0,0
"6143",2014-10-01,"sbtt","transporte não regular","voo doméstico",181,183,364,721,765,1486,4146,3157,7303,691
"6144",2014-10-01,"sbtt","transporte não regular","voo internacional",3,3,6,5,5,10,0,0,0,0
"6145",2014-10-01,"sbuf","transporte regular","voo doméstico",22,22,44,1324,1142,2466,0,0,0,0
"6146",2014-10-01,"sbuf","transporte regular","voo internacional",0,0,0,0,0,0,0,0,0,0
"6147",2014-10-01,"sbuf","transporte não regular","voo doméstico",70,68,138,109,96,205,0,0,0,0
"6148",2014-10-01,"sbuf","transporte não regular","voo internacional",0,0,0,0,0,0,0,0,0,0
"6149",2014-10-01,"sbug","transporte regular","voo doméstico",0,0,0,0,0,0,0,0,0,0
"6150",2014-10-01,"sbug","transporte regular","voo internacional",0,0,0,0,0,0,0,0,0,0
"6151",2014-10-01,"sbug","transporte não regular","voo doméstico",17,17,34,33,26,59,0,0,0,0
"6152",2014-10-01,"sbug","transporte não regular","voo internacional",0,0,0,0,0,0,0,0,0,0
"6153",2014-10-01,"sbul","transporte regular","voo doméstico",665,666,1331,50045,49433,99478,0,0,0,0
"6154",2014-10-01,"sbul","transporte regular","voo internacional",0,0,0,0,0,0,0,0,0,0
"6155",2014-10-01,"sbul","transporte não regular","voo doméstico",620,623,1243,1366,1303,2669,0,0,0,0
"6156",2014-10-01,"sbul","transporte não regular","voo internacional",1,1,2,6,3,9,0,0,0,0
"6157",2014-10-01,"sbur","transporte regular","voo doméstico",176,175,351,7059,7225,14284,0,0,0,0
"6158",2014-10-01,"sbur","transporte regular","voo internacional",0,0,0,0,0,0,0,0,0,0
"6159",2014-10-01,"sbur","transporte não regular","voo doméstico",182,180,362,630,699,1329,0,0,0,0
"6160",2014-10-01,"sbur","transporte não regular","voo internacional",0,0,0,0,0,0,0,0,0,0
"6161",2014-09-01,"sbbe","transporte regular","voo doméstico",1650,1653,3303,147928,150411,298339,53645,217529,271174,0
"6162",2014-09-01,"sbbe","transporte regular","voo internacional",42,41,83,4587,4133,8720,0,46,46,0
"6163",2014-09-01,"sbbe","transporte não regular","voo doméstico",689,692,1381,3634,4054,7688,29516,104588,134104,0
"6164",2014-09-01,"sbbe","transporte não regular","voo internacional",6,8,14,16,12,28,0,0,0,0
"6165",2014-09-01,"sbbg","transporte regular","voo doméstico",0,0,0,0,0,0,0,0,0,0
"6166",2014-09-01,"sbbg","transporte regular","voo internacional",0,0,0,0,0,0,0,0,0,0
"6167",2014-09-01,"sbbg","transporte não regular","voo doméstico",20,21,41,85,79,164,0,0,0,0
"6168",2014-09-01,"sbbg","transporte não regular","voo internacional",1,0,1,0,10,10,0,0,0,0
"6169",2014-09-01,"sbbh","transporte regular","voo doméstico",600,613,1213,30709,34367,65076,0,0,0,0
"6170",2014-09-01,"sbbh","transporte regular","voo internacional",0,0,0,0,0,0,0,0,0,0
"6171",2014-09-01,"sbbh","transporte não regular","voo doméstico",2418,2413,4831,9536,9873,19409,0,0,0,0
"6172",2014-09-01,"sbbh","transporte não regular","voo internacional",1,2,3,10,5,15,0,0,0,0
"6173",2014-09-01,"sbbi","transporte regular","voo doméstico",0,0,0,0,0,0,0,0,0,0
"6174",2014-09-01,"sbbi","transporte regular","voo internacional",0,0,0,0,0,0,0,0,0,0
"6175",2014-09-01,"sbbi","transporte não regular","voo doméstico",1327,1315,2642,6681,6641,13322,0,0,0,0
"6176",2014-09-01,"sbbi","transporte não regular","voo internacional",0,0,0,0,0,0,0,0,0,0
"6177",2014-09-01,"sbbv","transporte regular","voo doméstico",127,127,254,13933,14689,28622,0,0,0,0
"6178",2014-09-01,"sbbv","transporte regular","voo internacional",0,0,0,0,0,0,0,0,0,0
"6179",2014-09-01,"sbbv","transporte não regular","voo doméstico",123,132,255,318,82,400,0,0,0,0
"6180",2014-09-01,"sbbv","transporte não regular","voo internacional",39,24,63,0,10,10,0,0,0,0
"6181",2014-09-01,"sbcg","transporte regular","voo doméstico",643,635,1278,62024,60382,122406,50026,96472,146498,0
"6182",2014-09-01,"sbcg","transporte regular","voo internacional",13,13,26,211,213,424,0,0,0,0
"6183",2014-09-01,"sbcg","transporte não regular","voo doméstico",389,402,791,1339,422,1761,0,0,0,0
"6184",2014-09-01,"sbcg","transporte não regular","voo internacional",15,14,29,0,0,0,0,0,0,0
"6185",2014-09-01,"sbcj","transporte regular","voo doméstico",77,77,154,4685,4282,8967,0,0,0,0
"6186",2014-09-01,"sbcj","transporte regular","voo internacional",0,0,0,0,0,0,0,0,0,0
"6187",2014-09-01,"sbcj","transporte não regular","voo doméstico",113,112,225,176,278,454,0,0,0,0
"6188",2014-09-01,"sbcj","transporte não regular","voo internacional",0,0,0,0,0,0,0,0,0,0
"6189",2014-09-01,"sbcr","transporte regular","voo doméstico",26,26,52,1403,1364,2767,0,0,0,0
"6190",2014-09-01,"sbcr","transporte regular","voo internacional",0,0,0,0,0,0,0,0,0,0
"6191",2014-09-01,"sbcr","transporte não regular","voo doméstico",67,66,133,140,130,270,0,0,0,0
"6192",2014-09-01,"sbcr","transporte não regular","voo internacional",9,9,18,10,7,17,0,0,0,0
"6193",2014-09-01,"sbct","transporte regular","voo doméstico",2947,2948,5895,303152,304152,607304,179646,0,179646,188101
"6194",2014-09-01,"sbct","transporte regular","voo internacional",103,101,204,6016,6511,12527,0,6706,6706,0
"6195",2014-09-01,"sbct","transporte não regular","voo doméstico",224,225,449,1103,2341,3444,0,0,0,0
"6196",2014-09-01,"sbct","transporte não regular","voo internacional",14,18,32,37,39,76,0,7088,7088,0
"6197",2014-09-01,"sbcz","transporte regular","voo doméstico",29,29,58,2439,2459,4898,0,0,0,0
"6198",2014-09-01,"sbcz","transporte regular","voo internacional",0,0,0,0,0,0,0,0,0,0
"6199",2014-09-01,"sbcz","transporte não regular","voo doméstico",303,302,605,1161,1015,2176,0,0,0,0
"6200",2014-09-01,"sbcz","transporte não regular","voo internacional",0,0,0,0,0,0,0,0,0,0
"6201",2014-09-01,"sbeg","transporte regular","voo doméstico",1237,1223,2460,121644,117797,239441,0,0,0,0
"6202",2014-09-01,"sbeg","transporte regular","voo internacional",129,128,257,11331,10282,21613,0,0,0,0
"6203",2014-09-01,"sbeg","transporte não regular","voo doméstico",1074,1084,2158,9472,8954,18426,0,0,0,0
"6204",2014-09-01,"sbeg","transporte não regular","voo internacional",124,131,255,371,348,719,0,0,0,0
"6205",2014-09-01,"sbfi","transporte regular","voo doméstico",546,547,1093,70262,67906,138168,0,0,0,0
"6206",2014-09-01,"sbfi","transporte regular","voo internacional",30,30,60,3614,3818,7432,0,0,0,0
"6207",2014-09-01,"sbfi","transporte não regular","voo doméstico",89,96,185,803,1198,2001,0,0,0,0
"6208",2014-09-01,"sbfi","transporte não regular","voo internacional",27,24,51,39,37,76,0,0,0,0
"6209",2014-09-01,"sbgo","transporte regular","voo doméstico",1485,1481,2966,134461,131308,265769,97921,148596,246517,140483
"6210",2014-09-01,"sbgo","transporte regular","voo internacional",0,0,0,0,0,0,0,0,0,0
"6211",2014-09-01,"sbgo","transporte não regular","voo doméstico",1597,1606,3203,5036,6441,11477,0,0,0,0
"6212",2014-09-01,"sbgo","transporte não regular","voo internacional",7,6,13,0,0,0,0,0,0,0
"6213",2014-09-01,"sbht","transporte regular","voo doméstico",201,198,399,8802,8775,17577,0,0,0,0
"6214",2014-09-01,"sbht","transporte regular","voo internacional",0,0,0,0,0,0,0,0,0,0
"6215",2014-09-01,"sbht","transporte não regular","voo doméstico",379,382,761,1862,1472,3334,2993,6030,9023,1590
"6216",2014-09-01,"sbht","transporte não regular","voo internacional",0,0,0,0,0,0,0,0,0,0
"6217",2014-09-01,"sbiz","transporte regular","voo doméstico",222,221,443,13749,13838,27587,0,0,0,0
"6218",2014-09-01,"sbiz","transporte regular","voo internacional",0,0,0,0,0,0,0,0,0,0
"6219",2014-09-01,"sbiz","transporte não regular","voo doméstico",303,298,601,818,769,1587,0,0,0,0
"6220",2014-09-01,"sbiz","transporte não regular","voo internacional",1,2,3,0,0,0,0,0,0,0
"6221",2014-09-01,"sbjc","transporte regular","voo doméstico",0,1,1,0,0,0,0,0,0,0
"6222",2014-09-01,"sbjc","transporte regular","voo internacional",0,0,0,0,0,0,0,0,0,0
"6223",2014-09-01,"sbjc","transporte não regular","voo doméstico",758,758,1516,1258,1026,2284,0,0,0,0
"6224",2014-09-01,"sbjc","transporte não regular","voo internacional",0,0,0,0,0,0,0,0,0,0
"6225",2014-09-01,"sbjr","transporte regular","voo doméstico",0,0,0,0,0,0,0,0,0,0
"6226",2014-09-01,"sbjr","transporte regular","voo internacional",0,0,0,0,0,0,0,0,0,0
"6227",2014-09-01,"sbjr","transporte não regular","voo doméstico",2888,2883,5771,8923,4903,13826,0,0,0,0
"6228",2014-09-01,"sbjr","transporte não regular","voo internacional",0,0,0,0,0,0,0,0,0,0
"6229",2014-09-01,"sbjv","transporte regular","voo doméstico",224,224,448,20129,19282,39411,0,0,0,0
"6230",2014-09-01,"sbjv","transporte regular","voo internacional",0,0,0,0,0,0,0,0,0,0
"6231",2014-09-01,"sbjv","transporte não regular","voo doméstico",260,261,521,779,889,1668,0,0,0,0
"6232",2014-09-01,"sbjv","transporte não regular","voo internacional",0,0,0,0,0,0,0,0,0,0
"6233",2014-09-01,"sblo","transporte regular","voo doméstico",427,431,858,44331,43221,87552,0,0,0,0
"6234",2014-09-01,"sblo","transporte regular","voo internacional",0,0,0,0,0,0,0,0,0,0
"6235",2014-09-01,"sblo","transporte não regular","voo doméstico",656,642,1298,2283,3253,5536,0,0,0,0
"6236",2014-09-01,"sblo","transporte não regular","voo internacional",1,1,2,0,0,0,0,0,0,0
"6237",2014-09-01,"sbma","transporte regular","voo doméstico",345,345,690,17043,16985,34028,0,0,0,0
"6238",2014-09-01,"sbma","transporte regular","voo internacional",0,0,0,0,0,0,0,0,0,0
"6239",2014-09-01,"sbma","transporte não regular","voo doméstico",456,454,910,1680,1655,3335,0,0,0,0
"6240",2014-09-01,"sbma","transporte não regular","voo internacional",5,5,10,0,0,0,0,0,0,0
"6241",2014-09-01,"sbmk","transporte regular","voo doméstico",191,191,382,13818,13749,27567,0,0,0,0
"6242",2014-09-01,"sbmk","transporte regular","voo internacional",0,0,0,0,0,0,0,0,0,0
"6243",2014-09-01,"sbmk","transporte não regular","voo doméstico",361,362,723,6,1,7,0,0,0,0
"6244",2014-09-01,"sbmk","transporte não regular","voo internacional",0,0,0,0,0,0,0,0,0,0
"6245",2014-09-01,"sbmq","transporte regular","voo doméstico",332,330,662,26810,27876,54686,25580,36400,61980,0
"6246",2014-09-01,"sbmq","transporte regular","voo internacional",0,0,0,0,0,0,0,0,0,0
"6247",2014-09-01,"sbmq","transporte não regular","voo doméstico",290,299,589,308,163,471,0,0,0,0
"6248",2014-09-01,"sbmq","transporte não regular","voo internacional",9,6,15,0,0,0,0,0,0,0
"6249",2014-09-01,"sbmt","transporte regular","voo doméstico",0,0,0,0,0,0,0,0,0,0
"6250",2014-09-01,"sbmt","transporte regular","voo internacional",0,0,0,0,0,0,0,0,0,0
"6251",2014-09-01,"sbmt","transporte não regular","voo doméstico",4598,4564,9162,7400,7169,14569,0,0,0,0
"6252",2014-09-01,"sbmt","transporte não regular","voo internacional",0,0,0,0,0,0,0,0,0,0
"6253",2014-09-01,"sbnf","transporte regular","voo doméstico",569,569,1138,54343,56226,110569,64,0,64,0
"6254",2014-09-01,"sbnf","transporte regular","voo internacional",0,0,0,0,0,0,0,0,0,0
"6255",2014-09-01,"sbnf","transporte não regular","voo doméstico",247,245,492,678,845,1523,0,0,0,0
"6256",2014-09-01,"sbnf","transporte não regular","voo internacional",5,6,11,10,3,13,0,0,0,0
"6257",2014-09-01,"sbpb","transporte regular","voo doméstico",20,20,40,639,682,1321,0,0,0,0
"6258",2014-09-01,"sbpb","transporte regular","voo internacional",0,0,0,0,0,0,0,0,0,0
"6259",2014-09-01,"sbpb","transporte não regular","voo doméstico",100,100,200,200,188,388,0,0,0,0
"6260",2014-09-01,"sbpb","transporte não regular","voo internacional",0,0,0,0,0,0,0,0,0,0
"6261",2014-09-01,"sbpj","transporte regular","voo doméstico",350,350,700,26207,25926,52133,0,0,0,0
"6262",2014-09-01,"sbpj","transporte regular","voo internacional",0,0,0,0,0,0,0,0,0,0
"6263",2014-09-01,"sbpj","transporte não regular","voo doméstico",515,514,1029,901,453,1354,0,0,0,0
"6264",2014-09-01,"sbpj","transporte não regular","voo internacional",3,3,6,2,0,2,0,0,0,0
"6265",2014-09-01,"sbpk","transporte regular","voo doméstico",49,49,98,2322,2347,4669,0,0,0,0
"6266",2014-09-01,"sbpk","transporte regular","voo internacional",0,0,0,0,0,0,0,0,0,0
"6267",2014-09-01,"sbpk","transporte não regular","voo doméstico",45,45,90,114,129,243,0,0,0,0
"6268",2014-09-01,"sbpk","transporte não regular","voo internacional",3,2,5,5,6,11,0,0,0,0
"6269",2014-09-01,"sbpl","transporte regular","voo doméstico",206,205,411,20198,20760,40958,0,0,0,0
"6270",2014-09-01,"sbpl","transporte regular","voo internacional",4,4,8,0,0,0,0,0,0,0
"6271",2014-09-01,"sbpl","transporte não regular","voo doméstico",127,127,254,192,174,366,0,0,0,0
"6272",2014-09-01,"sbpl","transporte não regular","voo internacional",1,1,2,0,0,0,0,0,0,0
"6273",2014-09-01,"sbpp","transporte regular","voo doméstico",0,0,0,0,0,0,0,0,0,0
"6274",2014-09-01,"sbpp","transporte regular","voo internacional",0,0,0,0,0,0,0,0,0,0
"6275",2014-09-01,"sbpp","transporte não regular","voo doméstico",87,85,172,154,160,314,0,0,0,0
"6276",2014-09-01,"sbpp","transporte não regular","voo internacional",7,8,15,13,9,22,0,0,0,0
"6277",2014-09-01,"sbpr","transporte regular","voo doméstico",0,0,0,0,0,0,0,0,0,0
"6278",2014-09-01,"sbpr","transporte regular","voo internacional",0,0,0,0,0,0,0,0,0,0
"6279",2014-09-01,"sbpr","transporte não regular","voo doméstico",1573,1569,3142,1832,1735,3567,0,0,0,0
"6280",2014-09-01,"sbpr","transporte não regular","voo internacional",1,2,3,0,0,0,0,0,0,0
"6281",2014-09-01,"sbpv","transporte regular","voo doméstico",423,423,846,36344,33377,69721,0,0,0,0
"6282",2014-09-01,"sbpv","transporte regular","voo internacional",0,0,0,0,0,0,0,0,0,0
"6283",2014-09-01,"sbpv","transporte não regular","voo doméstico",328,339,667,59,64,123,0,0,0,0
"6284",2014-09-01,"sbpv","transporte não regular","voo internacional",0,0,0,0,0,0,0,0,0,0
"6285",2014-09-01,"sbrb","transporte regular","voo doméstico",159,158,317,15634,15707,31341,0,0,0,0
"6286",2014-09-01,"sbrb","transporte regular","voo internacional",0,0,0,0,0,0,0,0,0,0
"6287",2014-09-01,"sbrb","transporte não regular","voo doméstico",251,254,505,741,395,1136,0,0,0,0
"6288",2014-09-01,"sbrb","transporte não regular","voo internacional",0,0,0,0,0,0,0,0,0,0
"6289",2014-09-01,"sbrj","transporte regular","voo doméstico",4609,4617,9226,453809,445536,899345,0,150,150,99
"6290",2014-09-01,"sbrj","transporte regular","voo internacional",0,0,0,0,0,0,0,0,0,0
"6291",2014-09-01,"sbrj","transporte não regular","voo doméstico",978,967,1945,131,417,548,0,0,0,0
"6292",2014-09-01,"sbrj","transporte não regular","voo internacional",0,0,0,0,0,0,0,0,0,0
"6293",2014-09-01,"sbsj","transporte regular","voo doméstico",76,75,151,1608,1570,3178,0,0,0,0
"6294",2014-09-01,"sbsj","transporte regular","voo internacional",0,0,0,0,0,0,0,0,0,0
"6295",2014-09-01,"sbsj","transporte não regular","voo doméstico",542,521,1063,1767,1094,2861,0,0,0,0
"6296",2014-09-01,"sbsj","transporte não regular","voo internacional",2,10,12,8,6,14,0,0,0,0
"6297",2014-09-01,"sbsl","transporte regular","voo doméstico",670,674,1344,69513,72654,142167,265,0,265,0
"6298",2014-09-01,"sbsl","transporte regular","voo internacional",0,0,0,0,0,0,0,0,0,0
"6299",2014-09-01,"sbsl","transporte não regular","voo doméstico",501,498,999,1259,1495,2754,79471,204897,284368,0
"6300",2014-09-01,"sbsl","transporte não regular","voo internacional",1,0,1,0,0,0,0,0,0,0
"6301",2014-09-01,"sbsn","transporte regular","voo doméstico",455,456,911,26854,24911,51765,0,0,0,0
"6302",2014-09-01,"sbsn","transporte regular","voo internacional",0,0,0,0,0,0,0,0,0,0
"6303",2014-09-01,"sbsn","transporte não regular","voo doméstico",448,446,894,1765,1186,2951,0,0,0,0
"6304",2014-09-01,"sbsn","transporte não regular","voo internacional",2,1,3,0,0,0,0,0,0,0
"6305",2014-09-01,"sbsp","transporte regular","voo doméstico",6607,6643,13250,755848,747670,1503518,0,0,0,0
"6306",2014-09-01,"sbsp","transporte regular","voo internacional",0,0,0,0,0,0,0,0,0,0
"6307",2014-09-01,"sbsp","transporte não regular","voo doméstico",2079,2046,4125,11031,8560,19591,0,0,0,0
"6308",2014-09-01,"sbsp","transporte não regular","voo internacional",0,0,0,0,0,0,0,0,0,0
"6309",2014-09-01,"sbte","transporte regular","voo doméstico",441,441,882,43540,45094,88634,25221,88432,113653,294100
"6310",2014-09-01,"sbte","transporte regular","voo internacional",0,0,0,0,0,0,0,0,0,0
"6311",2014-09-01,"sbte","transporte não regular","voo doméstico",492,492,984,2316,2368,4684,0,0,0,0
"6312",2014-09-01,"sbte","transporte não regular","voo internacional",0,0,0,0,0,0,0,0,0,0
"6313",2014-09-01,"sbtf","transporte regular","voo doméstico",55,55,110,2289,2465,4754,0,0,0,0
"6314",2014-09-01,"sbtf","transporte regular","voo internacional",0,0,0,0,0,0,0,0,0,0
"6315",2014-09-01,"sbtf","transporte não regular","voo doméstico",386,387,773,672,693,1365,2688,4475,7163,24440
"6316",2014-09-01,"sbtf","transporte não regular","voo internacional",0,0,0,0,0,0,0,0,0,0
"6317",2014-09-01,"sbtt","transporte regular","voo doméstico",32,32,64,2484,3098,5582,0,0,0,0
"6318",2014-09-01,"sbtt","transporte regular","voo internacional",0,0,0,0,0,0,0,0,0,0
"6319",2014-09-01,"sbtt","transporte não regular","voo doméstico",215,212,427,1002,879,1881,1549,3877,5426,731
"6320",2014-09-01,"sbtt","transporte não regular","voo internacional",1,1,2,3,3,6,0,0,0,0
"6321",2014-09-01,"sbuf","transporte regular","voo doméstico",22,22,44,1299,1251,2550,0,0,0,0
"6322",2014-09-01,"sbuf","transporte regular","voo internacional",0,0,0,0,0,0,0,0,0,0
"6323",2014-09-01,"sbuf","transporte não regular","voo doméstico",78,79,157,171,133,304,0,0,0,0
"6324",2014-09-01,"sbuf","transporte não regular","voo internacional",0,0,0,0,0,0,0,0,0,0
"6325",2014-09-01,"sbug","transporte regular","voo doméstico",0,0,0,0,0,0,0,0,0,0
"6326",2014-09-01,"sbug","transporte regular","voo internacional",0,0,0,0,0,0,0,0,0,0
"6327",2014-09-01,"sbug","transporte não regular","voo doméstico",15,15,30,55,43,98,0,0,0,0
"6328",2014-09-01,"sbug","transporte não regular","voo internacional",0,0,0,0,0,0,0,0,0,0
"6329",2014-09-01,"sbul","transporte regular","voo doméstico",637,637,1274,46331,45749,92080,0,0,0,0
"6330",2014-09-01,"sbul","transporte regular","voo internacional",0,0,0,0,0,0,0,0,0,0
"6331",2014-09-01,"sbul","transporte não regular","voo doméstico",620,624,1244,1323,1270,2593,0,0,0,0
"6332",2014-09-01,"sbul","transporte não regular","voo internacional",1,1,2,7,5,12,0,0,0,0
"6333",2014-09-01,"sbur","transporte regular","voo doméstico",181,180,361,6413,6438,12851,0,0,0,0
"6334",2014-09-01,"sbur","transporte regular","voo internacional",0,0,0,0,0,0,0,0,0,0
"6335",2014-09-01,"sbur","transporte não regular","voo doméstico",245,248,493,1008,959,1967,0,0,0,0
"6336",2014-09-01,"sbur","transporte não regular","voo internacional",0,0,0,0,0,0,0,0,0,0
"6337",2015-04-01,"sbbe","transporte regular","voo doméstico",1625,1647,3272,146518,142997,289515,84623,274193,358816,0
"6338",2015-04-01,"sbbe","transporte regular","voo internacional",38,38,76,3842,3586,7428,0,15,15,0
"6339",2015-04-01,"sbbe","transporte não regular","voo doméstico",534,513,1047,3348,5394,8742,0,0,0,0
"6340",2015-04-01,"sbbe","transporte não regular","voo internacional",11,13,24,32,20,52,0,0,0,0
"6341",2015-04-01,"sbbg","transporte regular","voo doméstico",0,0,0,0,0,0,0,0,0,0
"6342",2015-04-01,"sbbg","transporte regular","voo internacional",0,0,0,0,0,0,0,0,0,0
"6343",2015-04-01,"sbbg","transporte não regular","voo doméstico",18,18,36,73,74,147,0,0,0,0
"6344",2015-04-01,"sbbg","transporte não regular","voo internacional",3,2,5,0,3,3,0,0,0,0
"6345",2015-04-01,"sbbh","transporte regular","voo doméstico",471,480,951,48029,25446,73475,0,0,0,0
"6346",2015-04-01,"sbbh","transporte regular","voo internacional",0,0,0,0,0,0,0,0,0,0
"6347",2015-04-01,"sbbh","transporte não regular","voo doméstico",1935,1946,3881,10262,9479,19741,0,0,0,0
"6348",2015-04-01,"sbbh","transporte não regular","voo internacional",9,9,18,47,47,94,0,0,0,0
"6349",2015-04-01,"sbbi","transporte regular","voo doméstico",0,0,0,0,0,0,0,0,0,0
"6350",2015-04-01,"sbbi","transporte regular","voo internacional",0,0,0,0,0,0,0,0,0,0
"6351",2015-04-01,"sbbi","transporte não regular","voo doméstico",1267,1277,2544,1919,1969,3888,0,0,0,0
"6352",2015-04-01,"sbbi","transporte não regular","voo internacional",0,0,0,0,0,0,0,0,0,0
"6353",2015-04-01,"sbbv","transporte regular","voo doméstico",105,105,210,14083,14016,28099,0,0,0,0
"6354",2015-04-01,"sbbv","transporte regular","voo internacional",0,0,0,0,0,0,0,0,0,0
"6355",2015-04-01,"sbbv","transporte não regular","voo doméstico",208,212,420,378,176,554,0,0,0,0
"6356",2015-04-01,"sbbv","transporte não regular","voo internacional",18,12,30,7,2,9,0,0,0,0
"6357",2015-04-01,"sbcg","transporte regular","voo doméstico",633,632,1265,65948,66385,132333,0,38525,38525,0
"6358",2015-04-01,"sbcg","transporte regular","voo internacional",0,0,0,0,0,0,0,0,0,0
"6359",2015-04-01,"sbcg","transporte não regular","voo doméstico",287,287,574,390,445,835,0,0,0,0
"6360",2015-04-01,"sbcg","transporte não regular","voo internacional",24,23,47,165,140,305,0,0,0,0
"6361",2015-04-01,"sbcj","transporte regular","voo doméstico",137,137,274,10679,10117,20796,0,0,0,0
"6362",2015-04-01,"sbcj","transporte regular","voo internacional",0,0,0,0,0,0,0,0,0,0
"6363",2015-04-01,"sbcj","transporte não regular","voo doméstico",92,92,184,366,149,515,0,0,0,0
"6364",2015-04-01,"sbcj","transporte não regular","voo internacional",0,0,0,0,0,0,0,0,0,0
"6365",2015-04-01,"sbcr","transporte regular","voo doméstico",26,26,52,1501,1380,2881,0,0,0,0
"6366",2015-04-01,"sbcr","transporte regular","voo internacional",0,0,0,0,0,0,0,0,0,0
"6367",2015-04-01,"sbcr","transporte não regular","voo doméstico",46,44,90,113,101,214,0,0,0,0
"6368",2015-04-01,"sbcr","transporte não regular","voo internacional",7,3,10,14,16,30,0,0,0,0
"6369",2015-04-01,"sbct","transporte regular","voo doméstico",2772,2770,5542,306657,299436,606093,170705,8557,179262,160311
"6370",2015-04-01,"sbct","transporte regular","voo internacional",105,105,210,5933,5219,11152,0,2337,2337,0
"6371",2015-04-01,"sbct","transporte não regular","voo doméstico",167,174,341,1931,1388,3319,0,0,0,0
"6372",2015-04-01,"sbct","transporte não regular","voo internacional",12,11,23,42,53,95,0,0,0,0
"6373",2015-04-01,"sbcz","transporte regular","voo doméstico",30,30,60,2830,2712,5542,0,0,0,0
"6374",2015-04-01,"sbcz","transporte regular","voo internacional",0,0,0,0,0,0,0,0,0,0
"6375",2015-04-01,"sbcz","transporte não regular","voo doméstico",136,135,271,512,481,993,0,0,0,0
"6376",2015-04-01,"sbcz","transporte não regular","voo internacional",0,0,0,0,0,0,0,0,0,0
"6377",2015-04-01,"sbeg","transporte regular","voo doméstico",1177,1170,2347,111101,108801,219902,0,0,0,0
"6378",2015-04-01,"sbeg","transporte regular","voo internacional",133,133,266,8006,6584,14590,0,0,0,0
"6379",2015-04-01,"sbeg","transporte não regular","voo doméstico",529,547,1076,5801,5418,11219,0,0,0,0
"6380",2015-04-01,"sbeg","transporte não regular","voo internacional",102,99,201,609,773,1382,0,0,0,0
"6381",2015-04-01,"sbfi","transporte regular","voo doméstico",624,619,1243,77303,76591,153894,0,0,0,0
"6382",2015-04-01,"sbfi","transporte regular","voo internacional",25,25,50,3258,3059,6317,0,0,0,0
"6383",2015-04-01,"sbfi","transporte não regular","voo doméstico",121,122,243,1845,2072,3917,0,0,0,0
"6384",2015-04-01,"sbfi","transporte não regular","voo internacional",49,46,95,250,83,333,0,0,0,0
"6385",2015-04-01,"sbgo","transporte regular","voo doméstico",1358,1360,2718,136807,133722,270529,90943,166437,257380,184775
"6386",2015-04-01,"sbgo","transporte regular","voo internacional",0,0,0,0,0,0,0,0,0,0
"6387",2015-04-01,"sbgo","transporte não regular","voo doméstico",1223,1232,2455,4061,5064,9125,0,0,0,0
"6388",2015-04-01,"sbgo","transporte não regular","voo internacional",5,7,12,0,0,0,0,0,0,0
"6389",2015-04-01,"sbht","transporte regular","voo doméstico",334,335,669,16706,15800,32506,0,0,0,0
"6390",2015-04-01,"sbht","transporte regular","voo internacional",0,0,0,0,0,0,0,0,0,0
"6391",2015-04-01,"sbht","transporte não regular","voo doméstico",196,199,395,738,664,1402,920,610,1530,220
"6392",2015-04-01,"sbht","transporte não regular","voo internacional",0,0,0,0,0,0,0,0,0,0
"6393",2015-04-01,"sbiz","transporte regular","voo doméstico",230,230,460,13197,12837,26034,0,0,0,19237
"6394",2015-04-01,"sbiz","transporte regular","voo internacional",0,0,0,0,0,0,0,0,0,0
"6395",2015-04-01,"sbiz","transporte não regular","voo doméstico",142,141,283,442,411,853,0,0,0,0
"6396",2015-04-01,"sbiz","transporte não regular","voo internacional",0,0,0,0,0,0,0,0,0,0
"6397",2015-04-01,"sbjc","transporte regular","voo doméstico",0,0,0,0,0,0,0,0,0,0
"6398",2015-04-01,"sbjc","transporte regular","voo internacional",0,0,0,0,0,0,0,0,0,0
"6399",2015-04-01,"sbjc","transporte não regular","voo doméstico",338,334,672,619,494,1113,0,0,0,0
"6400",2015-04-01,"sbjc","transporte não regular","voo internacional",4,4,8,0,0,0,0,0,0,0
"6401",2015-04-01,"sbjr","transporte regular","voo doméstico",0,0,0,0,0,0,0,0,0,0
"6402",2015-04-01,"sbjr","transporte regular","voo internacional",0,0,0,0,0,0,0,0,0,0
"6403",2015-04-01,"sbjr","transporte não regular","voo doméstico",2559,2554,5113,8651,6382,15033,0,0,0,0
"6404",2015-04-01,"sbjr","transporte não regular","voo internacional",0,0,0,0,0,0,0,0,0,0
"6405",2015-04-01,"sbjv","transporte regular","voo doméstico",236,235,471,21638,20779,42417,0,0,0,0
"6406",2015-04-01,"sbjv","transporte regular","voo internacional",0,0,0,0,0,0,0,0,0,0
"6407",2015-04-01,"sbjv","transporte não regular","voo doméstico",192,196,388,100,427,527,0,0,0,0
"6408",2015-04-01,"sbjv","transporte não regular","voo internacional",0,0,0,0,0,0,0,0,0,0
"6409",2015-04-01,"sblo","transporte regular","voo doméstico",467,472,939,46314,44324,90638,0,0,0,0
"6410",2015-04-01,"sblo","transporte regular","voo internacional",0,0,0,0,0,0,0,0,0,0
"6411",2015-04-01,"sblo","transporte não regular","voo doméstico",676,675,1351,530,800,1330,0,0,0,0
"6412",2015-04-01,"sblo","transporte não regular","voo internacional",5,5,10,0,0,0,0,0,0,0
"6413",2015-04-01,"sbma","transporte regular","voo doméstico",321,319,640,15031,14827,29858,0,0,0,0
"6414",2015-04-01,"sbma","transporte regular","voo internacional",0,0,0,0,0,0,0,0,0,0
"6415",2015-04-01,"sbma","transporte não regular","voo doméstico",281,282,563,1120,1028,2148,0,0,0,0
"6416",2015-04-01,"sbma","transporte não regular","voo internacional",4,4,8,0,0,0,0,0,0,0
"6417",2015-04-01,"sbmk","transporte regular","voo doméstico",194,193,387,18701,17975,36676,0,0,0,0
"6418",2015-04-01,"sbmk","transporte regular","voo internacional",0,0,0,0,0,0,0,0,0,0
"6419",2015-04-01,"sbmk","transporte não regular","voo doméstico",228,228,456,73,176,249,0,0,0,0
"6420",2015-04-01,"sbmk","transporte não regular","voo internacional",1,1,2,0,0,0,0,0,0,0
"6421",2015-04-01,"sbmq","transporte regular","voo doméstico",286,286,572,27374,27056,54430,14850,29257,44107,0
"6422",2015-04-01,"sbmq","transporte regular","voo internacional",0,0,0,0,0,0,0,0,0,0
"6423",2015-04-01,"sbmq","transporte não regular","voo doméstico",142,141,283,249,228,477,0,0,0,0
"6424",2015-04-01,"sbmq","transporte não regular","voo internacional",10,9,19,0,0,0,0,0,0,0
"6425",2015-04-01,"sbmt","transporte regular","voo doméstico",0,0,0,0,0,0,0,0,0,0
"6426",2015-04-01,"sbmt","transporte regular","voo internacional",0,0,0,0,0,0,0,0,0,0
"6427",2015-04-01,"sbmt","transporte não regular","voo doméstico",4248,4262,8510,6595,6503,13098,0,0,0,0
"6428",2015-04-01,"sbmt","transporte não regular","voo internacional",0,0,0,0,0,0,0,0,0,0
"6429",2015-04-01,"sbnf","transporte regular","voo doméstico",573,577,1150,60437,59534,119971,0,0,0,0
"6430",2015-04-01,"sbnf","transporte regular","voo internacional",0,0,0,0,0,0,0,0,0,0
"6431",2015-04-01,"sbnf","transporte não regular","voo doméstico",343,340,683,864,1199,2063,0,0,0,0
"6432",2015-04-01,"sbnf","transporte não regular","voo internacional",9,9,18,24,15,39,0,0,0,0
"6433",2015-04-01,"sbpb","transporte regular","voo doméstico",21,21,42,644,612,1256,0,0,0,0
"6434",2015-04-01,"sbpb","transporte regular","voo internacional",0,0,0,0,0,0,0,0,0,0
"6435",2015-04-01,"sbpb","transporte não regular","voo doméstico",53,47,100,82,94,176,0,0,0,0
"6436",2015-04-01,"sbpb","transporte não regular","voo internacional",0,0,0,0,0,0,0,0,0,0
"6437",2015-04-01,"sbpj","transporte regular","voo doméstico",354,332,686,23965,26194,50159,0,0,0,0
"6438",2015-04-01,"sbpj","transporte regular","voo internacional",0,0,0,0,0,0,0,0,0,0
"6439",2015-04-01,"sbpj","transporte não regular","voo doméstico",291,314,605,3436,335,3771,0,0,0,0
"6440",2015-04-01,"sbpj","transporte não regular","voo internacional",7,7,14,0,0,0,0,0,0,0
"6441",2015-04-01,"sbpk","transporte regular","voo doméstico",41,42,83,2280,2084,4364,0,0,0,0
"6442",2015-04-01,"sbpk","transporte regular","voo internacional",0,0,0,0,0,0,0,0,0,0
"6443",2015-04-01,"sbpk","transporte não regular","voo doméstico",60,54,114,133,218,351,0,0,0,0
"6444",2015-04-01,"sbpk","transporte não regular","voo internacional",3,7,10,24,16,40,0,0,0,0
"6445",2015-04-01,"sbpl","transporte regular","voo doméstico",138,138,276,18193,17955,36148,0,0,0,0
"6446",2015-04-01,"sbpl","transporte regular","voo internacional",4,4,8,0,0,0,0,0,0,0
"6447",2015-04-01,"sbpl","transporte não regular","voo doméstico",80,79,159,94,93,187,0,0,0,0
"6448",2015-04-01,"sbpl","transporte não regular","voo internacional",0,0,0,0,0,0,0,0,0,0
"6449",2015-04-01,"sbpp","transporte regular","voo doméstico",0,0,0,0,0,0,0,0,0,0
"6450",2015-04-01,"sbpp","transporte regular","voo internacional",0,0,0,0,0,0,0,0,0,0
"6451",2015-04-01,"sbpp","transporte não regular","voo doméstico",82,78,160,147,137,284,0,0,0,0
"6452",2015-04-01,"sbpp","transporte não regular","voo internacional",9,12,21,18,13,31,0,0,0,0
"6453",2015-04-01,"sbpr","transporte regular","voo doméstico",0,0,0,0,0,0,0,0,0,0
"6454",2015-04-01,"sbpr","transporte regular","voo internacional",0,0,0,0,0,0,0,0,0,0
"6455",2015-04-01,"sbpr","transporte não regular","voo doméstico",1046,1056,2102,1342,1231,2573,0,0,0,0
"6456",2015-04-01,"sbpr","transporte não regular","voo internacional",0,1,1,0,0,0,0,0,0,0
"6457",2015-04-01,"sbpv","transporte regular","voo doméstico",417,416,833,37028,35782,72810,0,0,0,0
"6458",2015-04-01,"sbpv","transporte regular","voo internacional",0,0,0,0,0,0,0,0,0,0
"6459",2015-04-01,"sbpv","transporte não regular","voo doméstico",217,222,439,0,135,135,0,0,0,0
"6460",2015-04-01,"sbpv","transporte não regular","voo internacional",2,2,4,0,0,0,0,0,0,0
"6461",2015-04-01,"sbrb","transporte regular","voo doméstico",155,155,310,14986,13959,28945,0,115,115,181
"6462",2015-04-01,"sbrb","transporte regular","voo internacional",0,0,0,0,0,0,0,0,0,0
"6463",2015-04-01,"sbrb","transporte não regular","voo doméstico",127,125,252,283,219,502,0,0,0,0
"6464",2015-04-01,"sbrb","transporte não regular","voo internacional",0,0,0,0,0,0,0,0,0,0
"6465",2015-04-01,"sbrj","transporte regular","voo doméstico",4253,4268,8521,416910,412465,829375,0,0,0,0
"6466",2015-04-01,"sbrj","transporte regular","voo internacional",0,0,0,0,0,0,0,0,0,0
"6467",2015-04-01,"sbrj","transporte não regular","voo doméstico",774,755,1529,1016,920,1936,0,0,0,0
"6468",2015-04-01,"sbrj","transporte não regular","voo internacional",0,0,0,0,0,0,0,0,0,0
"6469",2015-04-01,"sbsj","transporte regular","voo doméstico",0,0,0,0,0,0,0,0,0,0
"6470",2015-04-01,"sbsj","transporte regular","voo internacional",0,0,0,0,0,0,0,0,0,0
"6471",2015-04-01,"sbsj","transporte não regular","voo doméstico",578,558,1136,1243,1164,2407,0,0,0,0
"6472",2015-04-01,"sbsj","transporte não regular","voo internacional",5,15,20,16,0,16,0,0,0,0
"6473",2015-04-01,"sbsl","transporte regular","voo doméstico",631,631,1262,62569,64121,126690,0,0,0,0
"6474",2015-04-01,"sbsl","transporte regular","voo internacional",0,0,0,0,0,0,0,0,0,0
"6475",2015-04-01,"sbsl","transporte não regular","voo doméstico",197,198,395,839,1024,1863,61713,173437,235150,0
"6476",2015-04-01,"sbsl","transporte não regular","voo internacional",0,0,0,0,0,0,0,0,0,0
"6477",2015-04-01,"sbsn","transporte regular","voo doméstico",429,429,858,26770,24866,51636,0,166,166,0
"6478",2015-04-01,"sbsn","transporte regular","voo internacional",0,0,0,0,0,0,0,0,0,0
"6479",2015-04-01,"sbsn","transporte não regular","voo doméstico",361,363,724,840,612,1452,0,0,0,0
"6480",2015-04-01,"sbsn","transporte não regular","voo internacional",1,1,2,12,0,12,0,0,0,0
"6481",2015-04-01,"sbsp","transporte regular","voo doméstico",6972,7003,13975,806207,805897,1612104,0,0,0,0
"6482",2015-04-01,"sbsp","transporte regular","voo internacional",0,0,0,0,0,0,0,0,0,0
"6483",2015-04-01,"sbsp","transporte não regular","voo doméstico",1914,1891,3805,9385,8938,18323,0,0,0,0
"6484",2015-04-01,"sbsp","transporte não regular","voo internacional",0,0,0,0,0,0,0,0,0,0
"6485",2015-04-01,"sbte","transporte regular","voo doméstico",490,487,977,47408,46925,94333,19304,91938,111242,220043
"6486",2015-04-01,"sbte","transporte regular","voo internacional",0,0,0,0,0,0,0,0,0,0
"6487",2015-04-01,"sbte","transporte não regular","voo doméstico",215,218,433,1595,1522,3117,0,0,0,0
"6488",2015-04-01,"sbte","transporte não regular","voo internacional",0,0,0,0,0,0,0,0,0,0
"6489",2015-04-01,"sbtf","transporte regular","voo doméstico",38,38,76,1934,1933,3867,0,0,0,0
"6490",2015-04-01,"sbtf","transporte regular","voo internacional",0,0,0,0,0,0,0,0,0,0
"6491",2015-04-01,"sbtf","transporte não regular","voo doméstico",215,215,430,862,716,1578,1675,4098,5773,21188
"6492",2015-04-01,"sbtf","transporte não regular","voo internacional",0,0,0,0,0,0,0,0,0,0
"6493",2015-04-01,"sbtt","transporte regular","voo doméstico",30,30,60,2114,2592,4706,0,0,0,0
"6494",2015-04-01,"sbtt","transporte regular","voo internacional",0,0,0,0,0,0,0,0,0,0
"6495",2015-04-01,"sbtt","transporte não regular","voo doméstico",86,88,174,410,322,732,1811,4355,6166,771
"6496",2015-04-01,"sbtt","transporte não regular","voo internacional",2,2,4,1,3,4,0,0,0,0
"6497",2015-04-01,"sbuf","transporte regular","voo doméstico",19,19,38,1051,984,2035,0,0,0,0
"6498",2015-04-01,"sbuf","transporte regular","voo internacional",0,0,0,0,0,0,0,0,0,0
"6499",2015-04-01,"sbuf","transporte não regular","voo doméstico",48,49,97,261,228,489,0,0,0,0
"6500",2015-04-01,"sbuf","transporte não regular","voo internacional",0,0,0,0,0,0,0,0,0,0
"6501",2015-04-01,"sbug","transporte regular","voo doméstico",0,0,0,0,0,0,0,0,0,0
"6502",2015-04-01,"sbug","transporte regular","voo internacional",0,0,0,0,0,0,0,0,0,0
"6503",2015-04-01,"sbug","transporte não regular","voo doméstico",16,16,32,30,30,60,0,0,0,0
"6504",2015-04-01,"sbug","transporte não regular","voo internacional",0,0,0,0,0,0,0,0,0,0
"6505",2015-04-01,"sbul","transporte regular","voo doméstico",585,586,1171,48677,47849,96526,0,0,0,0
"6506",2015-04-01,"sbul","transporte regular","voo internacional",0,0,0,0,0,0,0,0,0,0
"6507",2015-04-01,"sbul","transporte não regular","voo doméstico",629,626,1255,1555,1395,2950,0,0,0,0
"6508",2015-04-01,"sbul","transporte não regular","voo internacional",1,1,2,8,6,14,0,0,0,0
"6509",2015-04-01,"sbur","transporte regular","voo doméstico",118,118,236,5640,5901,11541,0,0,0,0
"6510",2015-04-01,"sbur","transporte regular","voo internacional",0,0,0,0,0,0,0,0,0,0
"6511",2015-04-01,"sbur","transporte não regular","voo doméstico",184,171,355,707,892,1599,0,0,0,0
"6512",2015-04-01,"sbur","transporte não regular","voo internacional",2,2,4,0,0,0,0,0,0,0
"6513",2015-08-01,"sbbe","transporte regular","voo doméstico",1541,1544,3085,147505,148389,295894,106716,315946,422662,0
"6514",2015-08-01,"sbbe","transporte regular","voo internacional",42,44,86,4778,4750,9528,0,0,0,0
"6515",2015-08-01,"sbbe","transporte não regular","voo doméstico",545,539,1084,2752,2776,5528,0,0,0,0
"6516",2015-08-01,"sbbe","transporte não regular","voo internacional",11,9,20,20,73,93,0,0,0,0
"6517",2015-08-01,"sbbg","transporte regular","voo doméstico",0,0,0,0,0,0,0,0,0,0
"6518",2015-08-01,"sbbg","transporte regular","voo internacional",0,0,0,0,0,0,0,0,0,0
"6519",2015-08-01,"sbbg","transporte não regular","voo doméstico",15,15,30,51,47,98,0,0,0,0
"6520",2015-08-01,"sbbg","transporte não regular","voo internacional",0,0,0,0,0,0,0,0,0,0
"6521",2015-08-01,"sbbh","transporte regular","voo doméstico",319,326,645,16900,16092,32992,0,0,0,0
"6522",2015-08-01,"sbbh","transporte regular","voo internacional",0,0,0,0,0,0,0,0,0,0
"6523",2015-08-01,"sbbh","transporte não regular","voo doméstico",1910,1893,3803,8603,8777,17380,0,0,0,0
"6524",2015-08-01,"sbbh","transporte não regular","voo internacional",11,11,22,72,72,144,0,0,0,0
"6525",2015-08-01,"sbbi","transporte regular","voo doméstico",0,0,0,0,0,0,0,0,0,0
"6526",2015-08-01,"sbbi","transporte regular","voo internacional",0,0,0,0,0,0,0,0,0,0
"6527",2015-08-01,"sbbi","transporte não regular","voo doméstico",1283,1282,2565,6024,6025,12049,0,0,0,0
"6528",2015-08-01,"sbbi","transporte não regular","voo internacional",6,7,13,0,0,0,0,0,0,0
"6529",2015-08-01,"sbbv","transporte regular","voo doméstico",108,109,217,14000,14334,28334,0,205,205,0
"6530",2015-08-01,"sbbv","transporte regular","voo internacional",0,0,0,0,0,0,0,0,0,0
"6531",2015-08-01,"sbbv","transporte não regular","voo doméstico",220,217,437,82,29,111,0,0,0,0
"6532",2015-08-01,"sbbv","transporte não regular","voo internacional",11,9,20,3,0,3,0,0,0,0
"6533",2015-08-01,"sbcg","transporte regular","voo doméstico",665,668,1333,61816,61351,123167,65497,133579,199076,0
"6534",2015-08-01,"sbcg","transporte regular","voo internacional",5,5,10,106,62,168,0,0,0,0
"6535",2015-08-01,"sbcg","transporte não regular","voo doméstico",306,302,608,94,178,272,0,0,0,0
"6536",2015-08-01,"sbcg","transporte não regular","voo internacional",12,14,26,52,54,106,0,0,0,0
"6537",2015-08-01,"sbcj","transporte regular","voo doméstico",102,102,204,8236,8769,17005,0,0,0,0
"6538",2015-08-01,"sbcj","transporte regular","voo internacional",0,0,0,0,0,0,0,0,0,0
"6539",2015-08-01,"sbcj","transporte não regular","voo doméstico",79,78,157,164,14,178,0,0,0,0
"6540",2015-08-01,"sbcj","transporte não regular","voo internacional",0,0,0,0,0,0,0,0,0,0
"6541",2015-08-01,"sbcr","transporte regular","voo doméstico",18,18,36,1472,1447,2919,0,0,0,0
"6542",2015-08-01,"sbcr","transporte regular","voo internacional",0,0,0,0,0,0,0,0,0,0
"6543",2015-08-01,"sbcr","transporte não regular","voo doméstico",37,38,75,97,85,182,0,0,0,0
"6544",2015-08-01,"sbcr","transporte não regular","voo internacional",2,1,3,4,4,8,0,0,0,0
"6545",2015-08-01,"sbct","transporte regular","voo doméstico",2750,2752,5502,280083,274219,554302,108384,0,108384,116267
"6546",2015-08-01,"sbct","transporte regular","voo internacional",108,107,215,5770,5627,11397,0,1846,1846,0
"6547",2015-08-01,"sbct","transporte não regular","voo doméstico",213,215,428,1693,2110,3803,0,0,0,0
"6548",2015-08-01,"sbct","transporte não regular","voo internacional",14,13,27,13,39,52,0,0,0,0
"6549",2015-08-01,"sbcz","transporte regular","voo doméstico",30,31,61,3593,3575,7168,0,0,0,0
"6550",2015-08-01,"sbcz","transporte regular","voo internacional",0,0,0,0,0,0,0,0,0,0
"6551",2015-08-01,"sbcz","transporte não regular","voo doméstico",227,227,454,826,793,1619,0,0,0,0
"6552",2015-08-01,"sbcz","transporte não regular","voo internacional",0,0,0,0,0,0,0,0,0,0
"6553",2015-08-01,"sbeg","transporte regular","voo doméstico",1186,1177,2363,119625,116035,235660,0,0,0,0
"6554",2015-08-01,"sbeg","transporte regular","voo internacional",139,139,278,8379,7220,15599,0,0,0,0
"6555",2015-08-01,"sbeg","transporte não regular","voo doméstico",571,578,1149,5002,4268,9270,0,0,0,0
"6556",2015-08-01,"sbeg","transporte não regular","voo internacional",101,100,201,1309,1538,2847,0,0,0,0
"6557",2015-08-01,"sbfi","transporte regular","voo doméstico",635,632,1267,87621,84296,171917,0,0,0,0
"6558",2015-08-01,"sbfi","transporte regular","voo internacional",22,22,44,2818,2797,5615,0,0,0,0
"6559",2015-08-01,"sbfi","transporte não regular","voo doméstico",141,149,290,1157,727,1884,0,0,0,0
"6560",2015-08-01,"sbfi","transporte não regular","voo internacional",72,71,143,62,103,165,0,0,0,0
"6561",2015-08-01,"sbgo","transporte regular","voo doméstico",1409,1409,2818,135869,132613,268482,119176,172984,292160,189882
"6562",2015-08-01,"sbgo","transporte regular","voo internacional",0,0,0,0,0,0,0,0,0,0
"6563",2015-08-01,"sbgo","transporte não regular","voo doméstico",1688,1688,3376,5223,6358,11581,0,0,0,0
"6564",2015-08-01,"sbgo","transporte não regular","voo internacional",11,10,21,0,0,0,0,0,0,0
"6565",2015-08-01,"sbht","transporte regular","voo doméstico",235,235,470,14932,14006,28938,0,0,0,0
"6566",2015-08-01,"sbht","transporte regular","voo internacional",0,0,0,0,0,0,0,0,0,0
"6567",2015-08-01,"sbht","transporte não regular","voo doméstico",233,233,466,986,1081,2067,650,850,1500,0
"6568",2015-08-01,"sbht","transporte não regular","voo internacional",0,0,0,0,0,0,0,0,0,0
"6569",2015-08-01,"sbiz","transporte regular","voo doméstico",219,219,438,13336,12449,25785,0,0,0,0
"6570",2015-08-01,"sbiz","transporte regular","voo internacional",0,0,0,0,0,0,0,0,0,0
"6571",2015-08-01,"sbiz","transporte não regular","voo doméstico",152,158,310,520,504,1024,0,0,0,0
"6572",2015-08-01,"sbiz","transporte não regular","voo internacional",0,0,0,0,0,0,0,0,0,0
"6573",2015-08-01,"sbjc","transporte regular","voo doméstico",0,0,0,0,0,0,0,0,0,0
"6574",2015-08-01,"sbjc","transporte regular","voo internacional",0,0,0,0,0,0,0,0,0,0
"6575",2015-08-01,"sbjc","transporte não regular","voo doméstico",442,436,878,827,796,1623,0,0,0,0
"6576",2015-08-01,"sbjc","transporte não regular","voo internacional",0,0,0,0,0,0,0,0,0,0
"6577",2015-08-01,"sbjr","transporte regular","voo doméstico",0,0,0,0,0,0,0,0,0,0
"6578",2015-08-01,"sbjr","transporte regular","voo internacional",0,0,0,0,0,0,0,0,0,0
"6579",2015-08-01,"sbjr","transporte não regular","voo doméstico",2888,2890,5778,9614,7619,17233,0,0,0,0
"6580",2015-08-01,"sbjr","transporte não regular","voo internacional",0,0,0,0,0,0,0,0,0,0
"6581",2015-08-01,"sbjv","transporte regular","voo doméstico",279,278,557,23429,22458,45887,0,0,0,0
"6582",2015-08-01,"sbjv","transporte regular","voo internacional",0,0,0,0,0,0,0,0,0,0
"6583",2015-08-01,"sbjv","transporte não regular","voo doméstico",227,228,455,355,312,667,0,0,0,0
"6584",2015-08-01,"sbjv","transporte não regular","voo internacional",0,0,0,0,0,0,0,0,0,0
"6585",2015-08-01,"sblo","transporte regular","voo doméstico",415,409,824,41159,39791,80950,0,0,0,0
"6586",2015-08-01,"sblo","transporte regular","voo internacional",0,0,0,0,0,0,0,0,0,0
"6587",2015-08-01,"sblo","transporte não regular","voo doméstico",814,826,1640,80,157,237,0,0,0,0
"6588",2015-08-01,"sblo","transporte não regular","voo internacional",6,6,12,0,0,0,0,0,0,0
"6589",2015-08-01,"sbma","transporte regular","voo doméstico",229,228,457,16196,14882,31078,0,0,0,0
"6590",2015-08-01,"sbma","transporte regular","voo internacional",0,0,0,0,0,0,0,0,0,0
"6591",2015-08-01,"sbma","transporte não regular","voo doméstico",235,233,468,869,754,1623,0,0,0,0
"6592",2015-08-01,"sbma","transporte não regular","voo internacional",2,2,4,0,0,0,0,0,0,0
"6593",2015-08-01,"sbmk","transporte regular","voo doméstico",152,153,305,14348,13612,27960,0,0,0,0
"6594",2015-08-01,"sbmk","transporte regular","voo internacional",0,0,0,0,0,0,0,0,0,0
"6595",2015-08-01,"sbmk","transporte não regular","voo doméstico",234,235,469,22,6,28,0,0,0,0
"6596",2015-08-01,"sbmk","transporte não regular","voo internacional",0,0,0,0,0,0,0,0,0,0
"6597",2015-08-01,"sbmq","transporte regular","voo doméstico",262,256,518,25859,29950,55809,11286,32115,43401,0
"6598",2015-08-01,"sbmq","transporte regular","voo internacional",0,0,0,0,0,0,0,0,0,0
"6599",2015-08-01,"sbmq","transporte não regular","voo doméstico",145,149,294,386,405,791,0,0,0,0
"6600",2015-08-01,"sbmq","transporte não regular","voo internacional",5,5,10,0,0,0,0,0,0,0
"6601",2015-08-01,"sbmt","transporte regular","voo doméstico",0,0,0,0,0,0,0,0,0,0
"6602",2015-08-01,"sbmt","transporte regular","voo internacional",0,0,0,0,0,0,0,0,0,0
"6603",2015-08-01,"sbmt","transporte não regular","voo doméstico",4480,4461,8941,7184,7296,14480,0,0,0,0
"6604",2015-08-01,"sbmt","transporte não regular","voo internacional",0,0,0,0,0,0,0,0,0,0
"6605",2015-08-01,"sbnf","transporte regular","voo doméstico",624,626,1250,54104,51956,106060,0,0,0,0
"6606",2015-08-01,"sbnf","transporte regular","voo internacional",0,0,0,0,0,0,0,0,0,0
"6607",2015-08-01,"sbnf","transporte não regular","voo doméstico",242,244,486,498,633,1131,0,0,0,0
"6608",2015-08-01,"sbnf","transporte não regular","voo internacional",3,4,7,7,3,10,0,0,0,0
"6609",2015-08-01,"sbpb","transporte regular","voo doméstico",23,23,46,769,667,1436,0,0,0,0
"6610",2015-08-01,"sbpb","transporte regular","voo internacional",0,0,0,0,0,0,0,0,0,0
"6611",2015-08-01,"sbpb","transporte não regular","voo doméstico",44,49,93,171,128,299,0,0,0,0
"6612",2015-08-01,"sbpb","transporte não regular","voo internacional",0,0,0,0,0,0,0,0,0,0
"6613",2015-08-01,"sbpj","transporte regular","voo doméstico",318,318,636,25139,23891,49030,0,0,0,0
"6614",2015-08-01,"sbpj","transporte regular","voo internacional",0,0,0,0,0,0,0,0,0,0
"6615",2015-08-01,"sbpj","transporte não regular","voo doméstico",333,333,666,939,574,1513,0,0,0,0
"6616",2015-08-01,"sbpj","transporte não regular","voo internacional",4,4,8,0,0,0,0,0,0,0
"6617",2015-08-01,"sbpk","transporte regular","voo doméstico",27,27,54,1317,1360,2677,0,0,0,0
"6618",2015-08-01,"sbpk","transporte regular","voo internacional",0,0,0,0,0,0,0,0,0,0
"6619",2015-08-01,"sbpk","transporte não regular","voo doméstico",43,41,84,62,62,124,0,0,0,0
"6620",2015-08-01,"sbpk","transporte não regular","voo internacional",1,2,3,1,0,1,0,0,0,0
"6621",2015-08-01,"sbpl","transporte regular","voo doméstico",144,143,287,18471,17615,36086,0,0,0,0
"6622",2015-08-01,"sbpl","transporte regular","voo internacional",4,4,8,0,0,0,0,0,0,0
"6623",2015-08-01,"sbpl","transporte não regular","voo doméstico",75,76,151,443,371,814,0,0,0,0
"6624",2015-08-01,"sbpl","transporte não regular","voo internacional",0,0,0,0,0,0,0,0,0,0
"6625",2015-08-01,"sbpp","transporte regular","voo doméstico",0,0,0,0,0,0,0,0,0,0
"6626",2015-08-01,"sbpp","transporte regular","voo internacional",0,0,0,0,0,0,0,0,0,0
"6627",2015-08-01,"sbpp","transporte não regular","voo doméstico",81,81,162,134,138,272,0,0,0,0
"6628",2015-08-01,"sbpp","transporte não regular","voo internacional",11,9,20,4,5,9,0,0,0,0
"6629",2015-08-01,"sbpr","transporte regular","voo doméstico",2,2,4,4,2,6,0,0,0,0
"6630",2015-08-01,"sbpr","transporte regular","voo internacional",0,0,0,0,0,0,0,0,0,0
"6631",2015-08-01,"sbpr","transporte não regular","voo doméstico",1033,1031,2064,1276,1203,2479,0,0,0,0
"6632",2015-08-01,"sbpr","transporte não regular","voo internacional",0,0,0,0,0,0,0,0,0,0
"6633",2015-08-01,"sbpv","transporte regular","voo doméstico",484,484,968,40095,38429,78524,0,0,0,0
"6634",2015-08-01,"sbpv","transporte regular","voo internacional",0,0,0,0,0,0,0,0,0,0
"6635",2015-08-01,"sbpv","transporte não regular","voo doméstico",237,239,476,0,0,0,0,0,0,0
"6636",2015-08-01,"sbpv","transporte não regular","voo internacional",0,0,0,0,0,0,0,0,0,0
"6637",2015-08-01,"sbrb","transporte regular","voo doméstico",151,150,301,15620,15176,30796,0,0,0,0
"6638",2015-08-01,"sbrb","transporte regular","voo internacional",0,0,0,0,0,0,0,0,0,0
"6639",2015-08-01,"sbrb","transporte não regular","voo doméstico",130,131,261,297,185,482,0,0,0,0
"6640",2015-08-01,"sbrb","transporte não regular","voo internacional",0,0,0,0,0,0,0,0,0,0
"6641",2015-08-01,"sbrj","transporte regular","voo doméstico",4479,4494,8973,395686,389714,785400,0,0,0,0
"6642",2015-08-01,"sbrj","transporte regular","voo internacional",0,0,0,0,0,0,0,0,0,0
"6643",2015-08-01,"sbrj","transporte não regular","voo doméstico",742,729,1471,249,2160,2409,0,0,0,0
"6644",2015-08-01,"sbrj","transporte não regular","voo internacional",0,1,1,0,0,0,0,0,0,0
"6645",2015-08-01,"sbsj","transporte regular","voo doméstico",26,26,52,2439,2573,5012,0,0,0,0
"6646",2015-08-01,"sbsj","transporte regular","voo internacional",0,0,0,0,0,0,0,0,0,0
"6647",2015-08-01,"sbsj","transporte não regular","voo doméstico",556,546,1102,1951,1900,3851,0,0,0,0
"6648",2015-08-01,"sbsj","transporte não regular","voo internacional",7,21,28,44,16,60,0,0,0,0
"6649",2015-08-01,"sbsl","transporte regular","voo doméstico",751,748,1499,74551,78243,152794,0,0,0,0
"6650",2015-08-01,"sbsl","transporte regular","voo internacional",0,0,0,0,0,0,0,0,0,0
"6651",2015-08-01,"sbsl","transporte não regular","voo doméstico",255,257,512,734,454,1188,53973,179525,233498,10529
"6652",2015-08-01,"sbsl","transporte não regular","voo internacional",5,3,8,0,0,0,0,0,0,0
"6653",2015-08-01,"sbsn","transporte regular","voo doméstico",410,411,821,29525,26928,56453,0,0,0,0
"6654",2015-08-01,"sbsn","transporte regular","voo internacional",0,0,0,0,0,0,0,0,0,0
"6655",2015-08-01,"sbsn","transporte não regular","voo doméstico",345,345,690,836,556,1392,0,0,0,0
"6656",2015-08-01,"sbsn","transporte não regular","voo internacional",0,1,1,0,0,0,0,0,0,0
"6657",2015-08-01,"sbsp","transporte regular","voo doméstico",7370,7393,14763,770447,771202,1541649,0,0,0,0
"6658",2015-08-01,"sbsp","transporte regular","voo internacional",0,0,0,0,0,0,0,0,0,0
"6659",2015-08-01,"sbsp","transporte não regular","voo doméstico",2067,2023,4090,9258,9547,18805,0,0,0,0
"6660",2015-08-01,"sbsp","transporte não regular","voo internacional",0,0,0,0,0,0,0,0,0,0
"6661",2015-08-01,"sbte","transporte regular","voo doméstico",539,539,1078,50129,46748,96877,19607,75314,94921,224310
"6662",2015-08-01,"sbte","transporte regular","voo internacional",0,0,0,0,0,0,0,0,0,0
"6663",2015-08-01,"sbte","transporte não regular","voo doméstico",213,211,424,1235,1287,2522,0,0,0,0
"6664",2015-08-01,"sbte","transporte não regular","voo internacional",0,0,0,0,0,0,0,0,0,0
"6665",2015-08-01,"sbtf","transporte regular","voo doméstico",26,26,52,1791,1903,3694,0,0,0,0
"6666",2015-08-01,"sbtf","transporte regular","voo internacional",0,0,0,0,0,0,0,0,0,0
"6667",2015-08-01,"sbtf","transporte não regular","voo doméstico",169,170,339,339,260,599,1700,1387,3087,18014
"6668",2015-08-01,"sbtf","transporte não regular","voo internacional",0,0,0,0,0,0,0,0,0,0
"6669",2015-08-01,"sbtt","transporte regular","voo doméstico",32,32,64,2609,2682,5291,0,0,0,0
"6670",2015-08-01,"sbtt","transporte regular","voo internacional",0,0,0,0,0,0,0,0,0,0
"6671",2015-08-01,"sbtt","transporte não regular","voo doméstico",89,90,179,423,418,841,1770,3942,5712,445
"6672",2015-08-01,"sbtt","transporte não regular","voo internacional",5,4,9,4,6,10,0,0,0,0
"6673",2015-08-01,"sbuf","transporte regular","voo doméstico",5,5,10,252,163,415,0,0,0,0
"6674",2015-08-01,"sbuf","transporte regular","voo internacional",0,0,0,0,0,0,0,0,0,0
"6675",2015-08-01,"sbuf","transporte não regular","voo doméstico",51,49,100,784,749,1533,0,0,0,0
"6676",2015-08-01,"sbuf","transporte não regular","voo internacional",0,0,0,0,0,0,0,0,0,0
"6677",2015-08-01,"sbug","transporte regular","voo doméstico",0,0,0,0,0,0,0,0,0,0
"6678",2015-08-01,"sbug","transporte regular","voo internacional",0,0,0,0,0,0,0,0,0,0
"6679",2015-08-01,"sbug","transporte não regular","voo doméstico",15,15,30,38,35,73,0,0,0,0
"6680",2015-08-01,"sbug","transporte não regular","voo internacional",0,0,0,0,0,0,0,0,0,0
"6681",2015-08-01,"sbul","transporte regular","voo doméstico",595,595,1190,47236,45985,93221,0,0,0,0
"6682",2015-08-01,"sbul","transporte regular","voo internacional",0,0,0,0,0,0,0,0,0,0
"6683",2015-08-01,"sbul","transporte não regular","voo doméstico",666,660,1326,1621,1535,3156,0,0,0,0
"6684",2015-08-01,"sbul","transporte não regular","voo internacional",5,5,10,19,20,39,0,0,0,0
"6685",2015-08-01,"sbur","transporte regular","voo doméstico",110,109,219,5549,5688,11237,0,0,0,0
"6686",2015-08-01,"sbur","transporte regular","voo internacional",0,0,0,0,0,0,0,0,0,0
"6687",2015-08-01,"sbur","transporte não regular","voo doméstico",253,256,509,904,891,1795,0,0,0,0
"6688",2015-08-01,"sbur","transporte não regular","voo internacional",0,0,0,0,0,0,0,0,0,0
"6689",2015-12-01,"sbbe","transporte regular","voo doméstico",1423,1433,2856,142077,149002,291079,90722,348370,439092,0
"6690",2015-12-01,"sbbe","transporte regular","voo internacional",60,59,119,5190,5847,11037,0,39,39,0
"6691",2015-12-01,"sbbe","transporte não regular","voo doméstico",537,536,1073,4538,4406,8944,0,0,0,0
"6692",2015-12-01,"sbbe","transporte não regular","voo internacional",13,15,28,55,86,141,0,0,0,0
"6693",2015-12-01,"sbbg","transporte regular","voo doméstico",0,0,0,0,0,0,0,0,0,0
"6694",2015-12-01,"sbbg","transporte regular","voo internacional",0,0,0,0,0,0,0,0,0,0
"6695",2015-12-01,"sbbg","transporte não regular","voo doméstico",12,12,24,62,55,117,0,0,0,0
"6696",2015-12-01,"sbbg","transporte não regular","voo internacional",1,1,2,0,3,3,0,0,0,0
"6697",2015-12-01,"sbbh","transporte regular","voo doméstico",203,206,409,10342,9922,20264,0,0,0,0
"6698",2015-12-01,"sbbh","transporte regular","voo internacional",0,0,0,0,0,0,0,0,0,0
"6699",2015-12-01,"sbbh","transporte não regular","voo doméstico",1671,1696,3367,8669,8576,17245,0,0,0,0
"6700",2015-12-01,"sbbh","transporte não regular","voo internacional",6,6,12,52,52,104,0,0,0,0
"6701",2015-12-01,"sbbi","transporte regular","voo doméstico",0,0,0,0,0,0,0,0,0,0
"6702",2015-12-01,"sbbi","transporte regular","voo internacional",0,0,0,0,0,0,0,0,0,0
"6703",2015-12-01,"sbbi","transporte não regular","voo doméstico",935,936,1871,3726,3710,7436,0,0,0,0
"6704",2015-12-01,"sbbi","transporte não regular","voo internacional",2,2,4,0,0,0,0,0,0,0
"6705",2015-12-01,"sbbv","transporte regular","voo doméstico",108,108,216,15592,13453,29045,0,0,0,0
"6706",2015-12-01,"sbbv","transporte regular","voo internacional",0,0,0,0,0,0,0,0,0,0
"6707",2015-12-01,"sbbv","transporte não regular","voo doméstico",278,281,559,114,72,186,0,0,0,0
"6708",2015-12-01,"sbbv","transporte não regular","voo internacional",12,9,21,3,0,3,0,0,0,0
"6709",2015-12-01,"sbcg","transporte regular","voo doméstico",724,728,1452,71653,65188,136841,71392,156835,228227,0
"6710",2015-12-01,"sbcg","transporte regular","voo internacional",0,0,0,0,0,0,0,0,0,0
"6711",2015-12-01,"sbcg","transporte não regular","voo doméstico",211,205,416,384,426,810,0,0,0,0
"6712",2015-12-01,"sbcg","transporte não regular","voo internacional",8,10,18,0,0,0,0,0,0,0
"6713",2015-12-01,"sbcj","transporte regular","voo doméstico",86,86,172,8886,6849,15735,0,171,171,0
"6714",2015-12-01,"sbcj","transporte regular","voo internacional",0,0,0,0,0,0,0,0,0,0
"6715",2015-12-01,"sbcj","transporte não regular","voo doméstico",65,69,134,309,0,309,0,0,0,0
"6716",2015-12-01,"sbcj","transporte não regular","voo internacional",0,1,1,0,0,0,0,0,0,0
"6717",2015-12-01,"sbcr","transporte regular","voo doméstico",17,17,34,1332,1251,2583,0,0,0,0
"6718",2015-12-01,"sbcr","transporte regular","voo internacional",0,0,0,0,0,0,0,0,0,0
"6719",2015-12-01,"sbcr","transporte não regular","voo doméstico",35,38,73,106,77,183,0,0,0,0
"6720",2015-12-01,"sbcr","transporte não regular","voo internacional",3,3,6,4,3,7,0,0,0,0
"6721",2015-12-01,"sbct","transporte regular","voo doméstico",2766,2787,5553,299202,280956,580158,196489,0,196489,146585
"6722",2015-12-01,"sbct","transporte regular","voo internacional",87,86,173,3905,4999,8904,0,8969,8969,0
"6723",2015-12-01,"sbct","transporte não regular","voo doméstico",242,235,477,2365,2705,5070,0,0,0,0
"6724",2015-12-01,"sbct","transporte não regular","voo internacional",15,12,27,0,3,3,0,0,0,0
"6725",2015-12-01,"sbcz","transporte regular","voo doméstico",30,30,60,2588,3337,5925,0,0,0,0
"6726",2015-12-01,"sbcz","transporte regular","voo internacional",0,0,0,0,0,0,0,0,0,0
"6727",2015-12-01,"sbcz","transporte não regular","voo doméstico",157,161,318,642,517,1159,0,0,0,0
"6728",2015-12-01,"sbcz","transporte não regular","voo internacional",0,0,0,0,0,0,0,0,0,0
"6729",2015-12-01,"sbeg","transporte regular","voo doméstico",1163,1165,2328,140770,114859,255629,0,1646,1646,0
"6730",2015-12-01,"sbeg","transporte regular","voo internacional",133,135,268,9897,7616,17513,0,0,0,0
"6731",2015-12-01,"sbeg","transporte não regular","voo doméstico",578,572,1150,7036,6292,13328,0,0,0,0
"6732",2015-12-01,"sbeg","transporte não regular","voo internacional",103,106,209,1259,1012,2271,0,0,0,0
"6733",2015-12-01,"sbfi","transporte regular","voo doméstico",669,667,1336,77093,77954,155047,0,0,0,0
"6734",2015-12-01,"sbfi","transporte regular","voo internacional",22,22,44,2942,1845,4787,0,0,0,0
"6735",2015-12-01,"sbfi","transporte não regular","voo doméstico",131,129,260,1838,2480,4318,0,0,0,0
"6736",2015-12-01,"sbfi","transporte não regular","voo internacional",33,31,64,323,297,620,0,0,0,0
"6737",2015-12-01,"sbgo","transporte regular","voo doméstico",1445,1439,2884,141431,133222,274653,132450,183379,315829,195311
"6738",2015-12-01,"sbgo","transporte regular","voo internacional",0,0,0,0,0,0,0,0,0,0
"6739",2015-12-01,"sbgo","transporte não regular","voo doméstico",1126,1165,2291,6965,6068,13033,0,0,0,0
"6740",2015-12-01,"sbgo","transporte não regular","voo internacional",2,2,4,0,0,0,0,0,0,0
"6741",2015-12-01,"sbht","transporte regular","voo doméstico",221,221,442,12538,9825,22363,0,0,0,0
"6742",2015-12-01,"sbht","transporte regular","voo internacional",0,0,0,0,0,0,0,0,0,0
"6743",2015-12-01,"sbht","transporte não regular","voo doméstico",206,208,414,1436,591,2027,900,2650,3550,700
"6744",2015-12-01,"sbht","transporte não regular","voo internacional",0,0,0,0,0,0,0,0,0,0
"6745",2015-12-01,"sbiz","transporte regular","voo doméstico",233,233,466,15374,15069,30443,0,0,0,0
"6746",2015-12-01,"sbiz","transporte regular","voo internacional",0,0,0,0,0,0,0,0,0,0
"6747",2015-12-01,"sbiz","transporte não regular","voo doméstico",102,96,198,178,246,424,0,0,0,0
"6748",2015-12-01,"sbiz","transporte não regular","voo internacional",1,1,2,0,0,0,0,0,0,0
"6749",2015-12-01,"sbjc","transporte regular","voo doméstico",0,0,0,0,0,0,0,0,0,0
"6750",2015-12-01,"sbjc","transporte regular","voo internacional",0,0,0,0,0,0,0,0,0,0
"6751",2015-12-01,"sbjc","transporte não regular","voo doméstico",433,428,861,910,851,1761,0,0,0,0
"6752",2015-12-01,"sbjc","transporte não regular","voo internacional",0,0,0,0,0,0,0,0,0,0
"6753",2015-12-01,"sbjr","transporte regular","voo doméstico",0,0,0,0,0,0,0,0,0,0
"6754",2015-12-01,"sbjr","transporte regular","voo internacional",0,0,0,0,0,0,0,0,0,0
"6755",2015-12-01,"sbjr","transporte não regular","voo doméstico",2845,2841,5686,9488,7565,17053,0,0,0,0
"6756",2015-12-01,"sbjr","transporte não regular","voo internacional",0,0,0,0,0,0,0,0,0,0
"6757",2015-12-01,"sbjv","transporte regular","voo doméstico",299,303,602,21179,22885,44064,0,0,0,0
"6758",2015-12-01,"sbjv","transporte regular","voo internacional",0,0,0,0,0,0,0,0,0,0
"6759",2015-12-01,"sbjv","transporte não regular","voo doméstico",134,131,265,108,95,203,0,0,0,0
"6760",2015-12-01,"sbjv","transporte não regular","voo internacional",0,0,0,0,0,0,0,0,0,0
"6761",2015-12-01,"sblo","transporte regular","voo doméstico",473,464,937,42987,43631,86618,0,0,0,0
"6762",2015-12-01,"sblo","transporte regular","voo internacional",0,0,0,0,0,0,0,0,0,0
"6763",2015-12-01,"sblo","transporte não regular","voo doméstico",521,529,1050,2736,2252,4988,0,0,0,0
"6764",2015-12-01,"sblo","transporte não regular","voo internacional",0,0,0,0,0,0,0,0,0,0
"6765",2015-12-01,"sbma","transporte regular","voo doméstico",215,216,431,16084,14899,30983,0,0,0,0
"6766",2015-12-01,"sbma","transporte regular","voo internacional",0,0,0,0,0,0,0,0,0,0
"6767",2015-12-01,"sbma","transporte não regular","voo doméstico",171,171,342,621,796,1417,0,0,0,0
"6768",2015-12-01,"sbma","transporte não regular","voo internacional",1,1,2,0,0,0,0,0,0,0
"6769",2015-12-01,"sbmk","transporte regular","voo doméstico",155,155,310,12339,13230,25569,0,0,0,0
"6770",2015-12-01,"sbmk","transporte regular","voo internacional",0,0,0,0,0,0,0,0,0,0
"6771",2015-12-01,"sbmk","transporte não regular","voo doméstico",257,260,517,565,638,1203,0,0,0,0
"6772",2015-12-01,"sbmk","transporte não regular","voo internacional",0,0,0,0,0,0,0,0,0,0
"6773",2015-12-01,"sbmq","transporte regular","voo doméstico",227,227,454,28487,24941,53428,10620,30207,40827,0
"6774",2015-12-01,"sbmq","transporte regular","voo internacional",0,0,0,0,0,0,0,0,0,0
"6775",2015-12-01,"sbmq","transporte não regular","voo doméstico",216,213,429,618,428,1046,0,0,0,0
"6776",2015-12-01,"sbmq","transporte não regular","voo internacional",5,7,12,0,0,0,0,0,0,0
"6777",2015-12-01,"sbmt","transporte regular","voo doméstico",0,0,0,0,0,0,0,0,0,0
"6778",2015-12-01,"sbmt","transporte regular","voo internacional",0,0,0,0,0,0,0,0,0,0
"6779",2015-12-01,"sbmt","transporte não regular","voo doméstico",3405,3434,6839,6143,5859,12002,0,0,0,0
"6780",2015-12-01,"sbmt","transporte não regular","voo internacional",0,0,0,0,0,0,0,0,0,0
"6781",2015-12-01,"sbnf","transporte regular","voo doméstico",750,750,1500,66471,75405,141876,0,0,0,0
"6782",2015-12-01,"sbnf","transporte regular","voo internacional",0,0,0,0,0,0,0,0,0,0
"6783",2015-12-01,"sbnf","transporte não regular","voo doméstico",272,269,541,1335,1728,3063,0,0,0,0
"6784",2015-12-01,"sbnf","transporte não regular","voo internacional",5,5,10,4,10,14,0,0,0,0
"6785",2015-12-01,"sbpb","transporte regular","voo doméstico",2,2,4,81,97,178,0,0,0,0
"6786",2015-12-01,"sbpb","transporte regular","voo internacional",0,0,0,0,0,0,0,0,0,0
"6787",2015-12-01,"sbpb","transporte não regular","voo doméstico",111,103,214,463,681,1144,0,0,0,0
"6788",2015-12-01,"sbpb","transporte não regular","voo internacional",0,0,0,0,0,0,0,0,0,0
"6789",2015-12-01,"sbpj","transporte regular","voo doméstico",384,385,769,31354,27856,59210,0,0,0,0
"6790",2015-12-01,"sbpj","transporte regular","voo internacional",0,0,0,0,0,0,0,0,0,0
"6791",2015-12-01,"sbpj","transporte não regular","voo doméstico",233,234,467,674,844,1518,0,0,0,0
"6792",2015-12-01,"sbpj","transporte não regular","voo internacional",5,5,10,2,0,2,0,0,0,0
"6793",2015-12-01,"sbpk","transporte regular","voo doméstico",43,43,86,1964,2012,3976,0,0,0,0
"6794",2015-12-01,"sbpk","transporte regular","voo internacional",0,0,0,0,0,0,0,0,0,0
"6795",2015-12-01,"sbpk","transporte não regular","voo doméstico",48,48,96,91,92,183,0,0,0,0
"6796",2015-12-01,"sbpk","transporte não regular","voo internacional",3,3,6,3,9,12,0,0,0,0
"6797",2015-12-01,"sbpl","transporte regular","voo doméstico",131,131,262,17731,17604,35335,0,0,0,0
"6798",2015-12-01,"sbpl","transporte regular","voo internacional",1,1,2,0,0,0,0,0,0,0
"6799",2015-12-01,"sbpl","transporte não regular","voo doméstico",101,101,202,1929,2258,4187,0,0,0,0
"6800",2015-12-01,"sbpl","transporte não regular","voo internacional",4,4,8,0,0,0,0,0,0,0
"6801",2015-12-01,"sbpp","transporte regular","voo doméstico",0,0,0,0,0,0,0,0,0,0
"6802",2015-12-01,"sbpp","transporte regular","voo internacional",0,0,0,0,0,0,0,0,0,0
"6803",2015-12-01,"sbpp","transporte não regular","voo doméstico",94,90,184,173,165,338,0,0,0,0
"6804",2015-12-01,"sbpp","transporte não regular","voo internacional",8,10,18,18,12,30,0,0,0,0
"6805",2015-12-01,"sbpr","transporte regular","voo doméstico",0,0,0,0,0,0,0,0,0,0
"6806",2015-12-01,"sbpr","transporte regular","voo internacional",0,0,0,0,0,0,0,0,0,0
"6807",2015-12-01,"sbpr","transporte não regular","voo doméstico",795,803,1598,1008,852,1860,0,0,0,0
"6808",2015-12-01,"sbpr","transporte não regular","voo internacional",0,0,0,0,0,0,0,0,0,0
"6809",2015-12-01,"sbpv","transporte regular","voo doméstico",481,480,961,49031,41103,90134,0,0,0,0
"6810",2015-12-01,"sbpv","transporte regular","voo internacional",0,0,0,0,0,0,0,0,0,0
"6811",2015-12-01,"sbpv","transporte não regular","voo doméstico",220,217,437,332,541,873,0,0,0,0
"6812",2015-12-01,"sbpv","transporte não regular","voo internacional",2,2,4,0,0,0,0,0,0,0
"6813",2015-12-01,"sbrb","transporte regular","voo doméstico",176,178,354,20001,16396,36397,0,8,8,4
"6814",2015-12-01,"sbrb","transporte regular","voo internacional",0,0,0,0,0,0,0,0,0,0
"6815",2015-12-01,"sbrb","transporte não regular","voo doméstico",140,147,287,495,498,993,0,0,0,0
"6816",2015-12-01,"sbrb","transporte não regular","voo internacional",0,0,0,0,0,0,0,0,0,0
"6817",2015-12-01,"sbrj","transporte regular","voo doméstico",4237,4254,8491,376553,415565,792118,0,0,0,0
"6818",2015-12-01,"sbrj","transporte regular","voo internacional",0,0,0,0,0,0,0,0,0,0
"6819",2015-12-01,"sbrj","transporte não regular","voo doméstico",681,656,1337,4100,4736,8836,0,0,0,0
"6820",2015-12-01,"sbrj","transporte não regular","voo internacional",6,6,12,0,0,0,0,0,0,0
"6821",2015-12-01,"sbsj","transporte regular","voo doméstico",27,27,54,3179,2948,6127,0,0,0,0
"6822",2015-12-01,"sbsj","transporte regular","voo internacional",0,0,0,0,0,0,0,0,0,0
"6823",2015-12-01,"sbsj","transporte não regular","voo doméstico",492,482,974,1892,1833,3725,0,0,0,0
"6824",2015-12-01,"sbsj","transporte não regular","voo internacional",4,35,39,74,10,84,0,0,0,0
"6825",2015-12-01,"sbsl","transporte regular","voo doméstico",801,802,1603,74803,87978,162781,0,0,0,0
"6826",2015-12-01,"sbsl","transporte regular","voo internacional",0,0,0,0,0,0,0,0,0,0
"6827",2015-12-01,"sbsl","transporte não regular","voo doméstico",265,264,529,896,1430,2326,69128,202687,271815,0
"6828",2015-12-01,"sbsl","transporte não regular","voo internacional",1,0,1,0,0,0,0,0,0,0
"6829",2015-12-01,"sbsn","transporte regular","voo doméstico",353,355,708,24461,25371,49832,0,0,0,0
"6830",2015-12-01,"sbsn","transporte regular","voo internacional",0,0,0,0,0,0,0,0,0,0
"6831",2015-12-01,"sbsn","transporte não regular","voo doméstico",340,336,676,952,1055,2007,1345,2802,4147,0
"6832",2015-12-01,"sbsn","transporte não regular","voo internacional",1,1,2,0,0,0,0,0,0,0
"6833",2015-12-01,"sbsp","transporte regular","voo doméstico",7276,7336,14612,900016,813076,1713092,0,0,0,0
"6834",2015-12-01,"sbsp","transporte regular","voo internacional",0,0,0,0,0,0,0,0,0,0
"6835",2015-12-01,"sbsp","transporte não regular","voo doméstico",1865,1828,3693,12217,10324,22541,0,0,0,0
"6836",2015-12-01,"sbsp","transporte não regular","voo internacional",0,0,0,0,0,0,0,0,0,0
"6837",2015-12-01,"sbte","transporte regular","voo doméstico",579,582,1161,48124,57861,105985,16700,75349,92049,238556
"6838",2015-12-01,"sbte","transporte regular","voo internacional",0,0,0,0,0,0,0,0,0,0
"6839",2015-12-01,"sbte","transporte não regular","voo doméstico",264,270,534,3649,4249,7898,0,0,0,0
"6840",2015-12-01,"sbte","transporte não regular","voo internacional",0,0,0,0,0,0,0,0,0,0
"6841",2015-12-01,"sbtf","transporte regular","voo doméstico",43,43,86,2071,2322,4393,0,0,0,0
"6842",2015-12-01,"sbtf","transporte regular","voo internacional",0,0,0,0,0,0,0,0,0,0
"6843",2015-12-01,"sbtf","transporte não regular","voo doméstico",182,182,364,334,266,600,1409,2293,3702,11715
"6844",2015-12-01,"sbtf","transporte não regular","voo internacional",0,0,0,0,0,0,0,0,0,0
"6845",2015-12-01,"sbtt","transporte regular","voo doméstico",36,36,72,2591,3321,5912,0,0,0,0
"6846",2015-12-01,"sbtt","transporte regular","voo internacional",1,1,2,1,0,1,0,0,0,0
"6847",2015-12-01,"sbtt","transporte não regular","voo doméstico",104,103,207,527,516,1043,1181,2018,3199,418
"6848",2015-12-01,"sbtt","transporte não regular","voo internacional",4,4,8,8,13,21,0,0,0,0
"6849",2015-12-01,"sbuf","transporte regular","voo doméstico",13,13,26,673,699,1372,0,0,0,0
"6850",2015-12-01,"sbuf","transporte regular","voo internacional",0,0,0,0,0,0,0,0,0,0
"6851",2015-12-01,"sbuf","transporte não regular","voo doméstico",36,37,73,117,129,246,0,0,0,0
"6852",2015-12-01,"sbuf","transporte não regular","voo internacional",0,0,0,0,0,0,0,0,0,0
"6853",2015-12-01,"sbug","transporte regular","voo doméstico",24,24,48,1354,1296,2650,0,0,0,0
"6854",2015-12-01,"sbug","transporte regular","voo internacional",0,0,0,0,0,0,0,0,0,0
"6855",2015-12-01,"sbug","transporte não regular","voo doméstico",19,19,38,63,77,140,0,0,0,0
"6856",2015-12-01,"sbug","transporte não regular","voo internacional",0,0,0,0,0,0,0,0,0,0
"6857",2015-12-01,"sbul","transporte regular","voo doméstico",583,582,1165,50000,48876,98876,0,0,0,0
"6858",2015-12-01,"sbul","transporte regular","voo internacional",0,0,0,0,0,0,0,0,0,0
"6859",2015-12-01,"sbul","transporte não regular","voo doméstico",489,492,981,1824,1609,3433,0,0,0,0
"6860",2015-12-01,"sbul","transporte não regular","voo internacional",1,1,2,1,1,2,0,0,0,0
"6861",2015-12-01,"sbur","transporte regular","voo doméstico",68,72,140,3521,3318,6839,0,0,0,0
"6862",2015-12-01,"sbur","transporte regular","voo internacional",0,0,0,0,0,0,0,0,0,0
"6863",2015-12-01,"sbur","transporte não regular","voo doméstico",139,133,272,463,514,977,0,0,0,0
"6864",2015-12-01,"sbur","transporte não regular","voo internacional",0,0,0,0,0,0,0,0,0,0
"6865",2015-02-01,"sbbe","transporte regular","voo doméstico",1474,1490,2964,128989,122622,251611,74857,257940,332797,0
"6866",2015-02-01,"sbbe","transporte regular","voo internacional",35,35,70,4766,3742,8508,0,1,1,0
"6867",2015-02-01,"sbbe","transporte não regular","voo doméstico",408,396,804,2988,3917,6905,0,0,0,0
"6868",2015-02-01,"sbbe","transporte não regular","voo internacional",12,9,21,24,36,60,0,0,0,0
"6869",2015-02-01,"sbbg","transporte regular","voo doméstico",0,0,0,0,0,0,0,0,0,0
"6870",2015-02-01,"sbbg","transporte regular","voo internacional",0,0,0,0,0,0,0,0,0,0
"6871",2015-02-01,"sbbg","transporte não regular","voo doméstico",15,15,30,69,57,126,0,0,0,0
"6872",2015-02-01,"sbbg","transporte não regular","voo internacional",1,1,2,1,0,1,0,0,0,0
"6873",2015-02-01,"sbbh","transporte regular","voo doméstico",396,409,805,39313,21433,60746,0,0,0,0
"6874",2015-02-01,"sbbh","transporte regular","voo internacional",0,0,0,0,0,0,0,0,0,0
"6875",2015-02-01,"sbbh","transporte não regular","voo doméstico",1602,1577,3179,8979,8762,17741,0,0,0,0
"6876",2015-02-01,"sbbh","transporte não regular","voo internacional",2,2,4,0,0,0,0,0,0,0
"6877",2015-02-01,"sbbi","transporte regular","voo doméstico",0,0,0,0,0,0,0,0,0,0
"6878",2015-02-01,"sbbi","transporte regular","voo internacional",0,0,0,0,0,0,0,0,0,0
"6879",2015-02-01,"sbbi","transporte não regular","voo doméstico",950,936,1886,5093,4990,10083,0,0,0,0
"6880",2015-02-01,"sbbi","transporte não regular","voo internacional",0,0,0,0,0,0,0,0,0,0
"6881",2015-02-01,"sbbv","transporte regular","voo doméstico",96,96,192,12851,14141,26992,0,0,0,0
"6882",2015-02-01,"sbbv","transporte regular","voo internacional",0,0,0,0,0,0,0,0,0,0
"6883",2015-02-01,"sbbv","transporte não regular","voo doméstico",207,212,419,218,203,421,0,0,0,0
"6884",2015-02-01,"sbbv","transporte não regular","voo internacional",14,11,25,8,9,17,0,0,0,0
"6885",2015-02-01,"sbcg","transporte regular","voo doméstico",606,604,1210,58018,58697,116715,48906,103597,152503,0
"6886",2015-02-01,"sbcg","transporte regular","voo internacional",0,0,0,0,0,0,0,0,0,0
"6887",2015-02-01,"sbcg","transporte não regular","voo doméstico",212,209,421,876,674,1550,9076,26218,35294,0
"6888",2015-02-01,"sbcg","transporte não regular","voo internacional",18,18,36,207,145,352,0,0,0,0
"6889",2015-02-01,"sbcj","transporte regular","voo doméstico",100,100,200,7111,6570,13681,0,0,0,0
"6890",2015-02-01,"sbcj","transporte regular","voo internacional",0,0,0,0,0,0,0,0,0,0
"6891",2015-02-01,"sbcj","transporte não regular","voo doméstico",78,79,157,645,822,1467,0,0,0,0
"6892",2015-02-01,"sbcj","transporte não regular","voo internacional",0,0,0,0,0,0,0,0,0,0
"6893",2015-02-01,"sbcr","transporte regular","voo doméstico",23,23,46,1352,1276,2628,0,0,0,0
"6894",2015-02-01,"sbcr","transporte regular","voo internacional",0,0,0,0,0,0,0,0,0,0
"6895",2015-02-01,"sbcr","transporte não regular","voo doméstico",31,30,61,50,49,99,0,0,0,0
"6896",2015-02-01,"sbcr","transporte não regular","voo internacional",2,2,4,2,3,5,0,0,0,0
"6897",2015-02-01,"sbct","transporte regular","voo doméstico",2714,2717,5431,262321,269136,531457,131696,0,131696,140385
"6898",2015-02-01,"sbct","transporte regular","voo internacional",92,92,184,4470,5423,9893,0,1405,1405,0
"6899",2015-02-01,"sbct","transporte não regular","voo doméstico",213,207,420,1403,1735,3138,0,0,0,0
"6900",2015-02-01,"sbct","transporte não regular","voo internacional",13,13,26,25,26,51,0,0,0,0
"6901",2015-02-01,"sbcz","transporte regular","voo doméstico",27,27,54,2046,1889,3935,0,0,0,0
"6902",2015-02-01,"sbcz","transporte regular","voo internacional",0,0,0,0,0,0,0,0,0,0
"6903",2015-02-01,"sbcz","transporte não regular","voo doméstico",145,148,293,486,476,962,0,0,0,0
"6904",2015-02-01,"sbcz","transporte não regular","voo internacional",1,1,2,0,0,0,0,0,0,0
"6905",2015-02-01,"sbeg","transporte regular","voo doméstico",1149,1130,2279,112044,120865,232909,0,2,2,0
"6906",2015-02-01,"sbeg","transporte regular","voo internacional",122,125,247,11382,10117,21499,0,0,0,0
"6907",2015-02-01,"sbeg","transporte não regular","voo doméstico",557,571,1128,7658,6771,14429,0,0,0,0
"6908",2015-02-01,"sbeg","transporte não regular","voo internacional",110,113,223,692,925,1617,0,0,0,0
"6909",2015-02-01,"sbfi","transporte regular","voo doméstico",594,596,1190,74755,74632,149387,0,0,0,0
"6910",2015-02-01,"sbfi","transporte regular","voo internacional",28,28,56,3524,3852,7376,0,0,0,0
"6911",2015-02-01,"sbfi","transporte não regular","voo doméstico",107,108,215,1459,1731,3190,0,0,0,0
"6912",2015-02-01,"sbfi","transporte não regular","voo internacional",22,24,46,45,47,92,0,0,0,0
"6913",2015-02-01,"sbgo","transporte regular","voo doméstico",1256,1253,2509,111082,110505,221587,104770,151662,256432,166264
"6914",2015-02-01,"sbgo","transporte regular","voo internacional",0,0,0,0,0,0,0,0,0,0
"6915",2015-02-01,"sbgo","transporte não regular","voo doméstico",974,976,1950,3901,4292,8193,0,0,0,0
"6916",2015-02-01,"sbgo","transporte não regular","voo internacional",2,1,3,0,0,0,0,0,0,0
"6917",2015-02-01,"sbht","transporte regular","voo doméstico",275,275,550,11352,10448,21800,0,0,0,0
"6918",2015-02-01,"sbht","transporte regular","voo internacional",0,0,0,0,0,0,0,0,0,0
"6919",2015-02-01,"sbht","transporte não regular","voo doméstico",171,171,342,601,549,1150,340,480,820,320
"6920",2015-02-01,"sbht","transporte não regular","voo internacional",0,0,0,0,0,0,0,0,0,0
"6921",2015-02-01,"sbiz","transporte regular","voo doméstico",221,221,442,11006,10744,21750,0,0,0,0
"6922",2015-02-01,"sbiz","transporte regular","voo internacional",0,0,0,0,0,0,0,0,0,0
"6923",2015-02-01,"sbiz","transporte não regular","voo doméstico",117,113,230,253,217,470,0,0,0,0
"6924",2015-02-01,"sbiz","transporte não regular","voo internacional",1,0,1,0,0,0,0,0,0,0
"6925",2015-02-01,"sbjc","transporte regular","voo doméstico",0,0,0,0,0,0,0,0,0,0
"6926",2015-02-01,"sbjc","transporte regular","voo internacional",0,0,0,0,0,0,0,0,0,0
"6927",2015-02-01,"sbjc","transporte não regular","voo doméstico",389,389,778,609,531,1140,0,0,0,0
"6928",2015-02-01,"sbjc","transporte não regular","voo internacional",0,0,0,0,0,0,0,0,0,0
"6929",2015-02-01,"sbjr","transporte regular","voo doméstico",0,0,0,0,0,0,0,0,0,0
"6930",2015-02-01,"sbjr","transporte regular","voo internacional",0,0,0,0,0,0,0,0,0,0
"6931",2015-02-01,"sbjr","transporte não regular","voo doméstico",2637,2640,5277,9497,7237,16734,0,0,0,0
"6932",2015-02-01,"sbjr","transporte não regular","voo internacional",0,0,0,0,0,0,0,0,0,0
"6933",2015-02-01,"sbjv","transporte regular","voo doméstico",205,225,430,17832,16830,34662,0,0,0,0
"6934",2015-02-01,"sbjv","transporte regular","voo internacional",0,0,0,0,0,0,0,0,0,0
"6935",2015-02-01,"sbjv","transporte não regular","voo doméstico",164,146,310,55,1074,1129,0,0,0,0
"6936",2015-02-01,"sbjv","transporte não regular","voo internacional",1,1,2,0,0,0,0,0,0,0
"6937",2015-02-01,"sblo","transporte regular","voo doméstico",424,427,851,37334,37889,75223,0,0,0,0
"6938",2015-02-01,"sblo","transporte regular","voo internacional",0,0,0,0,0,0,0,0,0,0
"6939",2015-02-01,"sblo","transporte não regular","voo doméstico",529,519,1048,1217,1174,2391,0,0,0,0
"6940",2015-02-01,"sblo","transporte não regular","voo internacional",1,1,2,0,0,0,0,0,0,0
"6941",2015-02-01,"sbma","transporte regular","voo doméstico",292,291,583,14388,13675,28063,0,0,0,0
"6942",2015-02-01,"sbma","transporte regular","voo internacional",0,0,0,0,0,0,0,0,0,0
"6943",2015-02-01,"sbma","transporte não regular","voo doméstico",245,243,488,1110,1055,2165,0,0,0,0
"6944",2015-02-01,"sbma","transporte não regular","voo internacional",1,1,2,0,0,0,0,0,0,0
"6945",2015-02-01,"sbmk","transporte regular","voo doméstico",143,144,287,13236,12305,25541,0,0,0,0
"6946",2015-02-01,"sbmk","transporte regular","voo internacional",0,0,0,0,0,0,0,0,0,0
"6947",2015-02-01,"sbmk","transporte não regular","voo doméstico",222,220,442,2994,2716,5710,0,0,0,0
"6948",2015-02-01,"sbmk","transporte não regular","voo internacional",0,0,0,0,0,0,0,0,0,0
"6949",2015-02-01,"sbmq","transporte regular","voo doméstico",257,251,508,21946,24203,46149,15650,31630,47280,0
"6950",2015-02-01,"sbmq","transporte regular","voo internacional",0,0,0,0,0,0,0,0,0,0
"6951",2015-02-01,"sbmq","transporte não regular","voo doméstico",127,136,263,229,232,461,0,0,0,0
"6952",2015-02-01,"sbmq","transporte não regular","voo internacional",8,6,14,0,0,0,0,0,0,0
"6953",2015-02-01,"sbmt","transporte regular","voo doméstico",0,0,0,0,0,0,0,0,0,0
"6954",2015-02-01,"sbmt","transporte regular","voo internacional",0,0,0,0,0,0,0,0,0,0
"6955",2015-02-01,"sbmt","transporte não regular","voo doméstico",3877,3884,7761,6286,6226,12512,0,0,0,0
"6956",2015-02-01,"sbmt","transporte não regular","voo internacional",0,0,0,0,0,0,0,0,0,0
"6957",2015-02-01,"sbnf","transporte regular","voo doméstico",518,517,1035,52134,51886,104020,0,0,0,0
"6958",2015-02-01,"sbnf","transporte regular","voo internacional",0,0,0,0,0,0,0,0,0,0
"6959",2015-02-01,"sbnf","transporte não regular","voo doméstico",303,301,604,992,987,1979,0,0,0,0
"6960",2015-02-01,"sbnf","transporte não regular","voo internacional",9,9,18,26,30,56,0,0,0,0
"6961",2015-02-01,"sbpb","transporte regular","voo doméstico",17,17,34,534,471,1005,0,0,0,0
"6962",2015-02-01,"sbpb","transporte regular","voo internacional",0,0,0,0,0,0,0,0,0,0
"6963",2015-02-01,"sbpb","transporte não regular","voo doméstico",55,54,109,206,213,419,0,0,0,0
"6964",2015-02-01,"sbpb","transporte não regular","voo internacional",0,0,0,0,0,0,0,0,0,0
"6965",2015-02-01,"sbpj","transporte regular","voo doméstico",298,292,590,20824,21101,41925,0,0,0,0
"6966",2015-02-01,"sbpj","transporte regular","voo internacional",0,0,0,0,0,0,0,0,0,0
"6967",2015-02-01,"sbpj","transporte não regular","voo doméstico",250,250,500,1282,281,1563,0,0,0,0
"6968",2015-02-01,"sbpj","transporte não regular","voo internacional",0,0,0,0,0,0,0,0,0,0
"6969",2015-02-01,"sbpk","transporte regular","voo doméstico",41,41,82,2126,2165,4291,0,0,0,0
"6970",2015-02-01,"sbpk","transporte regular","voo internacional",0,0,0,0,0,0,0,0,0,0
"6971",2015-02-01,"sbpk","transporte não regular","voo doméstico",25,28,53,55,46,101,0,0,0,0
"6972",2015-02-01,"sbpk","transporte não regular","voo internacional",4,1,5,1,16,17,0,0,0,0
"6973",2015-02-01,"sbpl","transporte regular","voo doméstico",159,159,318,19447,18425,37872,0,0,0,0
"6974",2015-02-01,"sbpl","transporte regular","voo internacional",0,0,0,0,0,0,0,0,0,0
"6975",2015-02-01,"sbpl","transporte não regular","voo doméstico",76,75,151,52,39,91,0,0,0,0
"6976",2015-02-01,"sbpl","transporte não regular","voo internacional",0,0,0,0,0,0,0,0,0,0
"6977",2015-02-01,"sbpp","transporte regular","voo doméstico",0,0,0,0,0,0,0,0,0,0
"6978",2015-02-01,"sbpp","transporte regular","voo internacional",0,0,0,0,0,0,0,0,0,0
"6979",2015-02-01,"sbpp","transporte não regular","voo doméstico",67,68,135,115,108,223,0,0,0,0
"6980",2015-02-01,"sbpp","transporte não regular","voo internacional",9,6,15,4,6,10,0,0,0,0
"6981",2015-02-01,"sbpr","transporte regular","voo doméstico",1,1,2,2,3,5,0,0,0,0
"6982",2015-02-01,"sbpr","transporte regular","voo internacional",0,0,0,0,0,0,0,0,0,0
"6983",2015-02-01,"sbpr","transporte não regular","voo doméstico",670,665,1335,834,824,1658,0,0,0,0
"6984",2015-02-01,"sbpr","transporte não regular","voo internacional",0,0,0,0,0,0,0,0,0,0
"6985",2015-02-01,"sbpv","transporte regular","voo doméstico",375,379,754,28984,31209,60193,0,0,0,0
"6986",2015-02-01,"sbpv","transporte regular","voo internacional",0,0,0,0,0,0,0,0,0,0
"6987",2015-02-01,"sbpv","transporte não regular","voo doméstico",179,177,356,0,67,67,0,0,0,0
"6988",2015-02-01,"sbpv","transporte não regular","voo internacional",0,0,0,0,0,0,0,0,0,0
"6989",2015-02-01,"sbrb","transporte regular","voo doméstico",159,157,316,14522,15683,30205,0,37,37,19
"6990",2015-02-01,"sbrb","transporte regular","voo internacional",0,0,0,0,0,0,0,0,0,0
"6991",2015-02-01,"sbrb","transporte não regular","voo doméstico",147,150,297,379,225,604,0,0,0,0
"6992",2015-02-01,"sbrb","transporte não regular","voo internacional",0,0,0,0,0,0,0,0,0,0
"6993",2015-02-01,"sbrj","transporte regular","voo doméstico",4021,4040,8061,371861,363658,735519,0,0,0,0
"6994",2015-02-01,"sbrj","transporte regular","voo internacional",0,0,0,0,0,0,0,0,0,0
"6995",2015-02-01,"sbrj","transporte não regular","voo doméstico",782,758,1540,1807,1855,3662,0,0,0,0
"6996",2015-02-01,"sbrj","transporte não regular","voo internacional",2,2,4,0,0,0,0,0,0,0
"6997",2015-02-01,"sbsj","transporte regular","voo doméstico",0,0,0,0,0,0,0,0,0,0
"6998",2015-02-01,"sbsj","transporte regular","voo internacional",0,0,0,0,0,0,0,0,0,0
"6999",2015-02-01,"sbsj","transporte não regular","voo doméstico",425,407,832,702,650,1352,0,0,0,0
"7000",2015-02-01,"sbsj","transporte não regular","voo internacional",2,10,12,6,0,6,0,0,0,0
"7001",2015-02-01,"sbsl","transporte regular","voo doméstico",623,618,1241,62928,59961,122889,0,0,0,0
"7002",2015-02-01,"sbsl","transporte regular","voo internacional",1,0,1,0,0,0,0,0,0,0
"7003",2015-02-01,"sbsl","transporte não regular","voo doméstico",228,234,462,2349,1029,3378,60481,167748,228229,0
"7004",2015-02-01,"sbsl","transporte não regular","voo internacional",2,0,2,0,0,0,0,0,0,0
"7005",2015-02-01,"sbsn","transporte regular","voo doméstico",367,382,749,22006,18527,40533,0,4,4,0
"7006",2015-02-01,"sbsn","transporte regular","voo internacional",0,0,0,0,0,0,0,0,0,0
"7007",2015-02-01,"sbsn","transporte não regular","voo doméstico",330,320,650,878,1135,2013,0,0,0,0
"7008",2015-02-01,"sbsn","transporte não regular","voo internacional",3,3,6,0,0,0,0,0,0,0
"7009",2015-02-01,"sbsp","transporte regular","voo doméstico",6232,6283,12515,681416,682298,1363714,0,0,0,0
"7010",2015-02-01,"sbsp","transporte regular","voo internacional",0,0,0,0,0,0,0,0,0,0
"7011",2015-02-01,"sbsp","transporte não regular","voo doméstico",1736,1661,3397,9848,9346,19194,0,0,0,0
"7012",2015-02-01,"sbsp","transporte não regular","voo internacional",0,0,0,0,0,0,0,0,0,0
"7013",2015-02-01,"sbte","transporte regular","voo doméstico",444,444,888,44428,38849,83277,18242,81225,99467,206873
"7014",2015-02-01,"sbte","transporte regular","voo internacional",0,0,0,0,0,0,0,0,0,0
"7015",2015-02-01,"sbte","transporte não regular","voo doméstico",153,154,307,905,739,1644,0,0,0,0
"7016",2015-02-01,"sbte","transporte não regular","voo internacional",0,0,0,0,0,0,0,0,0,0
"7017",2015-02-01,"sbtf","transporte regular","voo doméstico",50,50,100,1915,2294,4209,0,0,0,0
"7018",2015-02-01,"sbtf","transporte regular","voo internacional",0,0,0,0,0,0,0,0,0,0
"7019",2015-02-01,"sbtf","transporte não regular","voo doméstico",163,161,324,292,224,516,1733,8311,10044,16977
"7020",2015-02-01,"sbtf","transporte não regular","voo internacional",0,0,0,0,0,0,0,0,0,0
"7021",2015-02-01,"sbtt","transporte regular","voo doméstico",28,28,56,2326,2991,5317,0,0,0,0
"7022",2015-02-01,"sbtt","transporte regular","voo internacional",0,0,0,0,0,0,0,0,0,0
"7023",2015-02-01,"sbtt","transporte não regular","voo doméstico",101,102,203,436,379,815,1200,2859,4059,468
"7024",2015-02-01,"sbtt","transporte não regular","voo internacional",5,8,13,11,13,24,0,0,0,0
"7025",2015-02-01,"sbuf","transporte regular","voo doméstico",19,19,38,885,818,1703,0,0,0,0
"7026",2015-02-01,"sbuf","transporte regular","voo internacional",0,0,0,0,0,0,0,0,0,0
"7027",2015-02-01,"sbuf","transporte não regular","voo doméstico",31,33,64,80,60,140,0,0,0,0
"7028",2015-02-01,"sbuf","transporte não regular","voo internacional",0,0,0,0,0,0,0,0,0,0
"7029",2015-02-01,"sbug","transporte regular","voo doméstico",0,0,0,0,0,0,0,0,0,0
"7030",2015-02-01,"sbug","transporte regular","voo internacional",0,0,0,0,0,0,0,0,0,0
"7031",2015-02-01,"sbug","transporte não regular","voo doméstico",5,5,10,9,4,13,0,0,0,0
"7032",2015-02-01,"sbug","transporte não regular","voo internacional",0,0,0,0,0,0,0,0,0,0
"7033",2015-02-01,"sbul","transporte regular","voo doméstico",516,512,1028,42324,42582,84906,0,0,0,0
"7034",2015-02-01,"sbul","transporte regular","voo internacional",0,0,0,0,0,0,0,0,0,0
"7035",2015-02-01,"sbul","transporte não regular","voo doméstico",462,466,928,1059,1088,2147,0,0,0,0
"7036",2015-02-01,"sbul","transporte não regular","voo internacional",1,1,2,9,8,17,0,0,0,0
"7037",2015-02-01,"sbur","transporte regular","voo doméstico",110,109,219,4343,4308,8651,1,0,1,0
"7038",2015-02-01,"sbur","transporte regular","voo internacional",0,0,0,0,0,0,0,0,0,0
"7039",2015-02-01,"sbur","transporte não regular","voo doméstico",140,145,285,838,904,1742,0,0,0,0
"7040",2015-02-01,"sbur","transporte não regular","voo internacional",0,0,0,0,0,0,0,0,0,0
"7041",2015-01-01,"sbbe","transporte regular","voo doméstico",1806,1828,3634,170736,165831,336567,83299,302816,386115,0
"7042",2015-01-01,"sbbe","transporte regular","voo internacional",38,38,76,5384,4024,9408,0,58,58,0
"7043",2015-01-01,"sbbe","transporte não regular","voo doméstico",475,459,934,4150,5064,9214,0,0,0,0
"7044",2015-01-01,"sbbe","transporte não regular","voo internacional",7,9,16,32,16,48,0,0,0,0
"7045",2015-01-01,"sbbg","transporte regular","voo doméstico",0,0,0,0,0,0,0,0,0,0
"7046",2015-01-01,"sbbg","transporte regular","voo internacional",0,0,0,0,0,0,0,0,0,0
"7047",2015-01-01,"sbbg","transporte não regular","voo doméstico",11,11,22,77,42,119,0,0,0,0
"7048",2015-01-01,"sbbg","transporte não regular","voo internacional",2,2,4,5,5,10,0,0,0,0
"7049",2015-01-01,"sbbh","transporte regular","voo doméstico",353,333,686,31997,18755,50752,0,0,0,0
"7050",2015-01-01,"sbbh","transporte regular","voo internacional",0,0,0,0,0,0,0,0,0,0
"7051",2015-01-01,"sbbh","transporte não regular","voo doméstico",1663,1664,3327,12223,9430,21653,0,0,0,0
"7052",2015-01-01,"sbbh","transporte não regular","voo internacional",1,1,2,0,0,0,0,0,0,0
"7053",2015-01-01,"sbbi","transporte regular","voo doméstico",0,0,0,0,0,0,0,0,0,0
"7054",2015-01-01,"sbbi","transporte regular","voo internacional",0,0,0,0,0,0,0,0,0,0
"7055",2015-01-01,"sbbi","transporte não regular","voo doméstico",1182,1168,2350,6117,6096,12213,0,0,0,0
"7056",2015-01-01,"sbbi","transporte não regular","voo internacional",0,0,0,0,0,0,0,0,0,0
"7057",2015-01-01,"sbbv","transporte regular","voo doméstico",118,118,236,17003,17754,34757,0,0,0,0
"7058",2015-01-01,"sbbv","transporte regular","voo internacional",0,0,0,0,0,0,0,0,0,0
"7059",2015-01-01,"sbbv","transporte não regular","voo doméstico",227,225,452,227,102,329,0,0,0,0
"7060",2015-01-01,"sbbv","transporte não regular","voo internacional",14,14,28,0,1,1,0,0,0,0
"7061",2015-01-01,"sbcg","transporte regular","voo doméstico",657,662,1319,73101,68495,141596,19863,36128,55991,0
"7062",2015-01-01,"sbcg","transporte regular","voo internacional",0,0,0,0,0,0,0,0,0,0
"7063",2015-01-01,"sbcg","transporte não regular","voo doméstico",254,249,503,2090,1938,4028,13023,31436,44459,0
"7064",2015-01-01,"sbcg","transporte não regular","voo internacional",18,18,36,291,306,597,0,0,0,0
"7065",2015-01-01,"sbcj","transporte regular","voo doméstico",120,118,238,7339,8274,15613,0,0,0,0
"7066",2015-01-01,"sbcj","transporte regular","voo internacional",0,0,0,0,0,0,0,0,0,0
"7067",2015-01-01,"sbcj","transporte não regular","voo doméstico",102,104,206,786,865,1651,0,0,0,0
"7068",2015-01-01,"sbcj","transporte não regular","voo internacional",0,0,0,0,0,0,0,0,0,0
"7069",2015-01-01,"sbcr","transporte regular","voo doméstico",24,24,48,1372,1364,2736,0,0,0,0
"7070",2015-01-01,"sbcr","transporte regular","voo internacional",0,0,0,0,0,0,0,0,0,0
"7071",2015-01-01,"sbcr","transporte não regular","voo doméstico",39,38,77,81,68,149,0,0,0,0
"7072",2015-01-01,"sbcr","transporte não regular","voo internacional",4,4,8,7,6,13,0,0,0,0
"7073",2015-01-01,"sbct","transporte regular","voo doméstico",2872,2878,5750,313977,313346,627323,177244,0,177244,158754
"7074",2015-01-01,"sbct","transporte regular","voo internacional",102,102,204,5813,7863,13676,0,6938,6938,3531
"7075",2015-01-01,"sbct","transporte não regular","voo doméstico",202,192,394,2838,3900,6738,0,0,0,0
"7076",2015-01-01,"sbct","transporte não regular","voo internacional",11,12,23,11,16,27,0,0,0,0
"7077",2015-01-01,"sbcz","transporte regular","voo doméstico",30,30,60,2551,1865,4416,0,0,0,0
"7078",2015-01-01,"sbcz","transporte regular","voo internacional",0,0,0,0,0,0,0,0,0,0
"7079",2015-01-01,"sbcz","transporte não regular","voo doméstico",137,136,273,510,442,952,0,0,0,0
"7080",2015-01-01,"sbcz","transporte não regular","voo internacional",3,3,6,0,0,0,0,0,0,0
"7081",2015-01-01,"sbeg","transporte regular","voo doméstico",1318,1307,2625,138968,141481,280449,668,213,881,0
"7082",2015-01-01,"sbeg","transporte regular","voo internacional",136,140,276,15290,11649,26939,0,0,0,0
"7083",2015-01-01,"sbeg","transporte não regular","voo doméstico",653,672,1325,13785,17164,30949,0,0,0,0
"7084",2015-01-01,"sbeg","transporte não regular","voo internacional",128,120,248,1070,764,1834,0,0,0,0
"7085",2015-01-01,"sbfi","transporte regular","voo doméstico",677,680,1357,98037,90365,188402,0,0,0,0
"7086",2015-01-01,"sbfi","transporte regular","voo internacional",31,31,62,3972,4055,8027,0,0,0,0
"7087",2015-01-01,"sbfi","transporte não regular","voo doméstico",125,118,243,2455,3053,5508,0,0,0,0
"7088",2015-01-01,"sbfi","transporte não regular","voo internacional",46,47,93,163,215,378,0,0,0,0
"7089",2015-01-01,"sbgo","transporte regular","voo doméstico",1449,1439,2888,142116,149745,291861,84058,121266,205324,130197
"7090",2015-01-01,"sbgo","transporte regular","voo internacional",0,0,0,0,0,0,0,0,0,0
"7091",2015-01-01,"sbgo","transporte não regular","voo doméstico",1061,1032,2093,3528,4806,8334,0,0,0,0
"7092",2015-01-01,"sbgo","transporte não regular","voo internacional",1,1,2,0,0,0,0,0,0,0
"7093",2015-01-01,"sbht","transporte regular","voo doméstico",281,283,564,11337,12499,23836,0,0,0,0
"7094",2015-01-01,"sbht","transporte regular","voo internacional",0,0,0,0,0,0,0,0,0,0
"7095",2015-01-01,"sbht","transporte não regular","voo doméstico",198,196,394,1354,2310,3664,1090,1480,2570,770
"7096",2015-01-01,"sbht","transporte não regular","voo internacional",0,0,0,0,0,0,0,0,0,0
"7097",2015-01-01,"sbiz","transporte regular","voo doméstico",249,249,498,12428,12571,24999,0,0,0,0
"7098",2015-01-01,"sbiz","transporte regular","voo internacional",0,0,0,0,0,0,0,0,0,0
"7099",2015-01-01,"sbiz","transporte não regular","voo doméstico",120,120,240,404,301,705,0,0,0,0
"7100",2015-01-01,"sbiz","transporte não regular","voo internacional",0,0,0,0,0,0,0,0,0,0
"7101",2015-01-01,"sbjc","transporte regular","voo doméstico",0,0,0,0,0,0,0,0,0,0
"7102",2015-01-01,"sbjc","transporte regular","voo internacional",0,0,0,0,0,0,0,0,0,0
"7103",2015-01-01,"sbjc","transporte não regular","voo doméstico",373,378,751,669,502,1171,0,0,0,0
"7104",2015-01-01,"sbjc","transporte não regular","voo internacional",0,0,0,0,0,0,0,0,0,0
"7105",2015-01-01,"sbjr","transporte regular","voo doméstico",0,0,0,0,0,0,0,0,0,0
"7106",2015-01-01,"sbjr","transporte regular","voo internacional",0,0,0,0,0,0,0,0,0,0
"7107",2015-01-01,"sbjr","transporte não regular","voo doméstico",3013,3005,6018,12798,10247,23045,0,0,0,0
"7108",2015-01-01,"sbjr","transporte não regular","voo internacional",0,0,0,0,0,0,0,0,0,0
"7109",2015-01-01,"sbjv","transporte regular","voo doméstico",213,214,427,22445,20475,42920,0,0,0,0
"7110",2015-01-01,"sbjv","transporte regular","voo internacional",0,0,0,0,0,0,0,0,0,0
"7111",2015-01-01,"sbjv","transporte não regular","voo doméstico",185,184,369,49,351,400,0,0,0,0
"7112",2015-01-01,"sbjv","transporte não regular","voo internacional",1,1,2,0,0,0,0,0,0,0
"7113",2015-01-01,"sblo","transporte regular","voo doméstico",423,424,847,47111,45719,92830,0,0,0,0
"7114",2015-01-01,"sblo","transporte regular","voo internacional",0,0,0,0,0,0,0,0,0,0
"7115",2015-01-01,"sblo","transporte não regular","voo doméstico",515,515,1030,2225,1777,4002,0,0,0,0
"7116",2015-01-01,"sblo","transporte não regular","voo internacional",2,2,4,0,0,0,0,0,0,0
"7117",2015-01-01,"sbma","transporte regular","voo doméstico",325,327,652,18123,18234,36357,0,0,0,0
"7118",2015-01-01,"sbma","transporte regular","voo internacional",0,0,0,0,0,0,0,0,0,0
"7119",2015-01-01,"sbma","transporte não regular","voo doméstico",219,216,435,756,1008,1764,0,0,0,0
"7120",2015-01-01,"sbma","transporte não regular","voo internacional",1,1,2,0,0,0,0,0,0,0
"7121",2015-01-01,"sbmk","transporte regular","voo doméstico",164,161,325,16862,14588,31450,0,0,0,0
"7122",2015-01-01,"sbmk","transporte regular","voo internacional",0,0,0,0,0,0,0,0,0,0
"7123",2015-01-01,"sbmk","transporte não regular","voo doméstico",187,190,377,1234,1188,2422,0,0,0,0
"7124",2015-01-01,"sbmk","transporte não regular","voo internacional",0,0,0,0,0,0,0,0,0,0
"7125",2015-01-01,"sbmq","transporte regular","voo doméstico",349,348,697,31068,34207,65275,18900,37217,56117,0
"7126",2015-01-01,"sbmq","transporte regular","voo internacional",0,0,0,0,0,0,0,0,0,0
"7127",2015-01-01,"sbmq","transporte não regular","voo doméstico",128,127,255,381,375,756,0,0,0,0
"7128",2015-01-01,"sbmq","transporte não regular","voo internacional",3,4,7,0,0,0,0,0,0,0
"7129",2015-01-01,"sbmt","transporte regular","voo doméstico",0,0,0,0,0,0,0,0,0,0
"7130",2015-01-01,"sbmt","transporte regular","voo internacional",0,0,0,0,0,0,0,0,0,0
"7131",2015-01-01,"sbmt","transporte não regular","voo doméstico",3981,3956,7937,6660,6670,13330,0,0,0,0
"7132",2015-01-01,"sbmt","transporte não regular","voo internacional",0,0,0,0,0,0,0,0,0,0
"7133",2015-01-01,"sbnf","transporte regular","voo doméstico",610,609,1219,70320,63655,133975,0,0,0,0
"7134",2015-01-01,"sbnf","transporte regular","voo internacional",0,0,0,0,0,0,0,0,0,0
"7135",2015-01-01,"sbnf","transporte não regular","voo doméstico",322,327,649,1422,1268,2690,0,0,0,0
"7136",2015-01-01,"sbnf","transporte não regular","voo internacional",8,8,16,21,8,29,0,0,0,0
"7137",2015-01-01,"sbpb","transporte regular","voo doméstico",22,22,44,837,1012,1849,0,0,0,0
"7138",2015-01-01,"sbpb","transporte regular","voo internacional",0,0,0,0,0,0,0,0,0,0
"7139",2015-01-01,"sbpb","transporte não regular","voo doméstico",49,62,111,403,270,673,0,0,0,0
"7140",2015-01-01,"sbpb","transporte não regular","voo internacional",0,0,0,0,0,0,0,0,0,0
"7141",2015-01-01,"sbpj","transporte regular","voo doméstico",344,343,687,26594,28170,54764,0,0,0,0
"7142",2015-01-01,"sbpj","transporte regular","voo internacional",0,0,0,0,0,0,0,0,0,0
"7143",2015-01-01,"sbpj","transporte não regular","voo doméstico",254,255,509,414,340,754,0,0,0,0
"7144",2015-01-01,"sbpj","transporte não regular","voo internacional",1,1,2,0,0,0,0,0,0,0
"7145",2015-01-01,"sbpk","transporte regular","voo doméstico",30,29,59,1676,1557,3233,0,0,0,0
"7146",2015-01-01,"sbpk","transporte regular","voo internacional",0,0,0,0,0,0,0,0,0,0
"7147",2015-01-01,"sbpk","transporte não regular","voo doméstico",53,54,107,106,101,207,0,0,0,0
"7148",2015-01-01,"sbpk","transporte não regular","voo internacional",5,6,11,10,16,26,0,0,0,0
"7149",2015-01-01,"sbpl","transporte regular","voo doméstico",181,181,362,24419,23115,47534,0,0,0,0
"7150",2015-01-01,"sbpl","transporte regular","voo internacional",0,0,0,0,0,0,0,0,0,0
"7151",2015-01-01,"sbpl","transporte não regular","voo doméstico",83,83,166,64,91,155,0,0,0,0
"7152",2015-01-01,"sbpl","transporte não regular","voo internacional",0,0,0,0,0,0,0,0,0,0
"7153",2015-01-01,"sbpp","transporte regular","voo doméstico",0,0,0,0,0,0,0,0,0,0
"7154",2015-01-01,"sbpp","transporte regular","voo internacional",0,0,0,0,0,0,0,0,0,0
"7155",2015-01-01,"sbpp","transporte não regular","voo doméstico",64,62,126,135,140,275,0,0,0,0
"7156",2015-01-01,"sbpp","transporte não regular","voo internacional",5,5,10,1,1,2,0,0,0,0
"7157",2015-01-01,"sbpr","transporte regular","voo doméstico",0,0,0,0,0,0,0,0,0,0
"7158",2015-01-01,"sbpr","transporte regular","voo internacional",0,0,0,0,0,0,0,0,0,0
"7159",2015-01-01,"sbpr","transporte não regular","voo doméstico",869,861,1730,1118,1049,2167,0,0,0,0
"7160",2015-01-01,"sbpr","transporte não regular","voo internacional",0,1,1,0,0,0,0,0,0,0
"7161",2015-01-01,"sbpv","transporte regular","voo doméstico",453,451,904,45027,45079,90106,41512,175051,216563,0
"7162",2015-01-01,"sbpv","transporte regular","voo internacional",0,0,0,0,0,0,0,0,0,0
"7163",2015-01-01,"sbpv","transporte não regular","voo doméstico",194,194,388,118,74,192,0,0,0,0
"7164",2015-01-01,"sbpv","transporte não regular","voo internacional",0,0,0,0,0,0,0,0,0,0
"7165",2015-01-01,"sbrb","transporte regular","voo doméstico",164,163,327,17504,16881,34385,0,72,72,883
"7166",2015-01-01,"sbrb","transporte regular","voo internacional",0,0,0,0,0,0,0,0,0,0
"7167",2015-01-01,"sbrb","transporte não regular","voo doméstico",151,152,303,534,294,828,0,0,0,0
"7168",2015-01-01,"sbrb","transporte não regular","voo internacional",0,0,0,0,0,0,0,0,0,0
"7169",2015-01-01,"sbrj","transporte regular","voo doméstico",4479,4483,8962,487095,436954,924049,0,0,0,0
"7170",2015-01-01,"sbrj","transporte regular","voo internacional",0,0,0,0,0,0,0,0,0,0
"7171",2015-01-01,"sbrj","transporte não regular","voo doméstico",761,761,1522,6641,6197,12838,0,0,0,0
"7172",2015-01-01,"sbrj","transporte não regular","voo internacional",0,0,0,0,0,0,0,0,0,0
"7173",2015-01-01,"sbsj","transporte regular","voo doméstico",0,0,0,0,0,0,0,0,0,0
"7174",2015-01-01,"sbsj","transporte regular","voo internacional",0,0,0,0,0,0,0,0,0,0
"7175",2015-01-01,"sbsj","transporte não regular","voo doméstico",492,477,969,1010,866,1876,0,0,0,0
"7176",2015-01-01,"sbsj","transporte não regular","voo internacional",3,8,11,2,1,3,0,0,0,0
"7177",2015-01-01,"sbsl","transporte regular","voo doméstico",756,727,1483,71367,74362,145729,0,1447,1447,1
"7178",2015-01-01,"sbsl","transporte regular","voo internacional",0,0,0,0,0,0,0,0,0,0
"7179",2015-01-01,"sbsl","transporte não regular","voo doméstico",264,293,557,8415,4112,12527,80101,176748,256849,9106
"7180",2015-01-01,"sbsl","transporte não regular","voo internacional",1,0,1,0,0,0,0,0,0,0
"7181",2015-01-01,"sbsn","transporte regular","voo doméstico",418,439,857,26204,21872,48076,0,0,0,0
"7182",2015-01-01,"sbsn","transporte regular","voo internacional",0,0,0,0,0,0,0,0,0,0
"7183",2015-01-01,"sbsn","transporte não regular","voo doméstico",351,327,678,1076,1653,2729,0,0,0,0
"7184",2015-01-01,"sbsn","transporte não regular","voo internacional",1,0,1,0,0,0,0,0,0,0
"7185",2015-01-01,"sbsp","transporte regular","voo doméstico",7006,7058,14064,835863,881149,1717012,0,0,0,0
"7186",2015-01-01,"sbsp","transporte regular","voo internacional",0,0,0,0,0,0,0,0,0,0
"7187",2015-01-01,"sbsp","transporte não regular","voo doméstico",1802,1744,3546,12663,12682,25345,0,0,0,0
"7188",2015-01-01,"sbsp","transporte não regular","voo internacional",0,0,0,0,0,0,0,0,0,0
"7189",2015-01-01,"sbte","transporte regular","voo doméstico",474,491,965,56781,48042,104823,21360,84329,105689,245557
"7190",2015-01-01,"sbte","transporte regular","voo internacional",0,0,0,0,0,0,0,0,0,0
"7191",2015-01-01,"sbte","transporte não regular","voo doméstico",270,247,517,7062,9335,16397,0,0,0,0
"7192",2015-01-01,"sbte","transporte não regular","voo internacional",0,0,0,0,0,0,0,0,0,0
"7193",2015-01-01,"sbtf","transporte regular","voo doméstico",55,54,109,2063,2199,4262,0,0,0,0
"7194",2015-01-01,"sbtf","transporte regular","voo internacional",0,0,0,0,0,0,0,0,0,0
"7195",2015-01-01,"sbtf","transporte não regular","voo doméstico",177,178,355,402,292,694,2436,2261,4697,17307
"7196",2015-01-01,"sbtf","transporte não regular","voo internacional",0,0,0,0,0,0,0,0,0,0
"7197",2015-01-01,"sbtt","transporte regular","voo doméstico",31,31,62,2787,3204,5991,0,0,0,0
"7198",2015-01-01,"sbtt","transporte regular","voo internacional",0,0,0,0,0,0,0,0,0,0
"7199",2015-01-01,"sbtt","transporte não regular","voo doméstico",132,130,262,561,534,1095,1502,2773,4275,517
"7200",2015-01-01,"sbtt","transporte não regular","voo internacional",2,1,3,3,2,5,0,0,0,0
"7201",2015-01-01,"sbuf","transporte regular","voo doméstico",21,21,42,1184,1120,2304,0,0,0,0
"7202",2015-01-01,"sbuf","transporte regular","voo internacional",0,0,0,0,0,0,0,0,0,0
"7203",2015-01-01,"sbuf","transporte não regular","voo doméstico",49,48,97,157,94,251,0,0,0,0
"7204",2015-01-01,"sbuf","transporte não regular","voo internacional",0,0,0,0,0,0,0,0,0,0
"7205",2015-01-01,"sbug","transporte regular","voo doméstico",0,0,0,0,0,0,0,0,0,0
"7206",2015-01-01,"sbug","transporte regular","voo internacional",0,0,0,0,0,0,0,0,0,0
"7207",2015-01-01,"sbug","transporte não regular","voo doméstico",12,12,24,28,17,45,0,0,0,0
"7208",2015-01-01,"sbug","transporte não regular","voo internacional",0,0,0,0,0,0,0,0,0,0
"7209",2015-01-01,"sbul","transporte regular","voo doméstico",543,547,1090,51746,50299,102045,0,0,0,0
"7210",2015-01-01,"sbul","transporte regular","voo internacional",0,0,0,0,0,0,0,0,0,0
"7211",2015-01-01,"sbul","transporte não regular","voo doméstico",601,599,1200,2107,1589,3696,0,0,0,0
"7212",2015-01-01,"sbul","transporte não regular","voo internacional",1,1,2,10,10,20,0,0,0,0
"7213",2015-01-01,"sbur","transporte regular","voo doméstico",105,103,208,4083,4208,8291,0,1,1,0
"7214",2015-01-01,"sbur","transporte regular","voo internacional",0,0,0,0,0,0,0,0,0,0
"7215",2015-01-01,"sbur","transporte não regular","voo doméstico",138,133,271,411,431,842,0,0,0,0
"7216",2015-01-01,"sbur","transporte não regular","voo internacional",0,0,0,0,0,0,0,0,0,0
"7217",2015-07-01,"sbbe","transporte regular","voo doméstico",1703,1695,3398,180639,179931,360570,94781,356455,451236,0
"7218",2015-07-01,"sbbe","transporte regular","voo internacional",39,39,78,4679,5067,9746,0,166,166,0
"7219",2015-07-01,"sbbe","transporte não regular","voo doméstico",546,554,1100,4573,4914,9487,0,0,0,0
"7220",2015-07-01,"sbbe","transporte não regular","voo internacional",5,6,11,16,16,32,0,0,0,0
"7221",2015-07-01,"sbbg","transporte regular","voo doméstico",0,0,0,0,0,0,0,0,0,0
"7222",2015-07-01,"sbbg","transporte regular","voo internacional",0,0,0,0,0,0,0,0,0,0
"7223",2015-07-01,"sbbg","transporte não regular","voo doméstico",19,20,39,81,76,157,0,0,0,0
"7224",2015-07-01,"sbbg","transporte não regular","voo internacional",2,1,3,0,8,8,0,0,0,0
"7225",2015-07-01,"sbbh","transporte regular","voo doméstico",329,331,660,19595,17683,37278,0,0,0,0
"7226",2015-07-01,"sbbh","transporte regular","voo internacional",0,0,0,0,0,0,0,0,0,0
"7227",2015-07-01,"sbbh","transporte não regular","voo doméstico",1876,1872,3748,8435,8623,17058,0,0,0,0
"7228",2015-07-01,"sbbh","transporte não regular","voo internacional",2,2,4,8,8,16,0,0,0,0
"7229",2015-07-01,"sbbi","transporte regular","voo doméstico",0,0,0,0,0,0,0,0,0,0
"7230",2015-07-01,"sbbi","transporte regular","voo internacional",0,0,0,0,0,0,0,0,0,0
"7231",2015-07-01,"sbbi","transporte não regular","voo doméstico",1021,1026,2047,4463,4409,8872,0,0,0,0
"7232",2015-07-01,"sbbi","transporte não regular","voo internacional",4,3,7,0,0,0,0,0,0,0
"7233",2015-07-01,"sbbv","transporte regular","voo doméstico",111,111,222,15882,15280,31162,0,0,0,0
"7234",2015-07-01,"sbbv","transporte regular","voo internacional",0,0,0,0,0,0,0,0,0,0
"7235",2015-07-01,"sbbv","transporte não regular","voo doméstico",265,265,530,100,81,181,0,0,0,0
"7236",2015-07-01,"sbbv","transporte não regular","voo internacional",19,18,37,14,7,21,0,0,0,0
"7237",2015-07-01,"sbcg","transporte regular","voo doméstico",662,660,1322,73255,71766,145021,75300,155325,230625,0
"7238",2015-07-01,"sbcg","transporte regular","voo internacional",14,14,28,277,245,522,0,0,0,0
"7239",2015-07-01,"sbcg","transporte não regular","voo doméstico",335,336,671,697,410,1107,0,3256,3256,0
"7240",2015-07-01,"sbcg","transporte não regular","voo internacional",10,11,21,0,0,0,0,0,0,0
"7241",2015-07-01,"sbcj","transporte regular","voo doméstico",120,120,240,10957,10628,21585,0,0,0,0
"7242",2015-07-01,"sbcj","transporte regular","voo internacional",0,0,0,0,0,0,0,0,0,0
"7243",2015-07-01,"sbcj","transporte não regular","voo doméstico",89,91,180,349,91,440,0,0,0,0
"7244",2015-07-01,"sbcj","transporte não regular","voo internacional",0,0,0,0,0,0,0,0,0,0
"7245",2015-07-01,"sbcr","transporte regular","voo doméstico",27,27,54,1609,1547,3156,0,0,0,0
"7246",2015-07-01,"sbcr","transporte regular","voo internacional",0,0,0,0,0,0,0,0,0,0
"7247",2015-07-01,"sbcr","transporte não regular","voo doméstico",33,33,66,76,137,213,0,0,0,0
"7248",2015-07-01,"sbcr","transporte não regular","voo internacional",8,9,17,15,8,23,0,0,0,0
"7249",2015-07-01,"sbct","transporte regular","voo doméstico",2807,2837,5644,316148,312307,628455,142399,7919,150318,138454
"7250",2015-07-01,"sbct","transporte regular","voo internacional",113,113,226,6266,6468,12734,0,5695,5695,0
"7251",2015-07-01,"sbct","transporte não regular","voo doméstico",240,212,452,3450,4849,8299,0,0,0,0
"7252",2015-07-01,"sbct","transporte não regular","voo internacional",8,8,16,29,161,190,0,0,0,0
"7253",2015-07-01,"sbcz","transporte regular","voo doméstico",32,31,63,3062,3140,6202,0,0,0,0
"7254",2015-07-01,"sbcz","transporte regular","voo internacional",0,0,0,0,0,0,0,0,0,0
"7255",2015-07-01,"sbcz","transporte não regular","voo doméstico",197,194,391,697,677,1374,0,0,0,0
"7256",2015-07-01,"sbcz","transporte não regular","voo internacional",0,1,1,0,0,0,0,0,0,0
"7257",2015-07-01,"sbeg","transporte regular","voo doméstico",1279,1276,2555,134993,139632,274625,0,0,0,0
"7258",2015-07-01,"sbeg","transporte regular","voo internacional",133,141,274,8177,8367,16544,0,0,0,0
"7259",2015-07-01,"sbeg","transporte não regular","voo doméstico",583,573,1156,7294,8443,15737,0,0,0,0
"7260",2015-07-01,"sbeg","transporte não regular","voo internacional",92,98,190,1146,1268,2414,0,0,0,0
"7261",2015-07-01,"sbfi","transporte regular","voo doméstico",681,679,1360,91527,92501,184028,0,0,0,0
"7262",2015-07-01,"sbfi","transporte regular","voo internacional",22,22,44,2845,2755,5600,0,0,0,0
"7263",2015-07-01,"sbfi","transporte não regular","voo doméstico",163,165,328,2264,4499,6763,0,0,0,0
"7264",2015-07-01,"sbfi","transporte não regular","voo internacional",36,36,72,47,55,102,0,0,0,0
"7265",2015-07-01,"sbgo","transporte regular","voo doméstico",1495,1491,2986,157219,155638,312857,168310,194655,362965,213336
"7266",2015-07-01,"sbgo","transporte regular","voo internacional",0,0,0,0,0,0,0,0,0,0
"7267",2015-07-01,"sbgo","transporte não regular","voo doméstico",1572,1560,3132,5590,6874,12464,0,0,0,0
"7268",2015-07-01,"sbgo","transporte não regular","voo internacional",0,0,0,0,0,0,0,0,0,0
"7269",2015-07-01,"sbht","transporte regular","voo doméstico",253,253,506,16265,16121,32386,0,0,0,0
"7270",2015-07-01,"sbht","transporte regular","voo internacional",0,0,0,0,0,0,0,0,0,0
"7271",2015-07-01,"sbht","transporte não regular","voo doméstico",218,220,438,920,807,1727,330,980,1310,200
"7272",2015-07-01,"sbht","transporte não regular","voo internacional",0,0,0,0,0,0,0,0,0,0
"7273",2015-07-01,"sbiz","transporte regular","voo doméstico",228,228,456,15400,15747,31147,0,0,0,0
"7274",2015-07-01,"sbiz","transporte regular","voo internacional",0,0,0,0,0,0,0,0,0,0
"7275",2015-07-01,"sbiz","transporte não regular","voo doméstico",156,159,315,447,399,846,0,0,0,0
"7276",2015-07-01,"sbiz","transporte não regular","voo internacional",0,0,0,0,0,0,0,0,0,0
"7277",2015-07-01,"sbjc","transporte regular","voo doméstico",0,0,0,0,0,0,0,0,0,0
"7278",2015-07-01,"sbjc","transporte regular","voo internacional",0,0,0,0,0,0,0,0,0,0
"7279",2015-07-01,"sbjc","transporte não regular","voo doméstico",418,423,841,834,775,1609,0,0,0,0
"7280",2015-07-01,"sbjc","transporte não regular","voo internacional",0,0,0,0,0,0,0,0,0,0
"7281",2015-07-01,"sbjr","transporte regular","voo doméstico",0,0,0,0,0,0,0,0,0,0
"7282",2015-07-01,"sbjr","transporte regular","voo internacional",0,0,0,0,0,0,0,0,0,0
"7283",2015-07-01,"sbjr","transporte não regular","voo doméstico",2513,2510,5023,8495,6625,15120,0,0,0,0
"7284",2015-07-01,"sbjr","transporte não regular","voo internacional",0,0,0,0,0,0,0,0,0,0
"7285",2015-07-01,"sbjv","transporte regular","voo doméstico",275,274,549,24317,24006,48323,0,0,0,0
"7286",2015-07-01,"sbjv","transporte regular","voo internacional",0,0,0,0,0,0,0,0,0,0
"7287",2015-07-01,"sbjv","transporte não regular","voo doméstico",220,217,437,173,660,833,0,0,0,0
"7288",2015-07-01,"sbjv","transporte não regular","voo internacional",0,0,0,0,0,0,0,0,0,0
"7289",2015-07-01,"sblo","transporte regular","voo doméstico",422,420,842,44075,43689,87764,0,0,0,0
"7290",2015-07-01,"sblo","transporte regular","voo internacional",0,0,0,0,0,0,0,0,0,0
"7291",2015-07-01,"sblo","transporte não regular","voo doméstico",668,666,1334,835,1859,2694,0,0,0,0
"7292",2015-07-01,"sblo","transporte não regular","voo internacional",2,2,4,0,0,0,0,0,0,0
"7293",2015-07-01,"sbma","transporte regular","voo doméstico",287,287,574,20457,20753,41210,0,0,0,0
"7294",2015-07-01,"sbma","transporte regular","voo internacional",0,0,0,0,0,0,0,0,0,0
"7295",2015-07-01,"sbma","transporte não regular","voo doméstico",259,259,518,1228,1147,2375,0,0,0,0
"7296",2015-07-01,"sbma","transporte não regular","voo internacional",1,1,2,0,0,0,0,0,0,0
"7297",2015-07-01,"sbmk","transporte regular","voo doméstico",163,162,325,18018,16726,34744,0,0,0,0
"7298",2015-07-01,"sbmk","transporte regular","voo internacional",0,0,0,0,0,0,0,0,0,0
"7299",2015-07-01,"sbmk","transporte não regular","voo doméstico",255,253,508,14,1,15,0,0,0,0
"7300",2015-07-01,"sbmk","transporte não regular","voo internacional",2,2,4,0,0,0,0,0,0,0
"7301",2015-07-01,"sbmq","transporte regular","voo doméstico",312,306,618,35702,33110,68812,17960,37304,55264,0
"7302",2015-07-01,"sbmq","transporte regular","voo internacional",0,0,0,0,0,0,0,0,0,0
"7303",2015-07-01,"sbmq","transporte não regular","voo doméstico",187,196,383,775,448,1223,0,0,0,0
"7304",2015-07-01,"sbmq","transporte não regular","voo internacional",3,5,8,0,0,0,0,0,0,0
"7305",2015-07-01,"sbmt","transporte regular","voo doméstico",0,0,0,0,0,0,0,0,0,0
"7306",2015-07-01,"sbmt","transporte regular","voo internacional",0,0,0,0,0,0,0,0,0,0
"7307",2015-07-01,"sbmt","transporte não regular","voo doméstico",3750,3739,7489,5522,5435,10957,0,0,0,0
"7308",2015-07-01,"sbmt","transporte não regular","voo internacional",0,0,0,0,0,0,0,0,0,0
"7309",2015-07-01,"sbnf","transporte regular","voo doméstico",631,636,1267,65923,66325,132248,0,0,0,0
"7310",2015-07-01,"sbnf","transporte regular","voo internacional",0,0,0,0,0,0,0,0,0,0
"7311",2015-07-01,"sbnf","transporte não regular","voo doméstico",194,191,385,622,777,1399,0,0,0,0
"7312",2015-07-01,"sbnf","transporte não regular","voo internacional",4,3,7,11,10,21,0,0,0,0
"7313",2015-07-01,"sbpb","transporte regular","voo doméstico",21,21,42,849,849,1698,0,0,0,0
"7314",2015-07-01,"sbpb","transporte regular","voo internacional",0,0,0,0,0,0,0,0,0,0
"7315",2015-07-01,"sbpb","transporte não regular","voo doméstico",58,53,111,118,133,251,0,0,0,0
"7316",2015-07-01,"sbpb","transporte não regular","voo internacional",0,0,0,0,0,0,0,0,0,0
"7317",2015-07-01,"sbpj","transporte regular","voo doméstico",331,330,661,30695,30697,61392,0,0,0,0
"7318",2015-07-01,"sbpj","transporte regular","voo internacional",0,0,0,0,0,0,0,0,0,0
"7319",2015-07-01,"sbpj","transporte não regular","voo doméstico",279,282,561,502,318,820,0,0,0,0
"7320",2015-07-01,"sbpj","transporte não regular","voo internacional",0,0,0,0,0,0,0,0,0,0
"7321",2015-07-01,"sbpk","transporte regular","voo doméstico",27,27,54,1364,1522,2886,0,0,0,0
"7322",2015-07-01,"sbpk","transporte regular","voo internacional",0,0,0,0,0,0,0,0,0,0
"7323",2015-07-01,"sbpk","transporte não regular","voo doméstico",37,39,76,60,65,125,0,0,0,0
"7324",2015-07-01,"sbpk","transporte não regular","voo internacional",3,1,4,0,4,4,0,0,0,0
"7325",2015-07-01,"sbpl","transporte regular","voo doméstico",115,115,230,16692,16024,32716,0,0,0,0
"7326",2015-07-01,"sbpl","transporte regular","voo internacional",5,5,10,0,0,0,0,0,0,0
"7327",2015-07-01,"sbpl","transporte não regular","voo doméstico",114,115,229,3293,3365,6658,0,0,0,0
"7328",2015-07-01,"sbpl","transporte não regular","voo internacional",0,0,0,0,0,0,0,0,0,0
"7329",2015-07-01,"sbpp","transporte regular","voo doméstico",0,0,0,0,0,0,0,0,0,0
"7330",2015-07-01,"sbpp","transporte regular","voo internacional",0,0,0,0,0,0,0,0,0,0
"7331",2015-07-01,"sbpp","transporte não regular","voo doméstico",53,51,104,72,82,154,0,0,0,0
"7332",2015-07-01,"sbpp","transporte não regular","voo internacional",8,10,18,18,12,30,0,0,0,0
"7333",2015-07-01,"sbpr","transporte regular","voo doméstico",0,0,0,0,0,0,0,0,0,0
"7334",2015-07-01,"sbpr","transporte regular","voo internacional",0,0,0,0,0,0,0,0,0,0
"7335",2015-07-01,"sbpr","transporte não regular","voo doméstico",977,974,1951,1193,1022,2215,0,0,0,0
"7336",2015-07-01,"sbpr","transporte não regular","voo internacional",0,0,0,0,0,0,0,0,0,0
"7337",2015-07-01,"sbpv","transporte regular","voo doméstico",432,431,863,45264,42936,88200,2316,0,2316,0
"7338",2015-07-01,"sbpv","transporte regular","voo internacional",0,0,0,0,0,0,0,0,0,0
"7339",2015-07-01,"sbpv","transporte não regular","voo doméstico",293,295,588,389,477,866,0,0,0,0
"7340",2015-07-01,"sbpv","transporte não regular","voo internacional",4,4,8,0,0,0,0,0,0,0
"7341",2015-07-01,"sbrb","transporte regular","voo doméstico",119,119,238,13549,13446,26995,0,17,17,0
"7342",2015-07-01,"sbrb","transporte regular","voo internacional",0,0,0,0,0,0,0,0,0,0
"7343",2015-07-01,"sbrb","transporte não regular","voo doméstico",119,118,237,1231,960,2191,0,0,0,0
"7344",2015-07-01,"sbrb","transporte não regular","voo internacional",0,0,0,0,0,0,0,0,0,0
"7345",2015-07-01,"sbrj","transporte regular","voo doméstico",4365,4374,8739,422307,414626,836933,0,0,0,0
"7346",2015-07-01,"sbrj","transporte regular","voo internacional",0,0,0,0,0,0,0,0,0,0
"7347",2015-07-01,"sbrj","transporte não regular","voo doméstico",717,710,1427,1419,1274,2693,0,0,0,0
"7348",2015-07-01,"sbrj","transporte não regular","voo internacional",0,0,0,0,0,0,0,0,0,0
"7349",2015-07-01,"sbsj","transporte regular","voo doméstico",18,16,34,1485,1877,3362,0,0,0,0
"7350",2015-07-01,"sbsj","transporte regular","voo internacional",0,0,0,0,0,0,0,0,0,0
"7351",2015-07-01,"sbsj","transporte não regular","voo doméstico",530,517,1047,846,879,1725,0,0,0,0
"7352",2015-07-01,"sbsj","transporte não regular","voo internacional",4,19,23,0,7,7,0,0,0,0
"7353",2015-07-01,"sbsl","transporte regular","voo doméstico",785,782,1567,77367,81135,158502,0,0,0,0
"7354",2015-07-01,"sbsl","transporte regular","voo internacional",0,0,0,0,0,0,0,0,0,0
"7355",2015-07-01,"sbsl","transporte não regular","voo doméstico",259,266,525,3901,3645,7546,63458,206853,270311,0
"7356",2015-07-01,"sbsl","transporte não regular","voo internacional",0,0,0,0,0,0,0,0,0,0
"7357",2015-07-01,"sbsn","transporte regular","voo doméstico",424,423,847,37069,34508,71577,0,0,0,0
"7358",2015-07-01,"sbsn","transporte regular","voo internacional",0,0,0,0,0,0,0,0,0,0
"7359",2015-07-01,"sbsn","transporte não regular","voo doméstico",366,366,732,968,697,1665,0,0,0,0
"7360",2015-07-01,"sbsn","transporte não regular","voo internacional",0,0,0,0,0,0,0,0,0,0
"7361",2015-07-01,"sbsp","transporte regular","voo doméstico",7350,7405,14755,852626,858675,1711301,0,0,0,0
"7362",2015-07-01,"sbsp","transporte regular","voo internacional",0,0,0,0,0,0,0,0,0,0
"7363",2015-07-01,"sbsp","transporte não regular","voo doméstico",1532,1515,3047,13349,13457,26806,0,0,0,0
"7364",2015-07-01,"sbsp","transporte não regular","voo internacional",0,0,0,0,0,0,0,0,0,0
"7365",2015-07-01,"sbte","transporte regular","voo doméstico",628,632,1260,59319,59484,118803,27348,81962,109310,248968
"7366",2015-07-01,"sbte","transporte regular","voo internacional",0,0,0,0,0,0,0,0,0,0
"7367",2015-07-01,"sbte","transporte não regular","voo doméstico",276,271,547,1885,2648,4533,0,0,0,0
"7368",2015-07-01,"sbte","transporte não regular","voo internacional",0,0,0,0,0,0,0,0,0,0
"7369",2015-07-01,"sbtf","transporte regular","voo doméstico",27,27,54,2160,2327,4487,0,0,0,0
"7370",2015-07-01,"sbtf","transporte regular","voo internacional",0,0,0,0,0,0,0,0,0,0
"7371",2015-07-01,"sbtf","transporte não regular","voo doméstico",182,182,364,389,315,704,2040,3561,5601,23597
"7372",2015-07-01,"sbtf","transporte não regular","voo internacional",0,0,0,0,0,0,0,0,0,0
"7373",2015-07-01,"sbtt","transporte regular","voo doméstico",32,32,64,2481,3142,5623,0,0,0,0
"7374",2015-07-01,"sbtt","transporte regular","voo internacional",0,0,0,0,0,0,0,0,0,0
"7375",2015-07-01,"sbtt","transporte não regular","voo doméstico",105,103,208,515,496,1011,1476,3991,5467,576
"7376",2015-07-01,"sbtt","transporte não regular","voo internacional",4,5,9,6,7,13,0,0,0,0
"7377",2015-07-01,"sbuf","transporte regular","voo doméstico",12,12,24,689,647,1336,0,0,0,0
"7378",2015-07-01,"sbuf","transporte regular","voo internacional",0,0,0,0,0,0,0,0,0,0
"7379",2015-07-01,"sbuf","transporte não regular","voo doméstico",44,45,89,88,100,188,0,0,0,0
"7380",2015-07-01,"sbuf","transporte não regular","voo internacional",0,0,0,0,0,0,0,0,0,0
"7381",2015-07-01,"sbug","transporte regular","voo doméstico",0,0,0,0,0,0,0,0,0,0
"7382",2015-07-01,"sbug","transporte regular","voo internacional",0,0,0,0,0,0,0,0,0,0
"7383",2015-07-01,"sbug","transporte não regular","voo doméstico",22,23,45,51,53,104,0,0,0,0
"7384",2015-07-01,"sbug","transporte não regular","voo internacional",0,0,0,0,0,0,0,0,0,0
"7385",2015-07-01,"sbul","transporte regular","voo doméstico",623,622,1245,50774,48127,98901,0,0,0,0
"7386",2015-07-01,"sbul","transporte regular","voo internacional",0,0,0,0,0,0,0,0,0,0
"7387",2015-07-01,"sbul","transporte não regular","voo doméstico",677,685,1362,1328,1278,2606,0,0,0,0
"7388",2015-07-01,"sbul","transporte não regular","voo internacional",0,0,0,0,0,0,0,0,0,0
"7389",2015-07-01,"sbur","transporte regular","voo doméstico",107,106,213,5712,6002,11714,0,0,0,0
"7390",2015-07-01,"sbur","transporte regular","voo internacional",0,0,0,0,0,0,0,0,0,0
"7391",2015-07-01,"sbur","transporte não regular","voo doméstico",189,186,375,632,683,1315,0,0,0,0
"7392",2015-07-01,"sbur","transporte não regular","voo internacional",0,0,0,0,0,0,0,0,0,0
"7393",2015-06-01,"sbbe","transporte regular","voo doméstico",1586,1581,3167,142756,146448,289204,97863,285166,383029,0
"7394",2015-06-01,"sbbe","transporte regular","voo internacional",38,38,76,4018,3917,7935,0,104,104,0
"7395",2015-06-01,"sbbe","transporte não regular","voo doméstico",489,492,981,3287,2824,6111,0,0,0,0
"7396",2015-06-01,"sbbe","transporte não regular","voo internacional",10,9,19,12,4,16,0,0,0,0
"7397",2015-06-01,"sbbg","transporte regular","voo doméstico",0,0,0,0,0,0,0,0,0,0
"7398",2015-06-01,"sbbg","transporte regular","voo internacional",0,0,0,0,0,0,0,0,0,0
"7399",2015-06-01,"sbbg","transporte não regular","voo doméstico",22,21,43,78,104,182,0,0,0,0
"7400",2015-06-01,"sbbg","transporte não regular","voo internacional",2,3,5,9,4,13,0,0,0,0
"7401",2015-06-01,"sbbh","transporte regular","voo doméstico",317,317,634,17533,14357,31890,0,0,0,0
"7402",2015-06-01,"sbbh","transporte regular","voo internacional",0,0,0,0,0,0,0,0,0,0
"7403",2015-06-01,"sbbh","transporte não regular","voo doméstico",1832,1847,3679,8498,8412,16910,0,0,0,0
"7404",2015-06-01,"sbbh","transporte não regular","voo internacional",4,5,9,17,12,29,0,0,0,0
"7405",2015-06-01,"sbbi","transporte regular","voo doméstico",0,0,0,0,0,0,0,0,0,0
"7406",2015-06-01,"sbbi","transporte regular","voo internacional",0,0,0,0,0,0,0,0,0,0
"7407",2015-06-01,"sbbi","transporte não regular","voo doméstico",1138,1144,2282,6044,5977,12021,0,0,0,0
"7408",2015-06-01,"sbbi","transporte não regular","voo internacional",1,1,2,0,0,0,0,0,0,0
"7409",2015-06-01,"sbbv","transporte regular","voo doméstico",108,108,216,13637,13294,26931,0,0,0,0
"7410",2015-06-01,"sbbv","transporte regular","voo internacional",0,0,0,0,0,0,0,0,0,0
"7411",2015-06-01,"sbbv","transporte não regular","voo doméstico",248,254,502,190,174,364,0,0,0,0
"7412",2015-06-01,"sbbv","transporte não regular","voo internacional",18,14,32,2,0,2,0,0,0,0
"7413",2015-06-01,"sbcg","transporte regular","voo doméstico",601,607,1208,60069,58406,118475,69439,132142,201581,0
"7414",2015-06-01,"sbcg","transporte regular","voo internacional",0,0,0,0,0,0,0,0,0,0
"7415",2015-06-01,"sbcg","transporte não regular","voo doméstico",310,310,620,216,450,666,0,0,0,0
"7416",2015-06-01,"sbcg","transporte não regular","voo internacional",18,16,34,129,162,291,3778,0,3778,0
"7417",2015-06-01,"sbcj","transporte regular","voo doméstico",119,119,238,8974,8533,17507,0,0,0,0
"7418",2015-06-01,"sbcj","transporte regular","voo internacional",0,0,0,0,0,0,0,0,0,0
"7419",2015-06-01,"sbcj","transporte não regular","voo doméstico",70,68,138,358,347,705,0,0,0,0
"7420",2015-06-01,"sbcj","transporte não regular","voo internacional",0,0,0,0,0,0,0,0,0,0
"7421",2015-06-01,"sbcr","transporte regular","voo doméstico",24,24,48,1369,1269,2638,0,0,0,0
"7422",2015-06-01,"sbcr","transporte regular","voo internacional",0,0,0,0,0,0,0,0,0,0
"7423",2015-06-01,"sbcr","transporte não regular","voo doméstico",53,54,107,146,122,268,0,0,0,0
"7424",2015-06-01,"sbcr","transporte não regular","voo internacional",3,3,6,11,7,18,0,0,0,0
"7425",2015-06-01,"sbct","transporte regular","voo doméstico",2700,2704,5404,276351,274171,550522,151783,0,151783,162902
"7426",2015-06-01,"sbct","transporte regular","voo internacional",101,101,202,4645,5221,9866,0,0,0,0
"7427",2015-06-01,"sbct","transporte não regular","voo doméstico",206,207,413,2680,2808,5488,0,0,0,0
"7428",2015-06-01,"sbct","transporte não regular","voo internacional",12,9,21,32,41,73,0,0,0,0
"7429",2015-06-01,"sbcz","transporte regular","voo doméstico",26,26,52,2947,2910,5857,0,0,0,0
"7430",2015-06-01,"sbcz","transporte regular","voo internacional",0,0,0,0,0,0,0,0,0,0
"7431",2015-06-01,"sbcz","transporte não regular","voo doméstico",146,145,291,549,499,1048,0,0,0,0
"7432",2015-06-01,"sbcz","transporte não regular","voo internacional",2,2,4,0,0,0,0,0,0,0
"7433",2015-06-01,"sbeg","transporte regular","voo doméstico",1215,1207,2422,120437,111031,231468,0,1463,1463,0
"7434",2015-06-01,"sbeg","transporte regular","voo internacional",131,136,267,7408,7050,14458,0,0,0,0
"7435",2015-06-01,"sbeg","transporte não regular","voo doméstico",619,624,1243,9738,9897,19635,0,0,0,0
"7436",2015-06-01,"sbeg","transporte não regular","voo internacional",117,112,229,414,330,744,0,0,0,0
"7437",2015-06-01,"sbfi","transporte regular","voo doméstico",597,595,1192,72132,72841,144973,0,0,0,0
"7438",2015-06-01,"sbfi","transporte regular","voo internacional",24,24,48,3037,2885,5922,0,0,0,0
"7439",2015-06-01,"sbfi","transporte não regular","voo doméstico",151,146,297,1821,1818,3639,0,0,0,0
"7440",2015-06-01,"sbfi","transporte não regular","voo internacional",38,44,82,91,91,182,0,0,0,0
"7441",2015-06-01,"sbgo","transporte regular","voo doméstico",1356,1358,2714,133650,131572,265222,162083,155529,317612,178878
"7442",2015-06-01,"sbgo","transporte regular","voo internacional",0,0,0,0,0,0,0,0,0,0
"7443",2015-06-01,"sbgo","transporte não regular","voo doméstico",1420,1414,2834,4502,5881,10383,0,0,0,0
"7444",2015-06-01,"sbgo","transporte não regular","voo internacional",1,1,2,0,0,0,0,0,0,0
"7445",2015-06-01,"sbht","transporte regular","voo doméstico",252,252,504,12982,13543,26525,0,0,0,0
"7446",2015-06-01,"sbht","transporte regular","voo internacional",0,0,0,0,0,0,0,0,0,0
"7447",2015-06-01,"sbht","transporte não regular","voo doméstico",237,237,474,584,549,1133,620,1350,1970,0
"7448",2015-06-01,"sbht","transporte não regular","voo internacional",0,0,0,0,0,0,0,0,0,0
"7449",2015-06-01,"sbiz","transporte regular","voo doméstico",223,222,445,13116,13575,26691,0,0,0,0
"7450",2015-06-01,"sbiz","transporte regular","voo internacional",0,0,0,0,0,0,0,0,0,0
"7451",2015-06-01,"sbiz","transporte não regular","voo doméstico",157,154,311,472,390,862,0,0,0,0
"7452",2015-06-01,"sbiz","transporte não regular","voo internacional",2,2,4,0,0,0,0,0,0,0
"7453",2015-06-01,"sbjc","transporte regular","voo doméstico",0,0,0,0,0,0,0,0,0,0
"7454",2015-06-01,"sbjc","transporte regular","voo internacional",0,0,0,0,0,0,0,0,0,0
"7455",2015-06-01,"sbjc","transporte não regular","voo doméstico",422,422,844,849,710,1559,20,0,20,0
"7456",2015-06-01,"sbjc","transporte não regular","voo internacional",3,2,5,0,0,0,0,0,0,0
"7457",2015-06-01,"sbjr","transporte regular","voo doméstico",0,0,0,0,0,0,0,0,0,0
"7458",2015-06-01,"sbjr","transporte regular","voo internacional",0,0,0,0,0,0,0,0,0,0
"7459",2015-06-01,"sbjr","transporte não regular","voo doméstico",2278,2278,4556,8583,7037,15620,0,0,0,0
"7460",2015-06-01,"sbjr","transporte não regular","voo internacional",0,0,0,0,0,0,0,0,0,0
"7461",2015-06-01,"sbjv","transporte regular","voo doméstico",251,251,502,19354,19046,38400,0,0,0,0
"7462",2015-06-01,"sbjv","transporte regular","voo internacional",0,0,0,0,0,0,0,0,0,0
"7463",2015-06-01,"sbjv","transporte não regular","voo doméstico",180,180,360,109,503,612,0,0,0,0
"7464",2015-06-01,"sbjv","transporte não regular","voo internacional",0,0,0,0,0,0,0,0,0,0
"7465",2015-06-01,"sblo","transporte regular","voo doméstico",441,439,880,42642,42625,85267,0,0,0,0
"7466",2015-06-01,"sblo","transporte regular","voo internacional",0,0,0,0,0,0,0,0,0,0
"7467",2015-06-01,"sblo","transporte não regular","voo doméstico",659,649,1308,401,535,936,0,0,0,0
"7468",2015-06-01,"sblo","transporte não regular","voo internacional",1,1,2,0,0,0,0,0,0,0
"7469",2015-06-01,"sbma","transporte regular","voo doméstico",282,282,564,15678,15696,31374,0,60,60,0
"7470",2015-06-01,"sbma","transporte regular","voo internacional",0,0,0,0,0,0,0,0,0,0
"7471",2015-06-01,"sbma","transporte não regular","voo doméstico",270,273,543,941,844,1785,0,0,0,0
"7472",2015-06-01,"sbma","transporte não regular","voo internacional",2,2,4,0,0,0,0,0,0,0
"7473",2015-06-01,"sbmk","transporte regular","voo doméstico",163,164,327,14983,15074,30057,0,0,0,0
"7474",2015-06-01,"sbmk","transporte regular","voo internacional",0,0,0,0,0,0,0,0,0,0
"7475",2015-06-01,"sbmk","transporte não regular","voo doméstico",245,245,490,361,480,841,0,0,0,0
"7476",2015-06-01,"sbmk","transporte não regular","voo internacional",0,0,0,0,0,0,0,0,0,0
"7477",2015-06-01,"sbmq","transporte regular","voo doméstico",271,273,544,28114,25406,53520,19460,27691,47151,0
"7478",2015-06-01,"sbmq","transporte regular","voo internacional",0,0,0,0,0,0,0,0,0,0
"7479",2015-06-01,"sbmq","transporte não regular","voo doméstico",151,152,303,244,116,360,0,0,0,0
"7480",2015-06-01,"sbmq","transporte não regular","voo internacional",7,5,12,0,0,0,0,0,0,0
"7481",2015-06-01,"sbmt","transporte regular","voo doméstico",0,0,0,0,0,0,0,0,0,0
"7482",2015-06-01,"sbmt","transporte regular","voo internacional",0,0,0,0,0,0,0,0,0,0
"7483",2015-06-01,"sbmt","transporte não regular","voo doméstico",3870,3887,7757,6110,6009,12119,0,0,0,0
"7484",2015-06-01,"sbmt","transporte não regular","voo internacional",0,0,0,0,0,0,0,0,0,0
"7485",2015-06-01,"sbnf","transporte regular","voo doméstico",602,602,1204,54888,54530,109418,0,0,0,0
"7486",2015-06-01,"sbnf","transporte regular","voo internacional",0,0,0,0,0,0,0,0,0,0
"7487",2015-06-01,"sbnf","transporte não regular","voo doméstico",225,222,447,441,507,948,0,0,0,0
"7488",2015-06-01,"sbnf","transporte não regular","voo internacional",6,7,13,13,15,28,0,0,0,0
"7489",2015-06-01,"sbpb","transporte regular","voo doméstico",20,20,40,621,599,1220,0,0,0,0
"7490",2015-06-01,"sbpb","transporte regular","voo internacional",0,0,0,0,0,0,0,0,0,0
"7491",2015-06-01,"sbpb","transporte não regular","voo doméstico",67,67,134,172,144,316,0,0,0,0
"7492",2015-06-01,"sbpb","transporte não regular","voo internacional",0,0,0,0,0,0,0,0,0,0
"7493",2015-06-01,"sbpj","transporte regular","voo doméstico",301,299,600,25443,25128,50571,0,0,0,0
"7494",2015-06-01,"sbpj","transporte regular","voo internacional",0,0,0,0,0,0,0,0,0,0
"7495",2015-06-01,"sbpj","transporte não regular","voo doméstico",296,295,591,752,440,1192,0,0,0,0
"7496",2015-06-01,"sbpj","transporte não regular","voo internacional",5,4,9,0,0,0,0,0,0,0
"7497",2015-06-01,"sbpk","transporte regular","voo doméstico",26,26,52,1481,1314,2795,0,0,0,0
"7498",2015-06-01,"sbpk","transporte regular","voo internacional",0,0,0,0,0,0,0,0,0,0
"7499",2015-06-01,"sbpk","transporte não regular","voo doméstico",50,47,97,71,82,153,0,0,0,0
"7500",2015-06-01,"sbpk","transporte não regular","voo internacional",0,4,4,0,0,0,0,0,0,0
"7501",2015-06-01,"sbpl","transporte regular","voo doméstico",140,141,281,17446,17877,35323,0,0,0,0
"7502",2015-06-01,"sbpl","transporte regular","voo internacional",4,4,8,0,0,0,0,0,0,0
"7503",2015-06-01,"sbpl","transporte não regular","voo doméstico",105,106,211,198,164,362,0,0,0,0
"7504",2015-06-01,"sbpl","transporte não regular","voo internacional",0,0,0,0,0,0,0,0,0,0
"7505",2015-06-01,"sbpp","transporte regular","voo doméstico",0,0,0,0,0,0,0,0,0,0
"7506",2015-06-01,"sbpp","transporte regular","voo internacional",0,0,0,0,0,0,0,0,0,0
"7507",2015-06-01,"sbpp","transporte não regular","voo doméstico",95,96,191,170,158,328,0,0,0,0
"7508",2015-06-01,"sbpp","transporte não regular","voo internacional",12,10,22,10,13,23,0,0,0,0
"7509",2015-06-01,"sbpr","transporte regular","voo doméstico",3,3,6,5,3,8,0,0,0,0
"7510",2015-06-01,"sbpr","transporte regular","voo internacional",0,0,0,0,0,0,0,0,0,0
"7511",2015-06-01,"sbpr","transporte não regular","voo doméstico",968,965,1933,1059,1022,2081,0,0,0,0
"7512",2015-06-01,"sbpr","transporte não regular","voo internacional",0,0,0,0,0,0,0,0,0,0
"7513",2015-06-01,"sbpv","transporte regular","voo doméstico",407,410,817,36183,35301,71484,0,0,0,0
"7514",2015-06-01,"sbpv","transporte regular","voo internacional",0,0,0,0,0,0,0,0,0,0
"7515",2015-06-01,"sbpv","transporte não regular","voo doméstico",283,280,563,0,0,0,0,0,0,0
"7516",2015-06-01,"sbpv","transporte não regular","voo internacional",6,6,12,0,0,0,0,0,0,0
"7517",2015-06-01,"sbrb","transporte regular","voo doméstico",133,133,266,14662,15116,29778,0,1315,1315,265
"7518",2015-06-01,"sbrb","transporte regular","voo internacional",0,0,0,0,0,0,0,0,0,0
"7519",2015-06-01,"sbrb","transporte não regular","voo doméstico",128,131,259,239,245,484,0,0,0,0
"7520",2015-06-01,"sbrb","transporte não regular","voo internacional",2,2,4,0,0,0,0,0,0,0
"7521",2015-06-01,"sbrj","transporte regular","voo doméstico",4070,4084,8154,363644,353915,717559,0,0,0,0
"7522",2015-06-01,"sbrj","transporte regular","voo internacional",0,0,0,0,0,0,0,0,0,0
"7523",2015-06-01,"sbrj","transporte não regular","voo doméstico",742,718,1460,569,622,1191,0,0,0,0
"7524",2015-06-01,"sbrj","transporte não regular","voo internacional",0,0,0,0,0,0,0,0,0,0
"7525",2015-06-01,"sbsj","transporte regular","voo doméstico",0,1,1,3,0,3,0,0,0,0
"7526",2015-06-01,"sbsj","transporte regular","voo internacional",0,0,0,0,0,0,0,0,0,0
"7527",2015-06-01,"sbsj","transporte não regular","voo doméstico",535,519,1054,1443,1300,2743,0,0,0,0
"7528",2015-06-01,"sbsj","transporte não regular","voo internacional",4,22,26,26,11,37,0,0,0,0
"7529",2015-06-01,"sbsl","transporte regular","voo doméstico",723,721,1444,66829,72028,138857,0,0,0,0
"7530",2015-06-01,"sbsl","transporte regular","voo internacional",0,0,0,0,0,0,0,0,0,0
"7531",2015-06-01,"sbsl","transporte não regular","voo doméstico",247,246,493,615,549,1164,58249,195888,254137,0
"7532",2015-06-01,"sbsl","transporte não regular","voo internacional",5,5,10,4,10,14,0,0,0,0
"7533",2015-06-01,"sbsn","transporte regular","voo doméstico",395,394,789,26024,23672,49696,0,0,0,0
"7534",2015-06-01,"sbsn","transporte regular","voo internacional",0,0,0,0,0,0,0,0,0,0
"7535",2015-06-01,"sbsn","transporte não regular","voo doméstico",342,344,686,724,607,1331,0,0,0,0
"7536",2015-06-01,"sbsn","transporte não regular","voo internacional",4,5,9,0,0,0,0,0,0,0
"7537",2015-06-01,"sbsp","transporte regular","voo doméstico",6940,6990,13930,748908,728412,1477320,0,0,0,0
"7538",2015-06-01,"sbsp","transporte regular","voo internacional",0,0,0,0,0,0,0,0,0,0
"7539",2015-06-01,"sbsp","transporte não regular","voo doméstico",1776,1721,3497,8563,6571,15134,0,0,0,0
"7540",2015-06-01,"sbsp","transporte não regular","voo internacional",0,0,0,0,0,0,0,0,0,0
"7541",2015-06-01,"sbte","transporte regular","voo doméstico",527,527,1054,46650,49980,96630,21026,77401,98427,244322
"7542",2015-06-01,"sbte","transporte regular","voo internacional",0,0,0,0,0,0,0,0,0,0
"7543",2015-06-01,"sbte","transporte não regular","voo doméstico",203,205,408,1254,1203,2457,0,0,0,0
"7544",2015-06-01,"sbte","transporte não regular","voo internacional",0,0,0,0,0,0,0,0,0,0
"7545",2015-06-01,"sbtf","transporte regular","voo doméstico",32,32,64,1925,1869,3794,0,0,0,0
"7546",2015-06-01,"sbtf","transporte regular","voo internacional",0,0,0,0,0,0,0,0,0,0
"7547",2015-06-01,"sbtf","transporte não regular","voo doméstico",182,183,365,298,261,559,1214,2752,3966,18446
"7548",2015-06-01,"sbtf","transporte não regular","voo internacional",0,0,0,0,0,0,0,0,0,0
"7549",2015-06-01,"sbtt","transporte regular","voo doméstico",30,30,60,2359,2667,5026,0,0,0,0
"7550",2015-06-01,"sbtt","transporte regular","voo internacional",0,0,0,0,0,0,0,0,0,0
"7551",2015-06-01,"sbtt","transporte não regular","voo doméstico",92,94,186,401,417,818,1825,3530,5355,612
"7552",2015-06-01,"sbtt","transporte não regular","voo internacional",4,2,6,5,12,17,0,0,0,0
"7553",2015-06-01,"sbuf","transporte regular","voo doméstico",15,15,30,709,773,1482,0,0,0,0
"7554",2015-06-01,"sbuf","transporte regular","voo internacional",0,0,0,0,0,0,0,0,0,0
"7555",2015-06-01,"sbuf","transporte não regular","voo doméstico",56,56,112,144,147,291,0,0,0,0
"7556",2015-06-01,"sbuf","transporte não regular","voo internacional",0,0,0,0,0,0,0,0,0,0
"7557",2015-06-01,"sbug","transporte regular","voo doméstico",0,0,0,0,0,0,0,0,0,0
"7558",2015-06-01,"sbug","transporte regular","voo internacional",0,0,0,0,0,0,0,0,0,0
"7559",2015-06-01,"sbug","transporte não regular","voo doméstico",17,16,33,41,44,85,0,0,0,0
"7560",2015-06-01,"sbug","transporte não regular","voo internacional",0,0,0,0,0,0,0,0,0,0
"7561",2015-06-01,"sbul","transporte regular","voo doméstico",567,567,1134,42089,42519,84608,0,0,0,0
"7562",2015-06-01,"sbul","transporte regular","voo internacional",0,0,0,0,0,0,0,0,0,0
"7563",2015-06-01,"sbul","transporte não regular","voo doméstico",608,603,1211,1376,1344,2720,0,0,0,0
"7564",2015-06-01,"sbul","transporte não regular","voo internacional",1,1,2,7,7,14,0,0,0,0
"7565",2015-06-01,"sbur","transporte regular","voo doméstico",121,122,243,5414,5697,11111,0,0,0,0
"7566",2015-06-01,"sbur","transporte regular","voo internacional",0,0,0,0,0,0,0,0,0,0
"7567",2015-06-01,"sbur","transporte não regular","voo doméstico",160,168,328,548,562,1110,0,0,0,0
"7568",2015-06-01,"sbur","transporte não regular","voo internacional",0,0,0,0,0,0,0,0,0,0
"7569",2015-05-01,"sbbe","transporte regular","voo doméstico",1624,1631,3255,147353,146171,293524,89649,288489,378138,0
"7570",2015-05-01,"sbbe","transporte regular","voo internacional",37,37,74,3762,3669,7431,0,26,26,0
"7571",2015-05-01,"sbbe","transporte não regular","voo doméstico",567,559,1126,4229,4845,9074,0,0,0,0
"7572",2015-05-01,"sbbe","transporte não regular","voo internacional",8,7,15,20,16,36,0,0,0,0
"7573",2015-05-01,"sbbg","transporte regular","voo doméstico",0,0,0,0,0,0,0,0,0,0
"7574",2015-05-01,"sbbg","transporte regular","voo internacional",0,0,0,0,0,0,0,0,0,0
"7575",2015-05-01,"sbbg","transporte não regular","voo doméstico",11,13,24,54,44,98,0,0,0,0
"7576",2015-05-01,"sbbg","transporte não regular","voo internacional",1,0,1,0,4,4,0,0,0,0
"7577",2015-05-01,"sbbh","transporte regular","voo doméstico",398,399,797,39237,19813,59050,0,0,0,0
"7578",2015-05-01,"sbbh","transporte regular","voo internacional",0,0,0,0,0,0,0,0,0,0
"7579",2015-05-01,"sbbh","transporte não regular","voo doméstico",1844,1834,3678,8816,7847,16663,0,0,0,0
"7580",2015-05-01,"sbbh","transporte não regular","voo internacional",11,10,21,43,48,91,0,0,0,0
"7581",2015-05-01,"sbbi","transporte regular","voo doméstico",0,0,0,0,0,0,0,0,0,0
"7582",2015-05-01,"sbbi","transporte regular","voo internacional",0,0,0,0,0,0,0,0,0,0
"7583",2015-05-01,"sbbi","transporte não regular","voo doméstico",997,990,1987,812,652,1464,0,0,0,0
"7584",2015-05-01,"sbbi","transporte não regular","voo internacional",2,2,4,0,0,0,0,0,0,0
"7585",2015-05-01,"sbbv","transporte regular","voo doméstico",109,109,218,14179,13762,27941,11,0,11,0
"7586",2015-05-01,"sbbv","transporte regular","voo internacional",0,0,0,0,0,0,0,0,0,0
"7587",2015-05-01,"sbbv","transporte não regular","voo doméstico",224,225,449,192,162,354,0,0,0,0
"7588",2015-05-01,"sbbv","transporte não regular","voo internacional",14,11,25,0,0,0,0,0,0,0
"7589",2015-05-01,"sbcg","transporte regular","voo doméstico",626,625,1251,63663,62197,125860,55982,136764,192746,0
"7590",2015-05-01,"sbcg","transporte regular","voo internacional",0,0,0,0,0,0,0,0,0,0
"7591",2015-05-01,"sbcg","transporte não regular","voo doméstico",337,339,676,253,654,907,0,0,0,0
"7592",2015-05-01,"sbcg","transporte não regular","voo internacional",23,21,44,158,183,341,0,0,0,0
"7593",2015-05-01,"sbcj","transporte regular","voo doméstico",140,140,280,10140,9570,19710,0,0,0,0
"7594",2015-05-01,"sbcj","transporte regular","voo internacional",0,0,0,0,0,0,0,0,0,0
"7595",2015-05-01,"sbcj","transporte não regular","voo doméstico",85,85,170,377,194,571,0,0,0,0
"7596",2015-05-01,"sbcj","transporte não regular","voo internacional",0,0,0,0,0,0,0,0,0,0
"7597",2015-05-01,"sbcr","transporte regular","voo doméstico",26,26,52,1515,1395,2910,0,0,0,0
"7598",2015-05-01,"sbcr","transporte regular","voo internacional",0,0,0,0,0,0,0,0,0,0
"7599",2015-05-01,"sbcr","transporte não regular","voo doméstico",48,46,94,100,88,188,0,0,0,0
"7600",2015-05-01,"sbcr","transporte não regular","voo internacional",10,15,25,12,13,25,0,0,0,0
"7601",2015-05-01,"sbct","transporte regular","voo doméstico",2844,2849,5693,296797,297962,594759,151336,0,151336,154446
"7602",2015-05-01,"sbct","transporte regular","voo internacional",110,110,220,4936,5487,10423,0,0,0,0
"7603",2015-05-01,"sbct","transporte não regular","voo doméstico",188,175,363,1815,1573,3388,0,0,0,0
"7604",2015-05-01,"sbct","transporte não regular","voo internacional",6,7,13,27,11,38,0,0,0,0
"7605",2015-05-01,"sbcz","transporte regular","voo doméstico",30,30,60,3012,2892,5904,0,0,0,0
"7606",2015-05-01,"sbcz","transporte regular","voo internacional",0,0,0,0,0,0,0,0,0,0
"7607",2015-05-01,"sbcz","transporte não regular","voo doméstico",152,154,306,550,566,1116,0,0,0,0
"7608",2015-05-01,"sbcz","transporte não regular","voo internacional",1,1,2,0,0,0,0,0,0,0
"7609",2015-05-01,"sbeg","transporte regular","voo doméstico",1235,1223,2458,111028,108551,219579,0,0,0,0
"7610",2015-05-01,"sbeg","transporte regular","voo internacional",130,136,266,7303,7309,14612,0,0,0,0
"7611",2015-05-01,"sbeg","transporte não regular","voo doméstico",516,509,1025,4657,4312,8969,0,0,0,0
"7612",2015-05-01,"sbeg","transporte não regular","voo internacional",66,77,143,395,380,775,0,0,0,0
"7613",2015-05-01,"sbfi","transporte regular","voo doméstico",639,638,1277,77414,74962,152376,0,0,0,0
"7614",2015-05-01,"sbfi","transporte regular","voo internacional",24,24,48,3011,3113,6124,0,0,0,0
"7615",2015-05-01,"sbfi","transporte não regular","voo doméstico",133,141,274,1128,1437,2565,0,0,0,0
"7616",2015-05-01,"sbfi","transporte não regular","voo internacional",59,56,115,85,146,231,0,0,0,0
"7617",2015-05-01,"sbgo","transporte regular","voo doméstico",1390,1394,2784,134542,131837,266379,116607,145497,262104,170191
"7618",2015-05-01,"sbgo","transporte regular","voo internacional",0,0,0,0,0,0,0,0,0,0
"7619",2015-05-01,"sbgo","transporte não regular","voo doméstico",1324,1317,2641,4071,5170,9241,0,0,0,0
"7620",2015-05-01,"sbgo","transporte não regular","voo internacional",6,6,12,0,0,0,0,0,0,0
"7621",2015-05-01,"sbht","transporte regular","voo doméstico",318,320,638,14724,15179,29903,0,8,8,0
"7622",2015-05-01,"sbht","transporte regular","voo internacional",0,0,0,0,0,0,0,0,0,0
"7623",2015-05-01,"sbht","transporte não regular","voo doméstico",217,213,430,601,693,1294,4090,4417,8507,1480
"7624",2015-05-01,"sbht","transporte não regular","voo internacional",0,0,0,0,0,0,0,0,0,0
"7625",2015-05-01,"sbiz","transporte regular","voo doméstico",230,231,461,13416,13442,26858,0,0,0,89
"7626",2015-05-01,"sbiz","transporte regular","voo internacional",0,0,0,0,0,0,0,0,0,0
"7627",2015-05-01,"sbiz","transporte não regular","voo doméstico",154,153,307,533,444,977,0,0,0,0
"7628",2015-05-01,"sbiz","transporte não regular","voo internacional",0,1,1,0,0,0,0,0,0,0
"7629",2015-05-01,"sbjc","transporte regular","voo doméstico",0,0,0,0,0,0,0,0,0,0
"7630",2015-05-01,"sbjc","transporte regular","voo internacional",0,0,0,0,0,0,0,0,0,0
"7631",2015-05-01,"sbjc","transporte não regular","voo doméstico",411,411,822,679,551,1230,0,0,0,0
"7632",2015-05-01,"sbjc","transporte não regular","voo internacional",0,0,0,0,0,0,0,0,0,0
"7633",2015-05-01,"sbjr","transporte regular","voo doméstico",0,0,0,0,0,0,0,0,0,0
"7634",2015-05-01,"sbjr","transporte regular","voo internacional",0,0,0,0,0,0,0,0,0,0
"7635",2015-05-01,"sbjr","transporte não regular","voo doméstico",2474,2469,4943,8955,6641,15596,0,0,0,0
"7636",2015-05-01,"sbjr","transporte não regular","voo internacional",0,0,0,0,0,0,0,0,0,0
"7637",2015-05-01,"sbjv","transporte regular","voo doméstico",254,255,509,21575,20735,42310,0,0,0,0
"7638",2015-05-01,"sbjv","transporte regular","voo internacional",0,0,0,0,0,0,0,0,0,0
"7639",2015-05-01,"sbjv","transporte não regular","voo doméstico",185,183,368,103,246,349,0,0,0,0
"7640",2015-05-01,"sbjv","transporte não regular","voo internacional",0,0,0,0,0,0,0,0,0,0
"7641",2015-05-01,"sblo","transporte regular","voo doméstico",460,463,923,45420,43776,89196,0,0,0,0
"7642",2015-05-01,"sblo","transporte regular","voo internacional",0,0,0,0,0,0,0,0,0,0
"7643",2015-05-01,"sblo","transporte não regular","voo doméstico",704,709,1413,468,1729,2197,0,0,0,0
"7644",2015-05-01,"sblo","transporte não regular","voo internacional",2,2,4,0,0,0,0,0,0,0
"7645",2015-05-01,"sbma","transporte regular","voo doméstico",309,309,618,15229,15050,30279,0,40,40,0
"7646",2015-05-01,"sbma","transporte regular","voo internacional",0,0,0,0,0,0,0,0,0,0
"7647",2015-05-01,"sbma","transporte não regular","voo doméstico",297,295,592,1081,1056,2137,0,0,0,0
"7648",2015-05-01,"sbma","transporte não regular","voo internacional",2,2,4,0,0,0,0,0,0,0
"7649",2015-05-01,"sbmk","transporte regular","voo doméstico",158,157,315,16113,15592,31705,0,0,0,0
"7650",2015-05-01,"sbmk","transporte regular","voo internacional",0,0,0,0,0,0,0,0,0,0
"7651",2015-05-01,"sbmk","transporte não regular","voo doméstico",227,230,457,15,10,25,0,0,0,0
"7652",2015-05-01,"sbmk","transporte não regular","voo internacional",0,0,0,0,0,0,0,0,0,0
"7653",2015-05-01,"sbmq","transporte regular","voo doméstico",274,266,540,27529,27284,54813,12910,36204,49114,0
"7654",2015-05-01,"sbmq","transporte regular","voo internacional",0,0,0,0,0,0,0,0,0,0
"7655",2015-05-01,"sbmq","transporte não regular","voo doméstico",191,198,389,435,356,791,0,0,0,0
"7656",2015-05-01,"sbmq","transporte não regular","voo internacional",6,4,10,0,0,0,0,0,0,0
"7657",2015-05-01,"sbmt","transporte regular","voo doméstico",0,0,0,0,0,0,0,0,0,0
"7658",2015-05-01,"sbmt","transporte regular","voo internacional",0,0,0,0,0,0,0,0,0,0
"7659",2015-05-01,"sbmt","transporte não regular","voo doméstico",4035,4043,8078,6237,6040,12277,0,0,0,0
"7660",2015-05-01,"sbmt","transporte não regular","voo internacional",0,0,0,0,0,0,0,0,0,0
"7661",2015-05-01,"sbnf","transporte regular","voo doméstico",615,614,1229,56164,54289,110453,0,0,0,0
"7662",2015-05-01,"sbnf","transporte regular","voo internacional",0,0,0,0,0,0,0,0,0,0
"7663",2015-05-01,"sbnf","transporte não regular","voo doméstico",279,282,561,651,1024,1675,0,0,0,0
"7664",2015-05-01,"sbnf","transporte não regular","voo internacional",4,3,7,0,2,2,0,0,0,0
"7665",2015-05-01,"sbpb","transporte regular","voo doméstico",24,24,48,585,445,1030,0,0,0,0
"7666",2015-05-01,"sbpb","transporte regular","voo internacional",0,0,0,0,0,0,0,0,0,0
"7667",2015-05-01,"sbpb","transporte não regular","voo doméstico",47,52,99,113,101,214,0,0,0,0
"7668",2015-05-01,"sbpb","transporte não regular","voo internacional",0,0,0,0,0,0,0,0,0,0
"7669",2015-05-01,"sbpj","transporte regular","voo doméstico",336,335,671,26707,26531,53238,0,0,0,0
"7670",2015-05-01,"sbpj","transporte regular","voo internacional",0,0,0,0,0,0,0,0,0,0
"7671",2015-05-01,"sbpj","transporte não regular","voo doméstico",312,315,627,636,432,1068,0,0,0,0
"7672",2015-05-01,"sbpj","transporte não regular","voo internacional",3,3,6,0,0,0,0,0,0,0
"7673",2015-05-01,"sbpk","transporte regular","voo doméstico",32,32,64,1794,1665,3459,0,0,0,0
"7674",2015-05-01,"sbpk","transporte regular","voo internacional",0,0,0,0,0,0,0,0,0,0
"7675",2015-05-01,"sbpk","transporte não regular","voo doméstico",66,69,135,132,146,278,0,0,0,0
"7676",2015-05-01,"sbpk","transporte não regular","voo internacional",3,0,3,0,16,16,0,0,0,0
"7677",2015-05-01,"sbpl","transporte regular","voo doméstico",144,143,287,19082,18856,37938,0,0,0,0
"7678",2015-05-01,"sbpl","transporte regular","voo internacional",4,4,8,0,0,0,0,0,0,0
"7679",2015-05-01,"sbpl","transporte não regular","voo doméstico",79,78,157,83,59,142,0,0,0,0
"7680",2015-05-01,"sbpl","transporte não regular","voo internacional",0,0,0,0,0,0,0,0,0,0
"7681",2015-05-01,"sbpp","transporte regular","voo doméstico",0,0,0,0,0,0,0,0,0,0
"7682",2015-05-01,"sbpp","transporte regular","voo internacional",0,0,0,0,0,0,0,0,0,0
"7683",2015-05-01,"sbpp","transporte não regular","voo doméstico",59,59,118,101,105,206,0,0,0,0
"7684",2015-05-01,"sbpp","transporte não regular","voo internacional",9,10,19,16,17,33,0,0,0,0
"7685",2015-05-01,"sbpr","transporte regular","voo doméstico",1,1,2,1,0,1,0,0,0,0
"7686",2015-05-01,"sbpr","transporte regular","voo internacional",0,0,0,0,0,0,0,0,0,0
"7687",2015-05-01,"sbpr","transporte não regular","voo doméstico",1030,1030,2060,1197,1077,2274,0,0,0,0
"7688",2015-05-01,"sbpr","transporte não regular","voo internacional",0,0,0,0,0,0,0,0,0,0
"7689",2015-05-01,"sbpv","transporte regular","voo doméstico",440,438,878,37123,36356,73479,0,0,0,0
"7690",2015-05-01,"sbpv","transporte regular","voo internacional",0,0,0,0,0,0,0,0,0,0
"7691",2015-05-01,"sbpv","transporte não regular","voo doméstico",256,251,507,20,56,76,0,0,0,0
"7692",2015-05-01,"sbpv","transporte não regular","voo internacional",2,2,4,0,0,0,0,0,0,0
"7693",2015-05-01,"sbrb","transporte regular","voo doméstico",155,154,309,15812,16142,31954,0,0,0,0
"7694",2015-05-01,"sbrb","transporte regular","voo internacional",0,0,0,0,0,0,0,0,0,0
"7695",2015-05-01,"sbrb","transporte não regular","voo doméstico",134,136,270,229,170,399,0,0,0,0
"7696",2015-05-01,"sbrb","transporte não regular","voo internacional",1,0,1,0,0,0,0,0,0,0
"7697",2015-05-01,"sbrj","transporte regular","voo doméstico",4324,4341,8665,395070,394631,789701,0,0,0,0
"7698",2015-05-01,"sbrj","transporte regular","voo internacional",0,0,0,0,0,0,0,0,0,0
"7699",2015-05-01,"sbrj","transporte não regular","voo doméstico",796,783,1579,4060,3719,7779,0,0,0,0
"7700",2015-05-01,"sbrj","transporte não regular","voo internacional",1,1,2,0,0,0,0,0,0,0
"7701",2015-05-01,"sbsj","transporte regular","voo doméstico",0,0,0,0,0,0,0,0,0,0
"7702",2015-05-01,"sbsj","transporte regular","voo internacional",0,0,0,0,0,0,0,0,0,0
"7703",2015-05-01,"sbsj","transporte não regular","voo doméstico",574,556,1130,1366,1442,2808,0,0,0,0
"7704",2015-05-01,"sbsj","transporte não regular","voo internacional",5,12,17,30,5,35,0,0,0,0
"7705",2015-05-01,"sbsl","transporte regular","voo doméstico",699,698,1397,65110,68401,133511,0,0,0,0
"7706",2015-05-01,"sbsl","transporte regular","voo internacional",0,0,0,0,0,0,0,0,0,0
"7707",2015-05-01,"sbsl","transporte não regular","voo doméstico",208,211,419,831,608,1439,63957,199417,263374,0
"7708",2015-05-01,"sbsl","transporte não regular","voo internacional",0,0,0,0,0,0,0,0,0,0
"7709",2015-05-01,"sbsn","transporte regular","voo doméstico",438,437,875,26414,23379,49793,0,0,0,0
"7710",2015-05-01,"sbsn","transporte regular","voo internacional",0,0,0,0,0,0,0,0,0,0
"7711",2015-05-01,"sbsn","transporte não regular","voo doméstico",347,346,693,830,632,1462,0,0,0,0
"7712",2015-05-01,"sbsn","transporte não regular","voo internacional",1,1,2,0,0,0,0,0,0,0
"7713",2015-05-01,"sbsp","transporte regular","voo doméstico",7132,7165,14297,783373,780442,1563815,0,0,0,0
"7714",2015-05-01,"sbsp","transporte regular","voo internacional",0,0,0,0,0,0,0,0,0,0
"7715",2015-05-01,"sbsp","transporte não regular","voo doméstico",1826,1783,3609,8119,7448,15567,0,0,0,0
"7716",2015-05-01,"sbsp","transporte não regular","voo internacional",0,0,0,0,0,0,0,0,0,0
"7717",2015-05-01,"sbte","transporte regular","voo doméstico",517,517,1034,47247,47074,94321,22303,84876,107179,253984
"7718",2015-05-01,"sbte","transporte regular","voo internacional",0,1,1,0,0,0,0,0,0,0
"7719",2015-05-01,"sbte","transporte não regular","voo doméstico",197,197,394,1172,1144,2316,0,0,0,0
"7720",2015-05-01,"sbte","transporte não regular","voo internacional",0,0,0,0,0,0,0,0,0,0
"7721",2015-05-01,"sbtf","transporte regular","voo doméstico",58,58,116,2370,2414,4784,0,0,0,0
"7722",2015-05-01,"sbtf","transporte regular","voo internacional",0,0,0,0,0,0,0,0,0,0
"7723",2015-05-01,"sbtf","transporte não regular","voo doméstico",211,210,421,271,211,482,1820,3109,4929,20137
"7724",2015-05-01,"sbtf","transporte não regular","voo internacional",0,0,0,0,0,0,0,0,0,0
"7725",2015-05-01,"sbtt","transporte regular","voo doméstico",32,32,64,2001,2371,4372,0,10,10,0
"7726",2015-05-01,"sbtt","transporte regular","voo internacional",0,0,0,0,0,0,0,0,0,0
"7727",2015-05-01,"sbtt","transporte não regular","voo doméstico",106,105,211,398,338,736,1311,4038,5349,732
"7728",2015-05-01,"sbtt","transporte não regular","voo internacional",4,4,8,6,5,11,0,0,0,0
"7729",2015-05-01,"sbuf","transporte regular","voo doméstico",22,22,44,1027,1014,2041,0,0,0,0
"7730",2015-05-01,"sbuf","transporte regular","voo internacional",0,0,0,0,0,0,0,0,0,0
"7731",2015-05-01,"sbuf","transporte não regular","voo doméstico",38,38,76,105,119,224,0,0,0,0
"7732",2015-05-01,"sbuf","transporte não regular","voo internacional",0,0,0,0,0,0,0,0,0,0
"7733",2015-05-01,"sbug","transporte regular","voo doméstico",0,0,0,0,0,0,0,0,0,0
"7734",2015-05-01,"sbug","transporte regular","voo internacional",0,0,0,0,0,0,0,0,0,0
"7735",2015-05-01,"sbug","transporte não regular","voo doméstico",14,14,28,28,34,62,0,0,0,0
"7736",2015-05-01,"sbug","transporte não regular","voo internacional",0,0,0,0,0,0,0,0,0,0
"7737",2015-05-01,"sbul","transporte regular","voo doméstico",579,577,1156,45928,45323,91251,0,0,0,0
"7738",2015-05-01,"sbul","transporte regular","voo internacional",0,0,0,0,0,0,0,0,0,0
"7739",2015-05-01,"sbul","transporte não regular","voo doméstico",553,549,1102,1261,1263,2524,0,0,0,0
"7740",2015-05-01,"sbul","transporte não regular","voo internacional",1,1,2,4,4,8,0,0,0,0
"7741",2015-05-01,"sbur","transporte regular","voo doméstico",120,119,239,5829,5902,11731,1,0,1,0
"7742",2015-05-01,"sbur","transporte regular","voo internacional",0,0,0,0,0,0,0,0,0,0
"7743",2015-05-01,"sbur","transporte não regular","voo doméstico",287,293,580,1091,1172,2263,0,0,0,0
"7744",2015-05-01,"sbur","transporte não regular","voo internacional",1,1,2,0,0,0,0,0,0,0
"7745",2015-03-01,"sbbe","transporte regular","voo doméstico",1705,1710,3415,137068,134987,272055,89948,313524,403472,0
"7746",2015-03-01,"sbbe","transporte regular","voo internacional",39,39,78,4641,3083,7724,0,2,2,0
"7747",2015-03-01,"sbbe","transporte não regular","voo doméstico",520,516,1036,3462,3458,6920,0,0,0,0
"7748",2015-03-01,"sbbe","transporte não regular","voo internacional",10,10,20,28,16,44,0,0,0,0
"7749",2015-03-01,"sbbg","transporte regular","voo doméstico",0,0,0,0,0,0,0,0,0,0
"7750",2015-03-01,"sbbg","transporte regular","voo internacional",0,0,0,0,0,0,0,0,0,0
"7751",2015-03-01,"sbbg","transporte não regular","voo doméstico",16,16,32,55,58,113,0,0,0,0
"7752",2015-03-01,"sbbg","transporte não regular","voo internacional",2,2,4,0,5,5,0,0,0,0
"7753",2015-03-01,"sbbh","transporte regular","voo doméstico",435,439,874,38351,19354,57705,0,0,0,0
"7754",2015-03-01,"sbbh","transporte regular","voo internacional",0,0,0,0,0,0,0,0,0,0
"7755",2015-03-01,"sbbh","transporte não regular","voo doméstico",1776,1767,3543,7177,6993,14170,0,0,0,0
"7756",2015-03-01,"sbbh","transporte não regular","voo internacional",4,5,9,21,16,37,0,0,0,0
"7757",2015-03-01,"sbbi","transporte regular","voo doméstico",0,0,0,0,0,0,0,0,0,0
"7758",2015-03-01,"sbbi","transporte regular","voo internacional",0,0,0,0,0,0,0,0,0,0
"7759",2015-03-01,"sbbi","transporte não regular","voo doméstico",1122,1108,2230,202,107,309,0,0,0,0
"7760",2015-03-01,"sbbi","transporte não regular","voo internacional",8,10,18,0,0,0,0,0,0,0
"7761",2015-03-01,"sbbv","transporte regular","voo doméstico",110,110,220,14332,14549,28881,0,0,0,0
"7762",2015-03-01,"sbbv","transporte regular","voo internacional",0,0,0,0,0,0,0,0,0,0
"7763",2015-03-01,"sbbv","transporte não regular","voo doméstico",251,254,505,369,220,589,0,0,0,0
"7764",2015-03-01,"sbbv","transporte não regular","voo internacional",13,7,20,1,1,2,0,0,0,0
"7765",2015-03-01,"sbcg","transporte regular","voo doméstico",686,688,1374,63655,61317,124972,64592,124770,189362,0
"7766",2015-03-01,"sbcg","transporte regular","voo internacional",0,0,0,0,0,0,0,0,0,0
"7767",2015-03-01,"sbcg","transporte não regular","voo doméstico",299,299,598,372,288,660,0,0,0,0
"7768",2015-03-01,"sbcg","transporte não regular","voo internacional",19,19,38,169,184,353,0,0,0,0
"7769",2015-03-01,"sbcj","transporte regular","voo doméstico",142,142,284,9343,9216,18559,0,0,0,0
"7770",2015-03-01,"sbcj","transporte regular","voo internacional",0,0,0,0,0,0,0,0,0,0
"7771",2015-03-01,"sbcj","transporte não regular","voo doméstico",63,62,125,160,195,355,0,0,0,0
"7772",2015-03-01,"sbcj","transporte não regular","voo internacional",1,1,2,0,0,0,0,0,0,0
"7773",2015-03-01,"sbcr","transporte regular","voo doméstico",25,25,50,1368,1345,2713,0,0,0,0
"7774",2015-03-01,"sbcr","transporte regular","voo internacional",0,0,0,0,0,0,0,0,0,0
"7775",2015-03-01,"sbcr","transporte não regular","voo doméstico",29,31,60,193,138,331,0,0,0,0
"7776",2015-03-01,"sbcr","transporte não regular","voo internacional",3,3,6,4,5,9,0,0,0,0
"7777",2015-03-01,"sbct","transporte regular","voo doméstico",3032,3045,6077,307277,304420,611697,171948,0,171948,175945
"7778",2015-03-01,"sbct","transporte regular","voo internacional",109,108,217,5620,6064,11684,0,10654,10654,0
"7779",2015-03-01,"sbct","transporte não regular","voo doméstico",222,206,428,922,2221,3143,0,0,0,0
"7780",2015-03-01,"sbct","transporte não regular","voo internacional",17,15,32,42,44,86,0,0,0,0
"7781",2015-03-01,"sbcz","transporte regular","voo doméstico",30,30,60,2415,2256,4671,0,0,0,0
"7782",2015-03-01,"sbcz","transporte regular","voo internacional",0,0,0,0,0,0,0,0,0,0
"7783",2015-03-01,"sbcz","transporte não regular","voo doméstico",168,166,334,517,522,1039,0,0,0,0
"7784",2015-03-01,"sbcz","transporte não regular","voo internacional",3,3,6,0,0,0,0,0,0,0
"7785",2015-03-01,"sbeg","transporte regular","voo doméstico",1208,1199,2407,113177,111134,224311,840,0,840,0
"7786",2015-03-01,"sbeg","transporte regular","voo internacional",144,143,287,11138,7479,18617,0,0,0,0
"7787",2015-03-01,"sbeg","transporte não regular","voo doméstico",601,619,1220,4970,4776,9746,0,0,0,0
"7788",2015-03-01,"sbeg","transporte não regular","voo internacional",102,96,198,693,767,1460,0,0,0,0
"7789",2015-03-01,"sbfi","transporte regular","voo doméstico",668,668,1336,83324,81537,164861,0,0,0,0
"7790",2015-03-01,"sbfi","transporte regular","voo internacional",32,31,63,4001,3855,7856,0,0,0,0
"7791",2015-03-01,"sbfi","transporte não regular","voo doméstico",95,90,185,486,531,1017,0,0,0,0
"7792",2015-03-01,"sbfi","transporte não regular","voo internacional",42,48,90,138,82,220,0,0,0,0
"7793",2015-03-01,"sbgo","transporte regular","voo doméstico",1434,1435,2869,130053,126652,256705,112757,157270,270027,167683
"7794",2015-03-01,"sbgo","transporte regular","voo internacional",0,0,0,0,0,0,0,0,0,0
"7795",2015-03-01,"sbgo","transporte não regular","voo doméstico",1171,1174,2345,3554,4537,8091,0,0,0,0
"7796",2015-03-01,"sbgo","transporte não regular","voo internacional",10,8,18,0,0,0,0,0,0,0
"7797",2015-03-01,"sbht","transporte regular","voo doméstico",349,349,698,11803,11153,22956,0,0,0,0
"7798",2015-03-01,"sbht","transporte regular","voo internacional",0,0,0,0,0,0,0,0,0,0
"7799",2015-03-01,"sbht","transporte não regular","voo doméstico",177,174,351,371,432,803,0,290,290,160
"7800",2015-03-01,"sbht","transporte não regular","voo internacional",1,1,2,0,0,0,0,0,0,0
"7801",2015-03-01,"sbiz","transporte regular","voo doméstico",214,213,427,13079,12039,25118,0,0,0,22
"7802",2015-03-01,"sbiz","transporte regular","voo internacional",0,0,0,0,0,0,0,0,0,0
"7803",2015-03-01,"sbiz","transporte não regular","voo doméstico",157,159,316,660,365,1025,0,0,0,0
"7804",2015-03-01,"sbiz","transporte não regular","voo internacional",0,0,0,0,0,0,0,0,0,0
"7805",2015-03-01,"sbjc","transporte regular","voo doméstico",0,0,0,0,0,0,0,0,0,0
"7806",2015-03-01,"sbjc","transporte regular","voo internacional",0,0,0,0,0,0,0,0,0,0
"7807",2015-03-01,"sbjc","transporte não regular","voo doméstico",374,375,749,637,572,1209,0,0,0,0
"7808",2015-03-01,"sbjc","transporte não regular","voo internacional",1,0,1,0,0,0,0,0,0,0
"7809",2015-03-01,"sbjr","transporte regular","voo doméstico",0,0,0,0,0,0,0,0,0,0
"7810",2015-03-01,"sbjr","transporte regular","voo internacional",0,0,0,0,0,0,0,0,0,0
"7811",2015-03-01,"sbjr","transporte não regular","voo doméstico",2546,2552,5098,9467,7586,17053,0,0,0,0
"7812",2015-03-01,"sbjr","transporte não regular","voo internacional",0,0,0,0,0,0,0,0,0,0
"7813",2015-03-01,"sbjv","transporte regular","voo doméstico",245,245,490,20875,20933,41808,0,0,0,0
"7814",2015-03-01,"sbjv","transporte regular","voo internacional",0,0,0,0,0,0,0,0,0,0
"7815",2015-03-01,"sbjv","transporte não regular","voo doméstico",182,179,361,472,104,576,0,0,0,0
"7816",2015-03-01,"sbjv","transporte não regular","voo internacional",0,0,0,0,0,0,0,0,0,0
"7817",2015-03-01,"sblo","transporte regular","voo doméstico",483,479,962,44835,44819,89654,0,0,0,0
"7818",2015-03-01,"sblo","transporte regular","voo internacional",0,0,0,0,0,0,0,0,0,0
"7819",2015-03-01,"sblo","transporte não regular","voo doméstico",690,697,1387,667,628,1295,0,0,0,0
"7820",2015-03-01,"sblo","transporte não regular","voo internacional",5,5,10,0,0,0,0,0,0,0
"7821",2015-03-01,"sbma","transporte regular","voo doméstico",338,339,677,14630,15042,29672,0,21,21,42
"7822",2015-03-01,"sbma","transporte regular","voo internacional",0,0,0,0,0,0,0,0,0,0
"7823",2015-03-01,"sbma","transporte não regular","voo doméstico",266,268,534,1124,1125,2249,0,0,0,0
"7824",2015-03-01,"sbma","transporte não regular","voo internacional",3,3,6,0,0,0,0,0,0,0
"7825",2015-03-01,"sbmk","transporte regular","voo doméstico",191,190,381,16385,15979,32364,0,0,0,0
"7826",2015-03-01,"sbmk","transporte regular","voo internacional",0,0,0,0,0,0,0,0,0,0
"7827",2015-03-01,"sbmk","transporte não regular","voo doméstico",208,206,414,1896,1991,3887,0,0,0,0
"7828",2015-03-01,"sbmk","transporte não regular","voo internacional",0,0,0,0,0,0,0,0,0,0
"7829",2015-03-01,"sbmq","transporte regular","voo doméstico",305,303,608,25908,25554,51462,18350,35783,54133,0
"7830",2015-03-01,"sbmq","transporte regular","voo internacional",0,0,0,0,0,0,0,0,0,0
"7831",2015-03-01,"sbmq","transporte não regular","voo doméstico",180,184,364,309,336,645,0,0,0,0
"7832",2015-03-01,"sbmq","transporte não regular","voo internacional",8,10,18,0,0,0,0,0,0,0
"7833",2015-03-01,"sbmt","transporte regular","voo doméstico",0,0,0,0,0,0,0,0,0,0
"7834",2015-03-01,"sbmt","transporte regular","voo internacional",0,0,0,0,0,0,0,0,0,0
"7835",2015-03-01,"sbmt","transporte não regular","voo doméstico",4251,4251,8502,6523,6353,12876,0,0,0,0
"7836",2015-03-01,"sbmt","transporte não regular","voo internacional",0,0,0,0,0,0,0,0,0,0
"7837",2015-03-01,"sbnf","transporte regular","voo doméstico",616,618,1234,61951,61325,123276,0,0,0,0
"7838",2015-03-01,"sbnf","transporte regular","voo internacional",0,0,0,0,0,0,0,0,0,0
"7839",2015-03-01,"sbnf","transporte não regular","voo doméstico",347,348,695,810,995,1805,0,0,0,0
"7840",2015-03-01,"sbnf","transporte não regular","voo internacional",5,7,12,6,19,25,0,0,0,0
"7841",2015-03-01,"sbpb","transporte regular","voo doméstico",20,20,40,536,586,1122,0,0,0,0
"7842",2015-03-01,"sbpb","transporte regular","voo internacional",0,0,0,0,0,0,0,0,0,0
"7843",2015-03-01,"sbpb","transporte não regular","voo doméstico",30,31,61,56,48,104,0,0,0,0
"7844",2015-03-01,"sbpb","transporte não regular","voo internacional",0,0,0,0,0,0,0,0,0,0
"7845",2015-03-01,"sbpj","transporte regular","voo doméstico",369,366,735,24546,23877,48423,0,0,0,0
"7846",2015-03-01,"sbpj","transporte regular","voo internacional",0,0,0,0,0,0,0,0,0,0
"7847",2015-03-01,"sbpj","transporte não regular","voo doméstico",298,303,601,750,302,1052,0,0,0,0
"7848",2015-03-01,"sbpj","transporte não regular","voo internacional",2,2,4,0,0,0,0,0,0,0
"7849",2015-03-01,"sbpk","transporte regular","voo doméstico",51,52,103,2771,2441,5212,0,0,0,0
"7850",2015-03-01,"sbpk","transporte regular","voo internacional",0,0,0,0,0,0,0,0,0,0
"7851",2015-03-01,"sbpk","transporte não regular","voo doméstico",53,54,107,127,130,257,0,0,0,0
"7852",2015-03-01,"sbpk","transporte não regular","voo internacional",3,2,5,3,9,12,0,0,0,0
"7853",2015-03-01,"sbpl","transporte regular","voo doméstico",150,150,300,19447,19503,38950,0,0,0,0
"7854",2015-03-01,"sbpl","transporte regular","voo internacional",0,0,0,0,0,0,0,0,0,0
"7855",2015-03-01,"sbpl","transporte não regular","voo doméstico",107,109,216,210,145,355,0,0,0,0
"7856",2015-03-01,"sbpl","transporte não regular","voo internacional",0,0,0,0,0,0,0,0,0,0
"7857",2015-03-01,"sbpp","transporte regular","voo doméstico",0,0,0,0,0,0,0,0,0,0
"7858",2015-03-01,"sbpp","transporte regular","voo internacional",0,0,0,0,0,0,0,0,0,0
"7859",2015-03-01,"sbpp","transporte não regular","voo doméstico",75,76,151,132,124,256,0,0,0,0
"7860",2015-03-01,"sbpp","transporte não regular","voo internacional",6,9,15,5,3,8,0,0,0,0
"7861",2015-03-01,"sbpr","transporte regular","voo doméstico",1,1,2,1,1,2,0,0,0,0
"7862",2015-03-01,"sbpr","transporte regular","voo internacional",0,0,0,0,0,0,0,0,0,0
"7863",2015-03-01,"sbpr","transporte não regular","voo doméstico",1016,1019,2035,1187,1122,2309,0,0,0,0
"7864",2015-03-01,"sbpr","transporte não regular","voo internacional",3,2,5,0,0,0,0,0,0,0
"7865",2015-03-01,"sbpv","transporte regular","voo doméstico",390,390,780,35925,35015,70940,0,0,0,0
"7866",2015-03-01,"sbpv","transporte regular","voo internacional",0,0,0,0,0,0,0,0,0,0
"7867",2015-03-01,"sbpv","transporte não regular","voo doméstico",237,238,475,161,237,398,0,0,0,0
"7868",2015-03-01,"sbpv","transporte não regular","voo internacional",0,0,0,0,0,0,0,0,0,0
"7869",2015-03-01,"sbrb","transporte regular","voo doméstico",160,161,321,13882,14467,28349,0,2,2,0
"7870",2015-03-01,"sbrb","transporte regular","voo internacional",0,0,0,0,0,0,0,0,0,0
"7871",2015-03-01,"sbrb","transporte não regular","voo doméstico",157,158,315,710,555,1265,0,0,0,0
"7872",2015-03-01,"sbrb","transporte não regular","voo internacional",0,0,0,0,0,0,0,0,0,0
"7873",2015-03-01,"sbrj","transporte regular","voo doméstico",4636,4651,9287,408913,406304,815217,0,0,0,0
"7874",2015-03-01,"sbrj","transporte regular","voo internacional",0,0,0,0,0,0,0,0,0,0
"7875",2015-03-01,"sbrj","transporte não regular","voo doméstico",794,782,1576,556,1006,1562,0,0,0,0
"7876",2015-03-01,"sbrj","transporte não regular","voo internacional",0,1,1,0,0,0,0,0,0,0
"7877",2015-03-01,"sbsj","transporte regular","voo doméstico",0,0,0,0,0,0,0,0,0,0
"7878",2015-03-01,"sbsj","transporte regular","voo internacional",0,0,0,0,0,0,0,0,0,0
"7879",2015-03-01,"sbsj","transporte não regular","voo doméstico",515,510,1025,710,711,1421,0,0,0,0
"7880",2015-03-01,"sbsj","transporte não regular","voo internacional",3,16,19,12,4,16,0,0,0,0
"7881",2015-03-01,"sbsl","transporte regular","voo doméstico",595,605,1200,60870,59487,120357,0,688,688,0
"7882",2015-03-01,"sbsl","transporte regular","voo internacional",0,0,0,0,0,0,0,0,0,0
"7883",2015-03-01,"sbsl","transporte não regular","voo doméstico",248,241,489,3447,4445,7892,70623,200151,270774,0
"7884",2015-03-01,"sbsl","transporte não regular","voo internacional",0,1,1,0,0,0,0,0,0,0
"7885",2015-03-01,"sbsn","transporte regular","voo doméstico",396,403,799,23494,21539,45033,12,748,760,0
"7886",2015-03-01,"sbsn","transporte regular","voo internacional",0,0,0,0,0,0,0,0,0,0
"7887",2015-03-01,"sbsn","transporte não regular","voo doméstico",360,348,708,1781,1549,3330,0,0,0,0
"7888",2015-03-01,"sbsn","transporte não regular","voo internacional",0,1,1,0,0,0,0,0,0,0
"7889",2015-03-01,"sbsp","transporte regular","voo doméstico",7407,7446,14853,786120,778907,1565027,0,0,0,0
"7890",2015-03-01,"sbsp","transporte regular","voo internacional",0,0,0,0,0,0,0,0,0,0
"7891",2015-03-01,"sbsp","transporte não regular","voo doméstico",1949,1918,3867,10798,10364,21162,0,0,0,0
"7892",2015-03-01,"sbsp","transporte não regular","voo internacional",0,0,0,0,0,0,0,0,0,0
"7893",2015-03-01,"sbte","transporte regular","voo doméstico",497,500,997,44683,45080,89763,35028,90603,125631,247848
"7894",2015-03-01,"sbte","transporte regular","voo internacional",0,0,0,0,0,0,0,0,0,0
"7895",2015-03-01,"sbte","transporte não regular","voo doméstico",175,170,345,870,920,1790,0,0,0,0
"7896",2015-03-01,"sbte","transporte não regular","voo internacional",1,1,2,0,0,0,0,0,0,0
"7897",2015-03-01,"sbtf","transporte regular","voo doméstico",56,56,112,2193,2294,4487,0,0,0,0
"7898",2015-03-01,"sbtf","transporte regular","voo internacional",0,0,0,0,0,0,0,0,0,0
"7899",2015-03-01,"sbtf","transporte não regular","voo doméstico",221,222,443,253,190,443,2302,4812,7114,27014
"7900",2015-03-01,"sbtf","transporte não regular","voo internacional",0,0,0,0,0,0,0,0,0,0
"7901",2015-03-01,"sbtt","transporte regular","voo doméstico",32,32,64,2103,2579,4682,0,0,0,0
"7902",2015-03-01,"sbtt","transporte regular","voo internacional",1,1,2,0,0,0,0,0,0,0
"7903",2015-03-01,"sbtt","transporte não regular","voo doméstico",122,121,243,502,503,1005,1421,4043,5464,449
"7904",2015-03-01,"sbtt","transporte não regular","voo internacional",1,1,2,4,2,6,0,0,0,0
"7905",2015-03-01,"sbuf","transporte regular","voo doméstico",23,23,46,1163,1103,2266,0,0,0,0
"7906",2015-03-01,"sbuf","transporte regular","voo internacional",0,0,0,0,0,0,0,0,0,0
"7907",2015-03-01,"sbuf","transporte não regular","voo doméstico",49,47,96,131,117,248,0,0,0,0
"7908",2015-03-01,"sbuf","transporte não regular","voo internacional",0,0,0,0,0,0,0,0,0,0
"7909",2015-03-01,"sbug","transporte regular","voo doméstico",0,0,0,0,0,0,0,0,0,0
"7910",2015-03-01,"sbug","transporte regular","voo internacional",0,0,0,0,0,0,0,0,0,0
"7911",2015-03-01,"sbug","transporte não regular","voo doméstico",12,12,24,26,31,57,0,0,0,0
"7912",2015-03-01,"sbug","transporte não regular","voo internacional",0,0,0,0,0,0,0,0,0,0
"7913",2015-03-01,"sbul","transporte regular","voo doméstico",602,597,1199,50026,50139,100165,0,0,0,0
"7914",2015-03-01,"sbul","transporte regular","voo internacional",0,0,0,0,0,0,0,0,0,0
"7915",2015-03-01,"sbul","transporte não regular","voo doméstico",491,499,990,1298,1191,2489,0,0,0,0
"7916",2015-03-01,"sbul","transporte não regular","voo internacional",2,2,4,17,19,36,0,0,0,0
"7917",2015-03-01,"sbur","transporte regular","voo doméstico",147,146,293,5595,5974,11569,0,0,0,0
"7918",2015-03-01,"sbur","transporte regular","voo internacional",0,0,0,0,0,0,0,0,0,0
"7919",2015-03-01,"sbur","transporte não regular","voo doméstico",128,132,260,426,469,895,0,0,0,0
"7920",2015-03-01,"sbur","transporte não regular","voo internacional",1,1,2,0,0,0,0,0,0,0
"7921",2015-11-01,"sbbe","transporte regular","voo doméstico",1420,1425,2845,135137,128422,263559,118431,325817,444248,0
"7922",2015-11-01,"sbbe","transporte regular","voo internacional",56,56,112,4782,4699,9481,0,8,8,0
"7923",2015-11-01,"sbbe","transporte não regular","voo doméstico",519,504,1023,2167,2513,4680,0,0,0,0
"7924",2015-11-01,"sbbe","transporte não regular","voo internacional",17,18,35,40,32,72,0,0,0,0
"7925",2015-11-01,"sbbg","transporte regular","voo doméstico",0,0,0,0,0,0,0,0,0,0
"7926",2015-11-01,"sbbg","transporte regular","voo internacional",0,0,0,0,0,0,0,0,0,0
"7927",2015-11-01,"sbbg","transporte não regular","voo doméstico",19,20,39,106,107,213,0,0,0,0
"7928",2015-11-01,"sbbg","transporte não regular","voo internacional",2,1,3,8,6,14,0,0,0,0
"7929",2015-11-01,"sbbh","transporte regular","voo doméstico",214,219,433,10894,10160,21054,0,0,0,0
"7930",2015-11-01,"sbbh","transporte regular","voo internacional",0,0,0,0,0,0,0,0,0,0
"7931",2015-11-01,"sbbh","transporte não regular","voo doméstico",1644,1621,3265,7946,8024,15970,0,0,0,0
"7932",2015-11-01,"sbbh","transporte não regular","voo internacional",2,2,4,25,25,50,0,0,0,0
"7933",2015-11-01,"sbbi","transporte regular","voo doméstico",0,0,0,0,0,0,0,0,0,0
"7934",2015-11-01,"sbbi","transporte regular","voo internacional",0,0,0,0,0,0,0,0,0,0
"7935",2015-11-01,"sbbi","transporte não regular","voo doméstico",788,789,1577,3561,3524,7085,0,0,0,0
"7936",2015-11-01,"sbbi","transporte não regular","voo internacional",0,0,0,0,0,0,0,0,0,0
"7937",2015-11-01,"sbbv","transporte regular","voo doméstico",108,108,216,13693,13931,27624,0,0,0,0
"7938",2015-11-01,"sbbv","transporte regular","voo internacional",0,0,0,0,0,0,0,0,0,0
"7939",2015-11-01,"sbbv","transporte não regular","voo doméstico",284,275,559,109,45,154,0,0,0,0
"7940",2015-11-01,"sbbv","transporte não regular","voo internacional",11,14,25,0,0,0,0,0,0,0
"7941",2015-11-01,"sbcg","transporte regular","voo doméstico",674,671,1345,61620,59054,120674,76350,129800,206150,0
"7942",2015-11-01,"sbcg","transporte regular","voo internacional",0,0,0,0,0,0,0,0,0,0
"7943",2015-11-01,"sbcg","transporte não regular","voo doméstico",228,237,465,208,251,459,0,0,0,0
"7944",2015-11-01,"sbcg","transporte não regular","voo internacional",13,12,25,8,8,16,0,0,0,0
"7945",2015-11-01,"sbcj","transporte regular","voo doméstico",75,75,150,6818,6749,13567,0,0,0,0
"7946",2015-11-01,"sbcj","transporte regular","voo internacional",0,0,0,0,0,0,0,0,0,0
"7947",2015-11-01,"sbcj","transporte não regular","voo doméstico",78,75,153,69,0,69,0,0,0,0
"7948",2015-11-01,"sbcj","transporte não regular","voo internacional",3,3,6,0,0,0,0,0,0,0
"7949",2015-11-01,"sbcr","transporte regular","voo doméstico",17,18,35,1393,1155,2548,0,0,0,0
"7950",2015-11-01,"sbcr","transporte regular","voo internacional",0,0,0,0,0,0,0,0,0,0
"7951",2015-11-01,"sbcr","transporte não regular","voo doméstico",58,56,114,135,128,263,0,0,0,0
"7952",2015-11-01,"sbcr","transporte não regular","voo internacional",3,4,7,11,12,23,0,0,0,0
"7953",2015-11-01,"sbct","transporte regular","voo doméstico",2796,2812,5608,293714,285721,579435,158032,0,158032,222183
"7954",2015-11-01,"sbct","transporte regular","voo internacional",103,103,206,3917,4537,8454,0,2730,2730,0
"7955",2015-11-01,"sbct","transporte não regular","voo doméstico",225,199,424,1729,2416,4145,0,0,0,0
"7956",2015-11-01,"sbct","transporte não regular","voo internacional",9,6,15,20,12,32,0,0,0,0
"7957",2015-11-01,"sbcz","transporte regular","voo doméstico",29,29,58,2511,2309,4820,0,0,0,0
"7958",2015-11-01,"sbcz","transporte regular","voo internacional",0,0,0,0,0,0,0,0,0,0
"7959",2015-11-01,"sbcz","transporte não regular","voo doméstico",163,165,328,545,526,1071,0,0,0,0
"7960",2015-11-01,"sbcz","transporte não regular","voo internacional",0,0,0,0,0,0,0,0,0,0
"7961",2015-11-01,"sbeg","transporte regular","voo doméstico",1095,1091,2186,113251,109362,222613,0,146,146,0
"7962",2015-11-01,"sbeg","transporte regular","voo internacional",134,134,268,6937,5938,12875,0,0,0,0
"7963",2015-11-01,"sbeg","transporte não regular","voo doméstico",620,619,1239,4801,4606,9407,0,0,0,0
"7964",2015-11-01,"sbeg","transporte não regular","voo internacional",102,103,205,1348,618,1966,0,0,0,0
"7965",2015-11-01,"sbfi","transporte regular","voo doméstico",625,628,1253,78915,75186,154101,0,0,0,0
"7966",2015-11-01,"sbfi","transporte regular","voo internacional",22,22,44,2689,2346,5035,0,0,0,0
"7967",2015-11-01,"sbfi","transporte não regular","voo doméstico",103,107,210,207,565,772,0,0,0,0
"7968",2015-11-01,"sbfi","transporte não regular","voo internacional",27,28,55,54,160,214,0,0,0,0
"7969",2015-11-01,"sbgo","transporte regular","voo doméstico",1401,1404,2805,128954,125013,253967,104309,170183,274492,166881
"7970",2015-11-01,"sbgo","transporte regular","voo internacional",0,0,0,0,0,0,0,0,0,0
"7971",2015-11-01,"sbgo","transporte não regular","voo doméstico",1252,1245,2497,4130,4180,8310,685,4317,5002,3857
"7972",2015-11-01,"sbgo","transporte não regular","voo internacional",5,5,10,0,0,0,0,0,0,0
"7973",2015-11-01,"sbht","transporte regular","voo doméstico",230,230,460,11865,10874,22739,0,0,0,0
"7974",2015-11-01,"sbht","transporte regular","voo internacional",0,0,0,0,0,0,0,0,0,0
"7975",2015-11-01,"sbht","transporte não regular","voo doméstico",177,177,354,202,183,385,300,710,1010,480
"7976",2015-11-01,"sbht","transporte não regular","voo internacional",0,0,0,0,0,0,0,0,0,0
"7977",2015-11-01,"sbiz","transporte regular","voo doméstico",259,260,519,14128,13967,28095,0,0,0,0
"7978",2015-11-01,"sbiz","transporte regular","voo internacional",0,0,0,0,0,0,0,0,0,0
"7979",2015-11-01,"sbiz","transporte não regular","voo doméstico",190,196,386,251,268,519,0,0,0,0
"7980",2015-11-01,"sbiz","transporte não regular","voo internacional",0,0,0,0,0,0,0,0,0,0
"7981",2015-11-01,"sbjc","transporte regular","voo doméstico",0,0,0,0,0,0,0,0,0,0
"7982",2015-11-01,"sbjc","transporte regular","voo internacional",0,0,0,0,0,0,0,0,0,0
"7983",2015-11-01,"sbjc","transporte não regular","voo doméstico",447,451,898,917,850,1767,0,0,0,0
"7984",2015-11-01,"sbjc","transporte não regular","voo internacional",0,0,0,0,0,0,0,0,0,0
"7985",2015-11-01,"sbjr","transporte regular","voo doméstico",0,0,0,0,0,0,0,0,0,0
"7986",2015-11-01,"sbjr","transporte regular","voo internacional",0,0,0,0,0,0,0,0,0,0
"7987",2015-11-01,"sbjr","transporte não regular","voo doméstico",2337,2337,4674,8816,6242,15058,0,0,0,0
"7988",2015-11-01,"sbjr","transporte não regular","voo internacional",0,0,0,0,0,0,0,0,0,0
"7989",2015-11-01,"sbjv","transporte regular","voo doméstico",305,303,608,22015,21795,43810,0,0,0,0
"7990",2015-11-01,"sbjv","transporte regular","voo internacional",0,0,0,0,0,0,0,0,0,0
"7991",2015-11-01,"sbjv","transporte não regular","voo doméstico",146,146,292,140,177,317,0,0,0,0
"7992",2015-11-01,"sbjv","transporte não regular","voo internacional",0,0,0,0,0,0,0,0,0,0
"7993",2015-11-01,"sblo","transporte regular","voo doméstico",463,451,914,43119,42282,85401,0,0,0,0
"7994",2015-11-01,"sblo","transporte regular","voo internacional",0,0,0,0,0,0,0,0,0,0
"7995",2015-11-01,"sblo","transporte não regular","voo doméstico",452,475,927,1410,690,2100,0,0,0,0
"7996",2015-11-01,"sblo","transporte não regular","voo internacional",1,1,2,0,0,0,0,0,0,0
"7997",2015-11-01,"sbma","transporte regular","voo doméstico",239,238,477,13666,13825,27491,0,0,0,33
"7998",2015-11-01,"sbma","transporte regular","voo internacional",0,0,0,0,0,0,0,0,0,0
"7999",2015-11-01,"sbma","transporte não regular","voo doméstico",186,186,372,559,596,1155,0,0,0,0
"8000",2015-11-01,"sbma","transporte não regular","voo internacional",1,1,2,0,0,0,0,0,0,0
"8001",2015-11-01,"sbmk","transporte regular","voo doméstico",166,165,331,13132,12986,26118,0,0,0,0
"8002",2015-11-01,"sbmk","transporte regular","voo internacional",0,0,0,0,0,0,0,0,0,0
"8003",2015-11-01,"sbmk","transporte não regular","voo doméstico",614,613,1227,182,197,379,0,0,0,0
"8004",2015-11-01,"sbmk","transporte não regular","voo internacional",1,1,2,0,0,0,0,0,0,0
"8005",2015-11-01,"sbmq","transporte regular","voo doméstico",212,214,426,25168,25193,50361,5700,30950,36650,0
"8006",2015-11-01,"sbmq","transporte regular","voo internacional",0,0,0,0,0,0,0,0,0,0
"8007",2015-11-01,"sbmq","transporte não regular","voo doméstico",147,146,293,215,103,318,0,0,0,0
"8008",2015-11-01,"sbmq","transporte não regular","voo internacional",6,7,13,0,0,0,0,0,0,0
"8009",2015-11-01,"sbmt","transporte regular","voo doméstico",0,0,0,0,0,0,0,0,0,0
"8010",2015-11-01,"sbmt","transporte regular","voo internacional",0,0,0,0,0,0,0,0,0,0
"8011",2015-11-01,"sbmt","transporte não regular","voo doméstico",3236,3201,6437,5719,5646,11365,0,0,0,0
"8012",2015-11-01,"sbmt","transporte não regular","voo internacional",0,0,0,0,0,0,0,0,0,0
"8013",2015-11-01,"sbnf","transporte regular","voo doméstico",689,688,1377,66234,62731,128965,0,0,0,0
"8014",2015-11-01,"sbnf","transporte regular","voo internacional",0,0,0,0,0,0,0,0,0,0
"8015",2015-11-01,"sbnf","transporte não regular","voo doméstico",170,173,343,470,828,1298,0,0,0,0
"8016",2015-11-01,"sbnf","transporte não regular","voo internacional",4,5,9,14,19,33,0,0,0,0
"8017",2015-11-01,"sbpb","transporte regular","voo doméstico",2,2,4,67,45,112,0,0,0,0
"8018",2015-11-01,"sbpb","transporte regular","voo internacional",0,0,0,0,0,0,0,0,0,0
"8019",2015-11-01,"sbpb","transporte não regular","voo doméstico",50,56,106,148,99,247,0,0,0,0
"8020",2015-11-01,"sbpb","transporte não regular","voo internacional",1,1,2,0,0,0,0,0,0,0
"8021",2015-11-01,"sbpj","transporte regular","voo doméstico",403,400,803,26955,25869,52824,0,0,0,0
"8022",2015-11-01,"sbpj","transporte regular","voo internacional",0,0,0,0,0,0,0,0,0,0
"8023",2015-11-01,"sbpj","transporte não regular","voo doméstico",211,209,420,540,434,974,0,0,0,0
"8024",2015-11-01,"sbpj","transporte não regular","voo internacional",3,2,5,0,0,0,0,0,0,0
"8025",2015-11-01,"sbpk","transporte regular","voo doméstico",46,47,93,2215,2176,4391,0,0,0,0
"8026",2015-11-01,"sbpk","transporte regular","voo internacional",0,0,0,0,0,0,0,0,0,0
"8027",2015-11-01,"sbpk","transporte não regular","voo doméstico",42,46,88,100,91,191,0,0,0,0
"8028",2015-11-01,"sbpk","transporte não regular","voo internacional",5,3,8,4,14,18,0,0,0,0
"8029",2015-11-01,"sbpl","transporte regular","voo doméstico",134,132,266,16594,16952,33546,0,0,0,0
"8030",2015-11-01,"sbpl","transporte regular","voo internacional",0,0,0,0,0,0,0,0,0,0
"8031",2015-11-01,"sbpl","transporte não regular","voo doméstico",91,91,182,142,133,275,0,0,0,0
"8032",2015-11-01,"sbpl","transporte não regular","voo internacional",8,8,16,0,0,0,0,0,0,0
"8033",2015-11-01,"sbpp","transporte regular","voo doméstico",0,0,0,0,0,0,0,0,0,0
"8034",2015-11-01,"sbpp","transporte regular","voo internacional",0,0,0,0,0,0,0,0,0,0
"8035",2015-11-01,"sbpp","transporte não regular","voo doméstico",63,63,126,102,100,202,0,0,0,0
"8036",2015-11-01,"sbpp","transporte não regular","voo internacional",5,4,9,6,10,16,0,0,0,0
"8037",2015-11-01,"sbpr","transporte regular","voo doméstico",0,0,0,0,0,0,0,0,0,0
"8038",2015-11-01,"sbpr","transporte regular","voo internacional",0,0,0,0,0,0,0,0,0,0
"8039",2015-11-01,"sbpr","transporte não regular","voo doméstico",716,712,1428,806,783,1589,0,0,0,0
"8040",2015-11-01,"sbpr","transporte não regular","voo internacional",0,0,0,0,0,0,0,0,0,0
"8041",2015-11-01,"sbpv","transporte regular","voo doméstico",461,463,924,39695,37369,77064,0,0,0,0
"8042",2015-11-01,"sbpv","transporte regular","voo internacional",0,0,0,0,0,0,0,0,0,0
"8043",2015-11-01,"sbpv","transporte não regular","voo doméstico",226,227,453,21,153,174,0,0,0,0
"8044",2015-11-01,"sbpv","transporte não regular","voo internacional",0,0,0,0,0,0,0,0,0,0
"8045",2015-11-01,"sbrb","transporte regular","voo doméstico",172,171,343,16783,16867,33650,0,0,0,350
"8046",2015-11-01,"sbrb","transporte regular","voo internacional",0,0,0,0,0,0,0,0,0,0
"8047",2015-11-01,"sbrb","transporte não regular","voo doméstico",134,127,261,314,178,492,0,0,0,0
"8048",2015-11-01,"sbrb","transporte não regular","voo internacional",0,0,0,0,0,0,0,0,0,0
"8049",2015-11-01,"sbrj","transporte regular","voo doméstico",4153,4171,8324,391248,379974,771222,0,0,0,0
"8050",2015-11-01,"sbrj","transporte regular","voo internacional",0,0,0,0,0,0,0,0,0,0
"8051",2015-11-01,"sbrj","transporte não regular","voo doméstico",630,614,1244,1328,1138,2466,0,0,0,0
"8052",2015-11-01,"sbrj","transporte não regular","voo internacional",1,1,2,0,0,0,0,0,0,0
"8053",2015-11-01,"sbsj","transporte regular","voo doméstico",27,25,52,2582,2608,5190,0,0,0,0
"8054",2015-11-01,"sbsj","transporte regular","voo internacional",0,0,0,0,0,0,0,0,0,0
"8055",2015-11-01,"sbsj","transporte não regular","voo doméstico",526,504,1030,1828,1828,3656,0,0,0,0
"8056",2015-11-01,"sbsj","transporte não regular","voo internacional",0,12,12,26,0,26,0,0,0,0
"8057",2015-11-01,"sbsl","transporte regular","voo doméstico",796,789,1585,65819,70543,136362,0,0,0,0
"8058",2015-11-01,"sbsl","transporte regular","voo internacional",0,0,0,0,0,0,0,0,0,0
"8059",2015-11-01,"sbsl","transporte não regular","voo doméstico",263,257,520,933,688,1621,86577,177803,264380,0
"8060",2015-11-01,"sbsl","transporte não regular","voo internacional",3,4,7,0,3,3,0,0,0,0
"8061",2015-11-01,"sbsn","transporte regular","voo doméstico",342,341,683,24528,22522,47050,0,0,0,0
"8062",2015-11-01,"sbsn","transporte regular","voo internacional",0,0,0,0,0,0,0,0,0,0
"8063",2015-11-01,"sbsn","transporte não regular","voo doméstico",286,285,571,899,550,1449,0,0,0,0
"8064",2015-11-01,"sbsn","transporte não regular","voo internacional",3,5,8,4,0,4,0,0,0,0
"8065",2015-11-01,"sbsp","transporte regular","voo doméstico",6983,7077,14060,810437,804688,1615125,0,0,0,0
"8066",2015-11-01,"sbsp","transporte regular","voo internacional",0,0,0,0,0,0,0,0,0,0
"8067",2015-11-01,"sbsp","transporte não regular","voo doméstico",1849,1729,3578,8911,8287,17198,0,0,0,0
"8068",2015-11-01,"sbsp","transporte não regular","voo internacional",0,0,0,0,0,0,0,0,0,0
"8069",2015-11-01,"sbte","transporte regular","voo doméstico",574,574,1148,45431,45908,91339,28990,82749,111739,241619
"8070",2015-11-01,"sbte","transporte regular","voo internacional",0,0,0,0,0,0,0,0,0,0
"8071",2015-11-01,"sbte","transporte não regular","voo doméstico",247,241,488,1322,1352,2674,0,0,0,0
"8072",2015-11-01,"sbte","transporte não regular","voo internacional",0,0,0,0,0,0,0,0,0,0
"8073",2015-11-01,"sbtf","transporte regular","voo doméstico",39,40,79,1818,1852,3670,0,0,0,0
"8074",2015-11-01,"sbtf","transporte regular","voo internacional",0,0,0,0,0,0,0,0,0,0
"8075",2015-11-01,"sbtf","transporte não regular","voo doméstico",128,129,257,325,215,540,1416,195,1611,11504
"8076",2015-11-01,"sbtf","transporte não regular","voo internacional",0,0,0,0,0,0,0,0,0,0
"8077",2015-11-01,"sbtt","transporte regular","voo doméstico",30,30,60,2313,2730,5043,0,0,0,0
"8078",2015-11-01,"sbtt","transporte regular","voo internacional",0,0,0,0,0,0,0,0,0,0
"8079",2015-11-01,"sbtt","transporte não regular","voo doméstico",97,99,196,466,463,929,1238,2668,3906,434
"8080",2015-11-01,"sbtt","transporte não regular","voo internacional",4,4,8,7,11,18,0,0,0,0
"8081",2015-11-01,"sbuf","transporte regular","voo doméstico",14,14,28,655,690,1345,0,0,0,0
"8082",2015-11-01,"sbuf","transporte regular","voo internacional",0,0,0,0,0,0,0,0,0,0
"8083",2015-11-01,"sbuf","transporte não regular","voo doméstico",40,40,80,103,104,207,0,0,0,0
"8084",2015-11-01,"sbuf","transporte não regular","voo internacional",0,0,0,0,0,0,0,0,0,0
"8085",2015-11-01,"sbug","transporte regular","voo doméstico",23,23,46,1347,1257,2604,0,0,0,0
"8086",2015-11-01,"sbug","transporte regular","voo internacional",0,0,0,0,0,0,0,0,0,0
"8087",2015-11-01,"sbug","transporte não regular","voo doméstico",8,9,17,14,20,34,0,0,0,0
"8088",2015-11-01,"sbug","transporte não regular","voo internacional",0,0,0,0,0,0,0,0,0,0
"8089",2015-11-01,"sbul","transporte regular","voo doméstico",573,569,1142,47900,47294,95194,0,0,0,0
"8090",2015-11-01,"sbul","transporte regular","voo internacional",0,0,0,0,0,0,0,0,0,0
"8091",2015-11-01,"sbul","transporte não regular","voo doméstico",485,485,970,1441,1394,2835,0,0,0,0
"8092",2015-11-01,"sbul","transporte não regular","voo internacional",0,0,0,0,0,0,0,0,0,0
"8093",2015-11-01,"sbur","transporte regular","voo doméstico",76,76,152,3811,3890,7701,0,0,0,0
"8094",2015-11-01,"sbur","transporte regular","voo internacional",0,0,0,0,0,0,0,0,0,0
"8095",2015-11-01,"sbur","transporte não regular","voo doméstico",142,140,282,539,645,1184,0,0,0,0
"8096",2015-11-01,"sbur","transporte não regular","voo internacional",2,2,4,0,0,0,0,0,0,0
"8097",2015-10-01,"sbbe","transporte regular","voo doméstico",1528,1521,3049,149734,137027,286761,101632,407828,509460,0
"8098",2015-10-01,"sbbe","transporte regular","voo internacional",62,60,122,5006,5652,10658,0,1,1,0
"8099",2015-10-01,"sbbe","transporte não regular","voo doméstico",581,590,1171,5443,5208,10651,0,0,0,0
"8100",2015-10-01,"sbbe","transporte não regular","voo internacional",9,13,22,263,12,275,0,0,0,0
"8101",2015-10-01,"sbbg","transporte regular","voo doméstico",0,0,0,0,0,0,0,0,0,0
"8102",2015-10-01,"sbbg","transporte regular","voo internacional",0,0,0,0,0,0,0,0,0,0
"8103",2015-10-01,"sbbg","transporte não regular","voo doméstico",12,14,26,50,56,106,0,0,0,0
"8104",2015-10-01,"sbbg","transporte não regular","voo internacional",2,0,2,0,0,0,0,0,0,0
"8105",2015-10-01,"sbbh","transporte regular","voo doméstico",281,288,569,14862,13513,28375,0,0,0,0
"8106",2015-10-01,"sbbh","transporte regular","voo internacional",0,0,0,0,0,0,0,0,0,0
"8107",2015-10-01,"sbbh","transporte não regular","voo doméstico",1755,1770,3525,8808,8970,17778,0,0,0,0
"8108",2015-10-01,"sbbh","transporte não regular","voo internacional",4,2,6,10,10,20,0,0,0,0
"8109",2015-10-01,"sbbi","transporte regular","voo doméstico",0,0,0,0,0,0,0,0,0,0
"8110",2015-10-01,"sbbi","transporte regular","voo internacional",0,0,0,0,0,0,0,0,0,0
"8111",2015-10-01,"sbbi","transporte não regular","voo doméstico",849,841,1690,4308,4296,8604,0,0,0,0
"8112",2015-10-01,"sbbi","transporte não regular","voo internacional",2,2,4,0,0,0,0,0,0,0
"8113",2015-10-01,"sbbv","transporte regular","voo doméstico",107,107,214,13873,13568,27441,0,0,0,0
"8114",2015-10-01,"sbbv","transporte regular","voo internacional",0,0,0,0,0,0,0,0,0,0
"8115",2015-10-01,"sbbv","transporte não regular","voo doméstico",289,285,574,93,50,143,0,0,0,0
"8116",2015-10-01,"sbbv","transporte não regular","voo internacional",13,22,35,8,0,8,0,0,0,0
"8117",2015-10-01,"sbcg","transporte regular","voo doméstico",690,691,1381,66640,65594,132234,77667,146754,224421,0
"8118",2015-10-01,"sbcg","transporte regular","voo internacional",0,0,0,0,0,0,0,0,0,0
"8119",2015-10-01,"sbcg","transporte não regular","voo doméstico",278,272,550,59,108,167,0,7199,7199,0
"8120",2015-10-01,"sbcg","transporte não regular","voo internacional",14,14,28,6,4,10,0,0,0,0
"8121",2015-10-01,"sbcj","transporte regular","voo doméstico",121,121,242,7832,7667,15499,0,0,0,0
"8122",2015-10-01,"sbcj","transporte regular","voo internacional",0,0,0,0,0,0,0,0,0,0
"8123",2015-10-01,"sbcj","transporte não regular","voo doméstico",62,60,122,550,469,1019,0,0,0,0
"8124",2015-10-01,"sbcj","transporte não regular","voo internacional",0,0,0,0,0,0,0,0,0,0
"8125",2015-10-01,"sbcr","transporte regular","voo doméstico",17,17,34,1416,1436,2852,0,0,0,0
"8126",2015-10-01,"sbcr","transporte regular","voo internacional",0,0,0,0,0,0,0,0,0,0
"8127",2015-10-01,"sbcr","transporte não regular","voo doméstico",65,63,128,183,154,337,0,0,0,0
"8128",2015-10-01,"sbcr","transporte não regular","voo internacional",7,6,13,10,13,23,0,0,0,0
"8129",2015-10-01,"sbct","transporte regular","voo doméstico",2963,2960,5923,303779,295976,599755,115832,0,115832,122239
"8130",2015-10-01,"sbct","transporte regular","voo internacional",104,105,209,5593,5197,10790,0,1986,1986,0
"8131",2015-10-01,"sbct","transporte não regular","voo doméstico",258,262,520,1631,3053,4684,0,0,0,0
"8132",2015-10-01,"sbct","transporte não regular","voo internacional",8,8,16,32,26,58,0,0,0,0
"8133",2015-10-01,"sbcz","transporte regular","voo doméstico",30,31,61,2625,2460,5085,0,0,0,0
"8134",2015-10-01,"sbcz","transporte regular","voo internacional",0,0,0,0,0,0,0,0,0,0
"8135",2015-10-01,"sbcz","transporte não regular","voo doméstico",200,198,398,628,686,1314,0,0,0,0
"8136",2015-10-01,"sbcz","transporte não regular","voo internacional",1,1,2,0,0,0,0,0,0,0
"8137",2015-10-01,"sbeg","transporte regular","voo doméstico",1183,1174,2357,115273,113408,228681,0,0,0,0
"8138",2015-10-01,"sbeg","transporte regular","voo internacional",141,142,283,8339,8664,17003,0,0,0,0
"8139",2015-10-01,"sbeg","transporte não regular","voo doméstico",623,628,1251,5836,5071,10907,0,0,0,0
"8140",2015-10-01,"sbeg","transporte não regular","voo internacional",85,94,179,1456,1890,3346,0,0,0,0
"8141",2015-10-01,"sbfi","transporte regular","voo doméstico",641,643,1284,81849,83705,165554,0,0,0,0
"8142",2015-10-01,"sbfi","transporte regular","voo internacional",22,22,44,3026,2801,5827,0,0,0,0
"8143",2015-10-01,"sbfi","transporte não regular","voo doméstico",141,139,280,517,1682,2199,0,0,0,0
"8144",2015-10-01,"sbfi","transporte não regular","voo internacional",38,32,70,88,126,214,0,0,0,0
"8145",2015-10-01,"sbgo","transporte regular","voo doméstico",1406,1410,2816,127960,126847,254807,127549,187029,314578,186414
"8146",2015-10-01,"sbgo","transporte regular","voo internacional",0,0,0,0,0,0,0,0,0,0
"8147",2015-10-01,"sbgo","transporte não regular","voo doméstico",1394,1409,2803,4711,4677,9388,0,0,0,0
"8148",2015-10-01,"sbgo","transporte não regular","voo internacional",3,3,6,0,0,0,0,0,0,0
"8149",2015-10-01,"sbht","transporte regular","voo doméstico",238,238,476,13167,11521,24688,0,0,0,0
"8150",2015-10-01,"sbht","transporte regular","voo internacional",0,0,0,0,0,0,0,0,0,0
"8151",2015-10-01,"sbht","transporte não regular","voo doméstico",204,206,410,445,232,677,210,390,600,260
"8152",2015-10-01,"sbht","transporte não regular","voo internacional",1,1,2,0,0,0,0,0,0,0
"8153",2015-10-01,"sbiz","transporte regular","voo doméstico",254,254,508,13771,13489,27260,0,0,0,0
"8154",2015-10-01,"sbiz","transporte regular","voo internacional",0,0,0,0,0,0,0,0,0,0
"8155",2015-10-01,"sbiz","transporte não regular","voo doméstico",212,209,421,612,562,1174,0,0,0,0
"8156",2015-10-01,"sbiz","transporte não regular","voo internacional",0,0,0,0,0,0,0,0,0,0
"8157",2015-10-01,"sbjc","transporte regular","voo doméstico",0,0,0,0,0,0,0,0,0,0
"8158",2015-10-01,"sbjc","transporte regular","voo internacional",0,0,0,0,0,0,0,0,0,0
"8159",2015-10-01,"sbjc","transporte não regular","voo doméstico",423,420,843,938,719,1657,0,0,0,0
"8160",2015-10-01,"sbjc","transporte não regular","voo internacional",0,0,0,0,0,0,0,0,0,0
"8161",2015-10-01,"sbjr","transporte regular","voo doméstico",0,0,0,0,0,0,0,0,0,0
"8162",2015-10-01,"sbjr","transporte regular","voo internacional",0,0,0,0,0,0,0,0,0,0
"8163",2015-10-01,"sbjr","transporte não regular","voo doméstico",2623,2623,5246,9152,7413,16565,0,0,0,0
"8164",2015-10-01,"sbjr","transporte não regular","voo internacional",0,0,0,0,0,0,0,0,0,0
"8165",2015-10-01,"sbjv","transporte regular","voo doméstico",285,281,566,23298,22923,46221,0,0,0,0
"8166",2015-10-01,"sbjv","transporte regular","voo internacional",0,0,0,0,0,0,0,0,0,0
"8167",2015-10-01,"sbjv","transporte não regular","voo doméstico",106,111,217,97,501,598,0,0,0,0
"8168",2015-10-01,"sbjv","transporte não regular","voo internacional",0,0,0,0,0,0,0,0,0,0
"8169",2015-10-01,"sblo","transporte regular","voo doméstico",476,471,947,41603,41810,83413,0,0,0,0
"8170",2015-10-01,"sblo","transporte regular","voo internacional",0,0,0,0,0,0,0,0,0,0
"8171",2015-10-01,"sblo","transporte não regular","voo doméstico",686,687,1373,1645,1242,2887,0,0,0,0
"8172",2015-10-01,"sblo","transporte não regular","voo internacional",2,3,5,0,0,0,0,0,0,0
"8173",2015-10-01,"sbma","transporte regular","voo doméstico",235,236,471,14879,13922,28801,0,0,0,0
"8174",2015-10-01,"sbma","transporte regular","voo internacional",0,0,0,0,0,0,0,0,0,0
"8175",2015-10-01,"sbma","transporte não regular","voo doméstico",203,201,404,584,652,1236,0,0,0,0
"8176",2015-10-01,"sbma","transporte não regular","voo internacional",3,3,6,0,0,0,0,0,0,0
"8177",2015-10-01,"sbmk","transporte regular","voo doméstico",165,166,331,15315,14767,30082,0,0,0,0
"8178",2015-10-01,"sbmk","transporte regular","voo internacional",0,0,0,0,0,0,0,0,0,0
"8179",2015-10-01,"sbmk","transporte não regular","voo doméstico",365,364,729,117,65,182,0,0,0,0
"8180",2015-10-01,"sbmk","transporte não regular","voo internacional",0,0,0,0,0,0,0,0,0,0
"8181",2015-10-01,"sbmq","transporte regular","voo doméstico",231,229,460,25924,25542,51466,9007,33400,42407,0
"8182",2015-10-01,"sbmq","transporte regular","voo internacional",0,0,0,0,0,0,0,0,0,0
"8183",2015-10-01,"sbmq","transporte não regular","voo doméstico",177,177,354,356,372,728,0,0,0,0
"8184",2015-10-01,"sbmq","transporte não regular","voo internacional",6,6,12,0,0,0,0,0,0,0
"8185",2015-10-01,"sbmt","transporte regular","voo doméstico",0,0,0,0,0,0,0,0,0,0
"8186",2015-10-01,"sbmt","transporte regular","voo internacional",0,0,0,0,0,0,0,0,0,0
"8187",2015-10-01,"sbmt","transporte não regular","voo doméstico",4050,4078,8128,7187,7146,14333,0,0,0,0
"8188",2015-10-01,"sbmt","transporte não regular","voo internacional",0,0,0,0,0,0,0,0,0,0
"8189",2015-10-01,"sbnf","transporte regular","voo doméstico",649,649,1298,62150,64788,126938,0,0,0,0
"8190",2015-10-01,"sbnf","transporte regular","voo internacional",0,0,0,0,0,0,0,0,0,0
"8191",2015-10-01,"sbnf","transporte não regular","voo doméstico",205,200,405,2783,3144,5927,0,0,0,0
"8192",2015-10-01,"sbnf","transporte não regular","voo internacional",1,1,2,4,1,5,0,0,0,0
"8193",2015-10-01,"sbpb","transporte regular","voo doméstico",21,21,42,588,642,1230,0,0,0,0
"8194",2015-10-01,"sbpb","transporte regular","voo internacional",0,0,0,0,0,0,0,0,0,0
"8195",2015-10-01,"sbpb","transporte não regular","voo doméstico",78,72,150,176,181,357,0,0,0,0
"8196",2015-10-01,"sbpb","transporte não regular","voo internacional",0,0,0,0,0,0,0,0,0,0
"8197",2015-10-01,"sbpj","transporte regular","voo doméstico",376,377,753,27575,28188,55763,0,0,0,0
"8198",2015-10-01,"sbpj","transporte regular","voo internacional",0,0,0,0,0,0,0,0,0,0
"8199",2015-10-01,"sbpj","transporte não regular","voo doméstico",256,254,510,767,862,1629,0,0,0,0
"8200",2015-10-01,"sbpj","transporte não regular","voo internacional",2,2,4,0,0,0,0,0,0,0
"8201",2015-10-01,"sbpk","transporte regular","voo doméstico",53,52,105,2549,2504,5053,0,0,0,0
"8202",2015-10-01,"sbpk","transporte regular","voo internacional",0,0,0,0,0,0,0,0,0,0
"8203",2015-10-01,"sbpk","transporte não regular","voo doméstico",47,45,92,108,121,229,0,0,0,0
"8204",2015-10-01,"sbpk","transporte não regular","voo internacional",4,5,9,11,13,24,0,0,0,0
"8205",2015-10-01,"sbpl","transporte regular","voo doméstico",145,146,291,17746,17525,35271,0,0,0,0
"8206",2015-10-01,"sbpl","transporte regular","voo internacional",0,0,0,0,0,0,0,0,0,0
"8207",2015-10-01,"sbpl","transporte não regular","voo doméstico",61,61,122,93,82,175,0,0,0,0
"8208",2015-10-01,"sbpl","transporte não regular","voo internacional",5,5,10,0,0,0,0,0,0,0
"8209",2015-10-01,"sbpp","transporte regular","voo doméstico",0,0,0,0,0,0,0,0,0,0
"8210",2015-10-01,"sbpp","transporte regular","voo internacional",0,0,0,0,0,0,0,0,0,0
"8211",2015-10-01,"sbpp","transporte não regular","voo doméstico",58,60,118,95,71,166,0,0,0,0
"8212",2015-10-01,"sbpp","transporte não regular","voo internacional",9,10,19,7,4,11,0,0,0,0
"8213",2015-10-01,"sbpr","transporte regular","voo doméstico",0,0,0,0,0,0,0,0,0,0
"8214",2015-10-01,"sbpr","transporte regular","voo internacional",0,0,0,0,0,0,0,0,0,0
"8215",2015-10-01,"sbpr","transporte não regular","voo doméstico",921,928,1849,1097,951,2048,0,0,0,0
"8216",2015-10-01,"sbpr","transporte não regular","voo internacional",1,0,1,0,0,0,0,0,0,0
"8217",2015-10-01,"sbpv","transporte regular","voo doméstico",486,485,971,40712,38798,79510,0,0,0,0
"8218",2015-10-01,"sbpv","transporte regular","voo internacional",0,0,0,0,0,0,0,0,0,0
"8219",2015-10-01,"sbpv","transporte não regular","voo doméstico",275,273,548,90,20,110,0,0,0,0
"8220",2015-10-01,"sbpv","transporte não regular","voo internacional",0,0,0,0,0,0,0,0,0,0
"8221",2015-10-01,"sbrb","transporte regular","voo doméstico",171,172,343,17306,16472,33778,0,26,26,52
"8222",2015-10-01,"sbrb","transporte regular","voo internacional",0,0,0,0,0,0,0,0,0,0
"8223",2015-10-01,"sbrb","transporte não regular","voo doméstico",124,126,250,515,482,997,0,0,0,0
"8224",2015-10-01,"sbrb","transporte não regular","voo internacional",0,0,0,0,0,0,0,0,0,0
"8225",2015-10-01,"sbrj","transporte regular","voo doméstico",4258,4293,8551,393615,389536,783151,0,0,0,0
"8226",2015-10-01,"sbrj","transporte regular","voo internacional",0,0,0,0,0,0,0,0,0,0
"8227",2015-10-01,"sbrj","transporte não regular","voo doméstico",652,622,1274,901,3442,4343,0,0,0,0
"8228",2015-10-01,"sbrj","transporte não regular","voo internacional",0,0,0,0,0,0,0,0,0,0
"8229",2015-10-01,"sbsj","transporte regular","voo doméstico",26,27,53,2516,2634,5150,0,0,0,0
"8230",2015-10-01,"sbsj","transporte regular","voo internacional",0,0,0,0,0,0,0,0,0,0
"8231",2015-10-01,"sbsj","transporte não regular","voo doméstico",600,582,1182,2452,2336,4788,0,0,0,0
"8232",2015-10-01,"sbsj","transporte não regular","voo internacional",2,16,18,25,3,28,0,0,0,0
"8233",2015-10-01,"sbsl","transporte regular","voo doméstico",766,766,1532,60948,63947,124895,70,0,70,0
"8234",2015-10-01,"sbsl","transporte regular","voo internacional",0,0,0,0,0,0,0,0,0,0
"8235",2015-10-01,"sbsl","transporte não regular","voo doméstico",303,308,611,1363,1135,2498,74550,201133,275683,3483
"8236",2015-10-01,"sbsl","transporte não regular","voo internacional",0,0,0,0,0,0,0,0,0,0
"8237",2015-10-01,"sbsn","transporte regular","voo doméstico",407,407,814,32277,31132,63409,0,1824,1824,0
"8238",2015-10-01,"sbsn","transporte regular","voo internacional",0,0,0,0,0,0,0,0,0,0
"8239",2015-10-01,"sbsn","transporte não regular","voo doméstico",376,379,755,993,704,1697,744,5328,6072,0
"8240",2015-10-01,"sbsn","transporte não regular","voo internacional",1,1,2,0,0,0,0,0,0,0
"8241",2015-10-01,"sbsp","transporte regular","voo doméstico",7246,7308,14554,819763,806914,1626677,0,0,0,0
"8242",2015-10-01,"sbsp","transporte regular","voo internacional",0,0,0,0,0,0,0,0,0,0
"8243",2015-10-01,"sbsp","transporte não regular","voo doméstico",1868,1828,3696,12776,11840,24616,0,0,0,0
"8244",2015-10-01,"sbsp","transporte não regular","voo internacional",0,0,0,0,0,0,0,0,0,0
"8245",2015-10-01,"sbte","transporte regular","voo doméstico",563,564,1127,46597,45266,91863,27545,76754,104299,274873
"8246",2015-10-01,"sbte","transporte regular","voo internacional",0,0,0,0,0,0,0,0,0,0
"8247",2015-10-01,"sbte","transporte não regular","voo doméstico",266,276,542,1716,1604,3320,0,0,0,0
"8248",2015-10-01,"sbte","transporte não regular","voo internacional",0,0,0,0,0,0,0,0,0,0
"8249",2015-10-01,"sbtf","transporte regular","voo doméstico",45,44,89,2107,2159,4266,0,0,0,0
"8250",2015-10-01,"sbtf","transporte regular","voo internacional",0,0,0,0,0,0,0,0,0,0
"8251",2015-10-01,"sbtf","transporte não regular","voo doméstico",160,159,319,263,269,532,2000,39,2039,16359
"8252",2015-10-01,"sbtf","transporte não regular","voo internacional",0,0,0,0,0,0,0,0,0,0
"8253",2015-10-01,"sbtt","transporte regular","voo doméstico",32,33,65,2254,2525,4779,0,0,0,0
"8254",2015-10-01,"sbtt","transporte regular","voo internacional",0,0,0,0,0,0,0,0,0,0
"8255",2015-10-01,"sbtt","transporte não regular","voo doméstico",93,93,186,412,413,825,1063,3272,4335,614
"8256",2015-10-01,"sbtt","transporte não regular","voo internacional",2,1,3,2,4,6,0,0,0,0
"8257",2015-10-01,"sbuf","transporte regular","voo doméstico",17,17,34,812,727,1539,0,0,0,0
"8258",2015-10-01,"sbuf","transporte regular","voo internacional",0,0,0,0,0,0,0,0,0,0
"8259",2015-10-01,"sbuf","transporte não regular","voo doméstico",31,29,60,83,74,157,0,0,0,0
"8260",2015-10-01,"sbuf","transporte não regular","voo internacional",0,0,0,0,0,0,0,0,0,0
"8261",2015-10-01,"sbug","transporte regular","voo doméstico",3,3,6,187,195,382,0,0,0,0
"8262",2015-10-01,"sbug","transporte regular","voo internacional",0,0,0,0,0,0,0,0,0,0
"8263",2015-10-01,"sbug","transporte não regular","voo doméstico",18,18,36,44,48,92,0,0,0,0
"8264",2015-10-01,"sbug","transporte não regular","voo internacional",0,0,0,0,0,0,0,0,0,0
"8265",2015-10-01,"sbul","transporte regular","voo doméstico",580,580,1160,50457,49193,99650,0,0,0,0
"8266",2015-10-01,"sbul","transporte regular","voo internacional",0,0,0,0,0,0,0,0,0,0
"8267",2015-10-01,"sbul","transporte não regular","voo doméstico",522,524,1046,1291,1087,2378,0,0,0,0
"8268",2015-10-01,"sbul","transporte não regular","voo internacional",2,2,4,16,12,28,0,0,0,0
"8269",2015-10-01,"sbur","transporte regular","voo doméstico",109,109,218,5452,5249,10701,0,0,0,0
"8270",2015-10-01,"sbur","transporte regular","voo internacional",0,0,0,0,0,0,0,0,0,0
"8271",2015-10-01,"sbur","transporte não regular","voo doméstico",139,142,281,463,555,1018,0,0,0,0
"8272",2015-10-01,"sbur","transporte não regular","voo internacional",0,0,0,0,0,0,0,0,0,0
"8273",2015-09-01,"sbbe","transporte regular","voo doméstico",1511,1510,3021,143034,139960,282994,12722,46977,59699,0
"8274",2015-09-01,"sbbe","transporte regular","voo internacional",60,62,122,5270,4701,9971,0,2,2,0
"8275",2015-09-01,"sbbe","transporte não regular","voo doméstico",479,477,956,2072,1997,4069,0,0,0,0
"8276",2015-09-01,"sbbe","transporte não regular","voo internacional",10,13,23,122,71,193,0,0,0,0
"8277",2015-09-01,"sbbg","transporte regular","voo doméstico",0,0,0,0,0,0,0,0,0,0
"8278",2015-09-01,"sbbg","transporte regular","voo internacional",0,0,0,0,0,0,0,0,0,0
"8279",2015-09-01,"sbbg","transporte não regular","voo doméstico",15,16,31,76,61,137,0,0,0,0
"8280",2015-09-01,"sbbg","transporte não regular","voo internacional",3,2,5,1,3,4,0,0,0,0
"8281",2015-09-01,"sbbh","transporte regular","voo doméstico",285,291,576,15573,14257,29830,0,0,0,0
"8282",2015-09-01,"sbbh","transporte regular","voo internacional",0,0,0,0,0,0,0,0,0,0
"8283",2015-09-01,"sbbh","transporte não regular","voo doméstico",1828,1826,3654,8003,8226,16229,0,0,0,0
"8284",2015-09-01,"sbbh","transporte não regular","voo internacional",2,1,3,7,12,19,0,0,0,0
"8285",2015-09-01,"sbbi","transporte regular","voo doméstico",0,0,0,0,0,0,0,0,0,0
"8286",2015-09-01,"sbbi","transporte regular","voo internacional",0,0,0,0,0,0,0,0,0,0
"8287",2015-09-01,"sbbi","transporte não regular","voo doméstico",927,928,1855,4418,4416,8834,0,0,0,0
"8288",2015-09-01,"sbbi","transporte não regular","voo internacional",2,2,4,0,0,0,0,0,0,0
"8289",2015-09-01,"sbbv","transporte regular","voo doméstico",102,102,204,13422,13310,26732,0,0,0,0
"8290",2015-09-01,"sbbv","transporte regular","voo internacional",0,0,0,0,0,0,0,0,0,0
"8291",2015-09-01,"sbbv","transporte não regular","voo doméstico",254,252,506,150,49,199,0,0,0,0
"8292",2015-09-01,"sbbv","transporte não regular","voo internacional",14,11,25,0,2,2,0,0,0,0
"8293",2015-09-01,"sbcg","transporte regular","voo doméstico",651,649,1300,62127,60030,122157,66224,147823,214047,0
"8294",2015-09-01,"sbcg","transporte regular","voo internacional",3,3,6,20,43,63,0,0,0,0
"8295",2015-09-01,"sbcg","transporte não regular","voo doméstico",268,272,540,202,660,862,0,6834,6834,0
"8296",2015-09-01,"sbcg","transporte não regular","voo internacional",13,13,26,58,52,110,0,0,0,0
"8297",2015-09-01,"sbcj","transporte regular","voo doméstico",106,107,213,7430,7767,15197,0,0,0,0
"8298",2015-09-01,"sbcj","transporte regular","voo internacional",0,0,0,0,0,0,0,0,0,0
"8299",2015-09-01,"sbcj","transporte não regular","voo doméstico",70,70,140,190,77,267,0,0,0,0
"8300",2015-09-01,"sbcj","transporte não regular","voo internacional",0,0,0,0,0,0,0,0,0,0
"8301",2015-09-01,"sbcr","transporte regular","voo doméstico",15,15,30,1297,1203,2500,0,0,0,0
"8302",2015-09-01,"sbcr","transporte regular","voo internacional",0,0,0,0,0,0,0,0,0,0
"8303",2015-09-01,"sbcr","transporte não regular","voo doméstico",46,46,92,123,102,225,0,0,0,0
"8304",2015-09-01,"sbcr","transporte não regular","voo internacional",4,5,9,10,4,14,0,0,0,0
"8305",2015-09-01,"sbct","transporte regular","voo doméstico",2884,2903,5787,294423,288827,583250,115876,0,115876,137699
"8306",2015-09-01,"sbct","transporte regular","voo internacional",102,103,205,5710,5619,11329,0,418,418,0
"8307",2015-09-01,"sbct","transporte não regular","voo doméstico",223,201,424,2310,3836,6146,0,0,0,0
"8308",2015-09-01,"sbct","transporte não regular","voo internacional",6,8,14,26,34,60,0,0,0,0
"8309",2015-09-01,"sbcz","transporte regular","voo doméstico",31,30,61,3166,3078,6244,0,0,0,0
"8310",2015-09-01,"sbcz","transporte regular","voo internacional",0,0,0,0,0,0,0,0,0,0
"8311",2015-09-01,"sbcz","transporte não regular","voo doméstico",199,198,397,750,678,1428,0,0,0,0
"8312",2015-09-01,"sbcz","transporte não regular","voo internacional",1,1,2,0,0,0,0,0,0,0
"8313",2015-09-01,"sbeg","transporte regular","voo doméstico",1160,1151,2311,120668,117654,238322,0,0,0,0
"8314",2015-09-01,"sbeg","transporte regular","voo internacional",140,144,284,8026,7767,15793,0,0,0,0
"8315",2015-09-01,"sbeg","transporte não regular","voo doméstico",597,601,1198,5501,4469,9970,0,0,0,0
"8316",2015-09-01,"sbeg","transporte não regular","voo internacional",72,73,145,1793,1542,3335,0,0,0,0
"8317",2015-09-01,"sbfi","transporte regular","voo doméstico",626,627,1253,78723,77268,155991,0,0,0,0
"8318",2015-09-01,"sbfi","transporte regular","voo internacional",21,21,42,2727,2720,5447,0,0,0,0
"8319",2015-09-01,"sbfi","transporte não regular","voo doméstico",157,157,314,979,1724,2703,0,0,0,0
"8320",2015-09-01,"sbfi","transporte não regular","voo internacional",32,32,64,88,96,184,0,0,0,0
"8321",2015-09-01,"sbgo","transporte regular","voo doméstico",1361,1366,2727,129913,126377,256290,162099,176755,338854,183540
"8322",2015-09-01,"sbgo","transporte regular","voo internacional",0,0,0,0,0,0,0,0,0,0
"8323",2015-09-01,"sbgo","transporte não regular","voo doméstico",1492,1499,2991,5030,5778,10808,0,0,0,0
"8324",2015-09-01,"sbgo","transporte não regular","voo internacional",1,2,3,0,0,0,0,0,0,0
"8325",2015-09-01,"sbht","transporte regular","voo doméstico",225,225,450,11612,11425,23037,0,0,0,0
"8326",2015-09-01,"sbht","transporte regular","voo internacional",0,0,0,0,0,0,0,0,0,0
"8327",2015-09-01,"sbht","transporte não regular","voo doméstico",203,200,403,658,506,1164,250,380,630,170
"8328",2015-09-01,"sbht","transporte não regular","voo internacional",0,0,0,0,0,0,0,0,0,0
"8329",2015-09-01,"sbiz","transporte regular","voo doméstico",230,231,461,12778,12317,25095,0,0,0,0
"8330",2015-09-01,"sbiz","transporte regular","voo internacional",0,0,0,0,0,0,0,0,0,0
"8331",2015-09-01,"sbiz","transporte não regular","voo doméstico",137,134,271,400,375,775,0,0,0,0
"8332",2015-09-01,"sbiz","transporte não regular","voo internacional",0,0,0,0,0,0,0,0,0,0
"8333",2015-09-01,"sbjc","transporte regular","voo doméstico",0,0,0,0,0,0,0,0,0,0
"8334",2015-09-01,"sbjc","transporte regular","voo internacional",0,0,0,0,0,0,0,0,0,0
"8335",2015-09-01,"sbjc","transporte não regular","voo doméstico",417,420,837,936,800,1736,0,0,0,0
"8336",2015-09-01,"sbjc","transporte não regular","voo internacional",0,0,0,0,0,0,0,0,0,0
"8337",2015-09-01,"sbjr","transporte regular","voo doméstico",0,0,0,0,0,0,0,0,0,0
"8338",2015-09-01,"sbjr","transporte regular","voo internacional",0,0,0,0,0,0,0,0,0,0
"8339",2015-09-01,"sbjr","transporte não regular","voo doméstico",2631,2636,5267,9049,7411,16460,0,0,0,0
"8340",2015-09-01,"sbjr","transporte não regular","voo internacional",0,0,0,0,0,0,0,0,0,0
"8341",2015-09-01,"sbjv","transporte regular","voo doméstico",257,256,513,21413,20027,41440,0,0,0,0
"8342",2015-09-01,"sbjv","transporte regular","voo internacional",0,0,0,0,0,0,0,0,0,0
"8343",2015-09-01,"sbjv","transporte não regular","voo doméstico",196,197,393,105,476,581,0,0,0,0
"8344",2015-09-01,"sbjv","transporte não regular","voo internacional",2,2,4,4,4,8,0,0,0,0
"8345",2015-09-01,"sblo","transporte regular","voo doméstico",438,403,841,38396,39268,77664,0,0,0,0
"8346",2015-09-01,"sblo","transporte regular","voo internacional",0,0,0,0,0,0,0,0,0,0
"8347",2015-09-01,"sblo","transporte não regular","voo doméstico",745,780,1525,4962,2526,7488,0,0,0,0
"8348",2015-09-01,"sblo","transporte não regular","voo internacional",1,0,1,0,0,0,0,0,0,0
"8349",2015-09-01,"sbma","transporte regular","voo doméstico",229,229,458,15568,15050,30618,0,0,0,0
"8350",2015-09-01,"sbma","transporte regular","voo internacional",0,0,0,0,0,0,0,0,0,0
"8351",2015-09-01,"sbma","transporte não regular","voo doméstico",231,239,470,643,688,1331,0,0,0,0
"8352",2015-09-01,"sbma","transporte não regular","voo internacional",1,1,2,0,0,0,0,0,0,0
"8353",2015-09-01,"sbmk","transporte regular","voo doméstico",159,158,317,14166,13954,28120,0,0,0,0
"8354",2015-09-01,"sbmk","transporte regular","voo internacional",0,0,0,0,0,0,0,0,0,0
"8355",2015-09-01,"sbmk","transporte não regular","voo doméstico",255,256,511,0,99,99,0,0,0,0
"8356",2015-09-01,"sbmk","transporte não regular","voo internacional",0,0,0,0,0,0,0,0,0,0
"8357",2015-09-01,"sbmq","transporte regular","voo doméstico",247,248,495,27150,26674,53824,17865,27375,45240,0
"8358",2015-09-01,"sbmq","transporte regular","voo internacional",0,0,0,0,0,0,0,0,0,0
"8359",2015-09-01,"sbmq","transporte não regular","voo doméstico",159,155,314,223,62,285,0,0,0,0
"8360",2015-09-01,"sbmq","transporte não regular","voo internacional",4,5,9,0,0,0,0,0,0,0
"8361",2015-09-01,"sbmt","transporte regular","voo doméstico",0,0,0,0,0,0,0,0,0,0
"8362",2015-09-01,"sbmt","transporte regular","voo internacional",0,0,0,0,0,0,0,0,0,0
"8363",2015-09-01,"sbmt","transporte não regular","voo doméstico",3487,3488,6975,5973,5953,11926,0,0,0,0
"8364",2015-09-01,"sbmt","transporte não regular","voo internacional",0,0,0,0,0,0,0,0,0,0
"8365",2015-09-01,"sbnf","transporte regular","voo doméstico",642,639,1281,59070,59272,118342,0,0,0,0
"8366",2015-09-01,"sbnf","transporte regular","voo internacional",0,0,0,0,0,0,0,0,0,0
"8367",2015-09-01,"sbnf","transporte não regular","voo doméstico",213,212,425,1201,2307,3508,0,0,0,0
"8368",2015-09-01,"sbnf","transporte não regular","voo internacional",3,3,6,9,9,18,0,0,0,0
"8369",2015-09-01,"sbpb","transporte regular","voo doméstico",18,19,37,634,537,1171,0,0,0,0
"8370",2015-09-01,"sbpb","transporte regular","voo internacional",0,0,0,0,0,0,0,0,0,0
"8371",2015-09-01,"sbpb","transporte não regular","voo doméstico",77,77,154,231,238,469,0,0,0,0
"8372",2015-09-01,"sbpb","transporte não regular","voo internacional",0,0,0,0,0,0,0,0,0,0
"8373",2015-09-01,"sbpj","transporte regular","voo doméstico",327,327,654,25256,24696,49952,0,0,0,0
"8374",2015-09-01,"sbpj","transporte regular","voo internacional",0,0,0,0,0,0,0,0,0,0
"8375",2015-09-01,"sbpj","transporte não regular","voo doméstico",273,275,548,718,374,1092,0,0,0,0
"8376",2015-09-01,"sbpj","transporte não regular","voo internacional",2,2,4,0,0,0,0,0,0,0
"8377",2015-09-01,"sbpk","transporte regular","voo doméstico",48,48,96,2023,2110,4133,0,0,0,0
"8378",2015-09-01,"sbpk","transporte regular","voo internacional",0,0,0,0,0,0,0,0,0,0
"8379",2015-09-01,"sbpk","transporte não regular","voo doméstico",27,26,53,53,52,105,0,0,0,0
"8380",2015-09-01,"sbpk","transporte não regular","voo internacional",1,1,2,0,0,0,0,0,0,0
"8381",2015-09-01,"sbpl","transporte regular","voo doméstico",142,142,284,17439,17457,34896,0,0,0,0
"8382",2015-09-01,"sbpl","transporte regular","voo internacional",3,3,6,0,0,0,0,0,0,0
"8383",2015-09-01,"sbpl","transporte não regular","voo doméstico",76,76,152,103,115,218,0,0,0,0
"8384",2015-09-01,"sbpl","transporte não regular","voo internacional",3,3,6,2,2,4,0,0,0,0
"8385",2015-09-01,"sbpp","transporte regular","voo doméstico",0,0,0,0,0,0,0,0,0,0
"8386",2015-09-01,"sbpp","transporte regular","voo internacional",0,0,0,0,0,0,0,0,0,0
"8387",2015-09-01,"sbpp","transporte não regular","voo doméstico",67,61,128,92,110,202,0,0,0,0
"8388",2015-09-01,"sbpp","transporte não regular","voo internacional",4,5,9,3,1,4,0,0,0,0
"8389",2015-09-01,"sbpr","transporte regular","voo doméstico",0,0,0,0,0,0,0,0,0,0
"8390",2015-09-01,"sbpr","transporte regular","voo internacional",0,0,0,0,0,0,0,0,0,0
"8391",2015-09-01,"sbpr","transporte não regular","voo doméstico",914,925,1839,1212,1030,2242,0,0,0,0
"8392",2015-09-01,"sbpr","transporte não regular","voo internacional",0,0,0,0,0,0,0,0,0,0
"8393",2015-09-01,"sbpv","transporte regular","voo doméstico",476,478,954,40006,38325,78331,0,0,0,0
"8394",2015-09-01,"sbpv","transporte regular","voo internacional",0,0,0,0,0,0,0,0,0,0
"8395",2015-09-01,"sbpv","transporte não regular","voo doméstico",246,243,489,0,0,0,0,0,0,0
"8396",2015-09-01,"sbpv","transporte não regular","voo internacional",0,0,0,0,0,0,0,0,0,0
"8397",2015-09-01,"sbrb","transporte regular","voo doméstico",174,173,347,16095,16198,32293,0,17,17,91
"8398",2015-09-01,"sbrb","transporte regular","voo internacional",0,0,0,0,0,0,0,0,0,0
"8399",2015-09-01,"sbrb","transporte não regular","voo doméstico",135,135,270,190,119,309,0,0,0,0
"8400",2015-09-01,"sbrb","transporte não regular","voo internacional",2,2,4,0,0,0,0,0,0,0
"8401",2015-09-01,"sbrj","transporte regular","voo doméstico",4140,4194,8334,393995,387376,781371,0,0,0,0
"8402",2015-09-01,"sbrj","transporte regular","voo internacional",0,0,0,0,0,0,0,0,0,0
"8403",2015-09-01,"sbrj","transporte não regular","voo doméstico",772,721,1493,1842,5025,6867,0,0,0,0
"8404",2015-09-01,"sbrj","transporte não regular","voo internacional",0,2,2,0,0,0,0,0,0,0
"8405",2015-09-01,"sbsj","transporte regular","voo doméstico",26,25,51,2584,2738,5322,0,0,0,0
"8406",2015-09-01,"sbsj","transporte regular","voo internacional",0,0,0,0,0,0,0,0,0,0
"8407",2015-09-01,"sbsj","transporte não regular","voo doméstico",500,477,977,1328,1429,2757,0,0,0,0
"8408",2015-09-01,"sbsj","transporte não regular","voo internacional",2,10,12,18,11,29,0,0,0,0
"8409",2015-09-01,"sbsl","transporte regular","voo doméstico",730,729,1459,65882,66970,132852,0,65,65,0
"8410",2015-09-01,"sbsl","transporte regular","voo internacional",0,0,0,0,0,0,0,0,0,0
"8411",2015-09-01,"sbsl","transporte não regular","voo doméstico",327,326,653,605,556,1161,60574,172003,232577,0
"8412",2015-09-01,"sbsl","transporte não regular","voo internacional",1,1,2,0,0,0,0,0,0,0
"8413",2015-09-01,"sbsn","transporte regular","voo doméstico",412,411,823,32180,31237,63417,0,0,0,1678
"8414",2015-09-01,"sbsn","transporte regular","voo internacional",0,0,0,0,0,0,0,0,0,0
"8415",2015-09-01,"sbsn","transporte não regular","voo doméstico",347,346,693,735,551,1286,0,120,120,0
"8416",2015-09-01,"sbsn","transporte não regular","voo internacional",2,2,4,0,0,0,0,0,0,0
"8417",2015-09-01,"sbsp","transporte regular","voo doméstico",7021,7092,14113,768665,764705,1533370,0,0,0,0
"8418",2015-09-01,"sbsp","transporte regular","voo internacional",0,0,0,0,0,0,0,0,0,0
"8419",2015-09-01,"sbsp","transporte não regular","voo doméstico",1795,1722,3517,7992,6755,14747,0,0,0,0
"8420",2015-09-01,"sbsp","transporte não regular","voo internacional",0,0,0,0,0,0,0,0,0,0
"8421",2015-09-01,"sbte","transporte regular","voo doméstico",543,542,1085,45194,45024,90218,19390,69362,88752,207429
"8422",2015-09-01,"sbte","transporte regular","voo internacional",0,0,0,0,0,0,0,0,0,0
"8423",2015-09-01,"sbte","transporte não regular","voo doméstico",239,238,477,1373,1279,2652,0,0,0,0
"8424",2015-09-01,"sbte","transporte não regular","voo internacional",0,0,0,0,0,0,0,0,0,0
"8425",2015-09-01,"sbtf","transporte regular","voo doméstico",26,26,52,2109,2143,4252,0,0,0,0
"8426",2015-09-01,"sbtf","transporte regular","voo internacional",0,0,0,0,0,0,0,0,0,0
"8427",2015-09-01,"sbtf","transporte não regular","voo doméstico",161,160,321,381,291,672,2187,75,2262,14167
"8428",2015-09-01,"sbtf","transporte não regular","voo internacional",2,2,4,0,0,0,0,0,0,0
"8429",2015-09-01,"sbtt","transporte regular","voo doméstico",31,30,61,2010,2428,4438,0,0,0,0
"8430",2015-09-01,"sbtt","transporte regular","voo internacional",0,0,0,0,0,0,0,0,0,0
"8431",2015-09-01,"sbtt","transporte não regular","voo doméstico",101,98,199,512,440,952,910,2638,3548,368
"8432",2015-09-01,"sbtt","transporte não regular","voo internacional",1,3,4,4,1,5,0,0,0,0
"8433",2015-09-01,"sbuf","transporte regular","voo doméstico",15,15,30,760,633,1393,0,0,0,0
"8434",2015-09-01,"sbuf","transporte regular","voo internacional",0,0,0,0,0,0,0,0,0,0
"8435",2015-09-01,"sbuf","transporte não regular","voo doméstico",42,43,85,221,200,421,0,0,0,0
"8436",2015-09-01,"sbuf","transporte não regular","voo internacional",0,0,0,0,0,0,0,0,0,0
"8437",2015-09-01,"sbug","transporte regular","voo doméstico",0,0,0,0,0,0,0,0,0,0
"8438",2015-09-01,"sbug","transporte regular","voo internacional",0,0,0,0,0,0,0,0,0,0
"8439",2015-09-01,"sbug","transporte não regular","voo doméstico",10,9,19,21,24,45,0,0,0,0
"8440",2015-09-01,"sbug","transporte não regular","voo internacional",0,0,0,0,0,0,0,0,0,0
"8441",2015-09-01,"sbul","transporte regular","voo doméstico",564,562,1126,44854,45522,90376,0,0,0,0
"8442",2015-09-01,"sbul","transporte regular","voo internacional",0,0,0,0,0,0,0,0,0,0
"8443",2015-09-01,"sbul","transporte não regular","voo doméstico",593,601,1194,1124,1023,2147,0,0,0,0
"8444",2015-09-01,"sbul","transporte não regular","voo internacional",0,0,0,0,0,0,0,0,0,0
"8445",2015-09-01,"sbur","transporte regular","voo doméstico",105,107,212,5083,5192,10275,0,0,0,0
"8446",2015-09-01,"sbur","transporte regular","voo internacional",0,0,0,0,0,0,0,0,0,0
"8447",2015-09-01,"sbur","transporte não regular","voo doméstico",211,204,415,731,885,1616,0,0,0,0
"8448",2015-09-01,"sbur","transporte não regular","voo internacional",0,0,0,0,0,0,0,0,0,0
"8449",2016-04-01,"sbbe","transporte regular","voo doméstico",1003,999,2002,106041,104124,210165,3855,16173,20028,0
"8450",2016-04-01,"sbbe","transporte regular","voo internacional",56,55,111,5286,4633,9919,0,3,3,0
"8451",2016-04-01,"sbbe","transporte não regular","voo doméstico",375,379,754,2432,2311,4743,0,0,0,0
"8452",2016-04-01,"sbbe","transporte não regular","voo internacional",12,13,25,155,111,266,0,0,0,0
"8453",2016-04-01,"sbbg","transporte regular","voo doméstico",0,0,0,0,0,0,0,0,0,0
"8454",2016-04-01,"sbbg","transporte regular","voo internacional",0,0,0,0,0,0,0,0,0,0
"8455",2016-04-01,"sbbg","transporte não regular","voo doméstico",20,19,39,107,87,194,0,0,0,0
"8456",2016-04-01,"sbbg","transporte não regular","voo internacional",1,2,3,6,6,12,0,0,0,0
"8457",2016-04-01,"sbbh","transporte regular","voo doméstico",164,166,330,5453,5066,10519,0,0,0,0
"8458",2016-04-01,"sbbh","transporte regular","voo internacional",0,0,0,0,0,0,0,0,0,0
"8459",2016-04-01,"sbbh","transporte não regular","voo doméstico",1641,1634,3275,7201,7159,14360,0,0,0,0
"8460",2016-04-01,"sbbh","transporte não regular","voo internacional",5,5,10,23,23,46,0,0,0,0
"8461",2016-04-01,"sbbi","transporte regular","voo doméstico",0,0,0,0,0,0,0,0,0,0
"8462",2016-04-01,"sbbi","transporte regular","voo internacional",0,0,0,0,0,0,0,0,0,0
"8463",2016-04-01,"sbbi","transporte não regular","voo doméstico",1245,1225,2470,4938,4916,9854,0,0,0,0
"8464",2016-04-01,"sbbi","transporte não regular","voo internacional",0,0,0,0,0,0,0,0,0,0
"8465",2016-04-01,"sbbv","transporte regular","voo doméstico",91,91,182,11216,11180,22396,0,0,0,0
"8466",2016-04-01,"sbbv","transporte regular","voo internacional",0,0,0,0,0,0,0,0,0,0
"8467",2016-04-01,"sbbv","transporte não regular","voo doméstico",134,131,265,83,84,167,0,0,0,0
"8468",2016-04-01,"sbbv","transporte não regular","voo internacional",6,11,17,0,0,0,0,0,0,0
"8469",2016-04-01,"sbcg","transporte regular","voo doméstico",549,548,1097,56289,54185,110474,62518,155288,217806,0
"8470",2016-04-01,"sbcg","transporte regular","voo internacional",0,0,0,0,0,0,0,0,0,0
"8471",2016-04-01,"sbcg","transporte não regular","voo doméstico",225,226,451,416,474,890,0,0,0,0
"8472",2016-04-01,"sbcg","transporte não regular","voo internacional",8,8,16,0,0,0,0,0,0,0
"8473",2016-04-01,"sbcj","transporte regular","voo doméstico",59,59,118,5914,5846,11760,0,0,0,0
"8474",2016-04-01,"sbcj","transporte regular","voo internacional",0,0,0,0,0,0,0,0,0,0
"8475",2016-04-01,"sbcj","transporte não regular","voo doméstico",96,99,195,149,201,350,0,0,0,0
"8476",2016-04-01,"sbcj","transporte não regular","voo internacional",1,1,2,0,0,0,0,0,0,0
"8477",2016-04-01,"sbcr","transporte regular","voo doméstico",17,17,34,1312,1301,2613,0,0,0,0
"8478",2016-04-01,"sbcr","transporte regular","voo internacional",0,0,0,0,0,0,0,0,0,0
"8479",2016-04-01,"sbcr","transporte não regular","voo doméstico",38,40,78,95,72,167,0,0,0,0
"8480",2016-04-01,"sbcr","transporte não regular","voo internacional",5,5,10,15,10,25,0,0,0,0
"8481",2016-04-01,"sbct","transporte regular","voo doméstico",2361,2357,4718,253854,248803,502657,133036,0,133036,138110
"8482",2016-04-01,"sbct","transporte regular","voo internacional",56,55,111,1428,1477,2905,0,7106,7106,0
"8483",2016-04-01,"sbct","transporte não regular","voo doméstico",188,200,388,1187,1026,2213,0,0,0,0
"8484",2016-04-01,"sbct","transporte não regular","voo internacional",7,6,13,12,8,20,0,0,0,0
"8485",2016-04-01,"sbcz","transporte regular","voo doméstico",28,28,56,2525,2426,4951,0,0,0,0
"8486",2016-04-01,"sbcz","transporte regular","voo internacional",0,0,0,0,0,0,0,0,0,0
"8487",2016-04-01,"sbcz","transporte não regular","voo doméstico",137,136,273,514,519,1033,0,0,0,0
"8488",2016-04-01,"sbcz","transporte não regular","voo internacional",2,2,4,0,0,0,0,0,0,0
"8489",2016-04-01,"sbeg","transporte regular","voo doméstico",856,848,1704,91678,82107,173785,0,0,0,0
"8490",2016-04-01,"sbeg","transporte regular","voo internacional",87,89,176,3197,3499,6696,0,0,0,54615
"8491",2016-04-01,"sbeg","transporte não regular","voo doméstico",423,424,847,6532,5384,11916,0,0,0,0
"8492",2016-04-01,"sbeg","transporte não regular","voo internacional",79,78,157,446,486,932,0,0,0,0
"8493",2016-04-01,"sbfi","transporte regular","voo doméstico",525,516,1041,62752,63292,126044,0,0,0,0
"8494",2016-04-01,"sbfi","transporte regular","voo internacional",21,21,42,2593,2010,4603,0,0,0,0
"8495",2016-04-01,"sbfi","transporte não regular","voo doméstico",149,157,306,3075,3417,6492,0,0,0,0
"8496",2016-04-01,"sbfi","transporte não regular","voo internacional",56,50,106,191,118,309,0,0,0,0
"8497",2016-04-01,"sbgo","transporte regular","voo doméstico",1181,1185,2366,117253,115215,232468,230713,169818,400531,159502
"8498",2016-04-01,"sbgo","transporte regular","voo internacional",0,0,0,0,1,1,0,0,0,0
"8499",2016-04-01,"sbgo","transporte não regular","voo doméstico",1302,1305,2607,3933,3695,7628,0,0,0,0
"8500",2016-04-01,"sbgo","transporte não regular","voo internacional",1,1,2,0,0,0,0,0,0,0
"8501",2016-04-01,"sbht","transporte regular","voo doméstico",139,139,278,6359,6001,12360,0,0,0,0
"8502",2016-04-01,"sbht","transporte regular","voo internacional",0,0,0,0,0,0,0,0,0,0
"8503",2016-04-01,"sbht","transporte não regular","voo doméstico",145,146,291,637,690,1327,100,0,100,0
"8504",2016-04-01,"sbht","transporte não regular","voo internacional",0,0,0,0,0,0,0,0,0,0
"8505",2016-04-01,"sbiz","transporte regular","voo doméstico",128,129,257,10737,10536,21273,0,0,0,0
"8506",2016-04-01,"sbiz","transporte regular","voo internacional",0,0,0,0,0,0,0,0,0,0
"8507",2016-04-01,"sbiz","transporte não regular","voo doméstico",81,83,164,213,198,411,0,0,0,0
"8508",2016-04-01,"sbiz","transporte não regular","voo internacional",1,1,2,0,0,0,0,0,0,0
"8509",2016-04-01,"sbjc","transporte regular","voo doméstico",0,0,0,0,0,0,0,0,0,0
"8510",2016-04-01,"sbjc","transporte regular","voo internacional",0,0,0,0,0,0,0,0,0,0
"8511",2016-04-01,"sbjc","transporte não regular","voo doméstico",322,325,647,582,389,971,0,0,0,0
"8512",2016-04-01,"sbjc","transporte não regular","voo internacional",0,0,0,0,0,0,0,0,0,0
"8513",2016-04-01,"sbjr","transporte regular","voo doméstico",0,0,0,0,0,0,0,0,0,0
"8514",2016-04-01,"sbjr","transporte regular","voo internacional",0,0,0,0,0,0,0,0,0,0
"8515",2016-04-01,"sbjr","transporte não regular","voo doméstico",2663,2672,5335,10229,8120,18349,0,0,0,0
"8516",2016-04-01,"sbjr","transporte não regular","voo internacional",0,0,0,0,0,0,0,0,0,0
"8517",2016-04-01,"sbjv","transporte regular","voo doméstico",235,236,471,18728,19018,37746,0,0,0,0
"8518",2016-04-01,"sbjv","transporte regular","voo internacional",0,0,0,0,5,5,0,0,0,0
"8519",2016-04-01,"sbjv","transporte não regular","voo doméstico",127,126,253,126,95,221,0,0,0,0
"8520",2016-04-01,"sbjv","transporte não regular","voo internacional",1,1,2,0,0,0,0,0,0,0
"8521",2016-04-01,"sblo","transporte regular","voo doméstico",404,401,805,36102,35674,71776,0,0,0,0
"8522",2016-04-01,"sblo","transporte regular","voo internacional",0,0,0,0,0,0,0,0,0,0
"8523",2016-04-01,"sblo","transporte não regular","voo doméstico",694,698,1392,275,75,350,0,0,0,0
"8524",2016-04-01,"sblo","transporte não regular","voo internacional",4,4,8,0,0,0,0,0,0,0
"8525",2016-04-01,"sbma","transporte regular","voo doméstico",132,133,265,11741,11317,23058,0,0,0,0
"8526",2016-04-01,"sbma","transporte regular","voo internacional",0,0,0,0,0,0,0,0,0,0
"8527",2016-04-01,"sbma","transporte não regular","voo doméstico",211,211,422,680,635,1315,0,0,0,0
"8528",2016-04-01,"sbma","transporte não regular","voo internacional",0,0,0,0,0,0,0,0,0,0
"8529",2016-04-01,"sbmk","transporte regular","voo doméstico",140,142,282,10897,10569,21466,0,0,0,0
"8530",2016-04-01,"sbmk","transporte regular","voo internacional",0,0,0,0,0,0,0,0,0,0
"8531",2016-04-01,"sbmk","transporte não regular","voo doméstico",185,181,366,16,94,110,0,0,0,0
"8532",2016-04-01,"sbmk","transporte não regular","voo internacional",0,0,0,0,0,0,0,0,0,0
"8533",2016-04-01,"sbmq","transporte regular","voo doméstico",190,189,379,16438,17001,33439,11800,28599,40399,0
"8534",2016-04-01,"sbmq","transporte regular","voo internacional",0,0,0,0,0,0,0,0,0,0
"8535",2016-04-01,"sbmq","transporte não regular","voo doméstico",175,172,347,4171,3242,7413,0,0,0,0
"8536",2016-04-01,"sbmq","transporte não regular","voo internacional",4,5,9,0,0,0,0,0,0,0
"8537",2016-04-01,"sbmt","transporte regular","voo doméstico",0,0,0,0,0,0,0,0,0,0
"8538",2016-04-01,"sbmt","transporte regular","voo internacional",0,0,0,0,0,0,0,0,0,0
"8539",2016-04-01,"sbmt","transporte não regular","voo doméstico",3551,3541,7092,6253,6176,12429,0,0,0,0
"8540",2016-04-01,"sbmt","transporte não regular","voo internacional",0,0,0,0,0,0,0,0,0,0
"8541",2016-04-01,"sbnf","transporte regular","voo doméstico",566,565,1131,58643,59777,118420,0,174,174,0
"8542",2016-04-01,"sbnf","transporte regular","voo internacional",0,0,0,0,0,0,0,0,0,0
"8543",2016-04-01,"sbnf","transporte não regular","voo doméstico",255,254,509,883,881,1764,0,0,0,0
"8544",2016-04-01,"sbnf","transporte não regular","voo internacional",1,2,3,18,16,34,0,0,0,0
"8545",2016-04-01,"sbpb","transporte regular","voo doméstico",0,0,0,0,0,0,0,0,0,0
"8546",2016-04-01,"sbpb","transporte regular","voo internacional",0,0,0,0,0,0,0,0,0,0
"8547",2016-04-01,"sbpb","transporte não regular","voo doméstico",30,29,59,83,71,154,0,0,0,0
"8548",2016-04-01,"sbpb","transporte não regular","voo internacional",0,0,0,0,0,0,0,0,0,0
"8549",2016-04-01,"sbpj","transporte regular","voo doméstico",240,239,479,23820,22931,46751,0,0,0,0
"8550",2016-04-01,"sbpj","transporte regular","voo internacional",0,0,0,0,0,0,0,0,0,0
"8551",2016-04-01,"sbpj","transporte não regular","voo doméstico",193,193,386,403,228,631,0,0,0,0
"8552",2016-04-01,"sbpj","transporte não regular","voo internacional",0,0,0,0,0,0,0,0,0,0
"8553",2016-04-01,"sbpk","transporte regular","voo doméstico",50,49,99,1939,1834,3773,0,0,0,0
"8554",2016-04-01,"sbpk","transporte regular","voo internacional",0,0,0,0,0,0,0,0,0,0
"8555",2016-04-01,"sbpk","transporte não regular","voo doméstico",31,28,59,85,98,183,0,0,0,0
"8556",2016-04-01,"sbpk","transporte não regular","voo internacional",1,3,4,7,0,7,0,0,0,0
"8557",2016-04-01,"sbpl","transporte regular","voo doméstico",158,164,322,17390,16540,33930,0,0,0,0
"8558",2016-04-01,"sbpl","transporte regular","voo internacional",1,1,2,0,0,0,0,0,0,0
"8559",2016-04-01,"sbpl","transporte não regular","voo doméstico",73,71,144,71,236,307,0,0,0,0
"8560",2016-04-01,"sbpl","transporte não regular","voo internacional",3,3,6,0,0,0,0,0,0,0
"8561",2016-04-01,"sbpp","transporte regular","voo doméstico",0,0,0,0,0,0,0,0,0,0
"8562",2016-04-01,"sbpp","transporte regular","voo internacional",0,0,0,0,0,0,0,0,0,0
"8563",2016-04-01,"sbpp","transporte não regular","voo doméstico",91,92,183,139,146,285,0,0,0,0
"8564",2016-04-01,"sbpp","transporte não regular","voo internacional",9,9,18,15,5,20,0,0,0,0
"8565",2016-04-01,"sbpr","transporte regular","voo doméstico",1,0,1,0,1,1,0,0,0,0
"8566",2016-04-01,"sbpr","transporte regular","voo internacional",0,0,0,0,0,0,0,0,0,0
"8567",2016-04-01,"sbpr","transporte não regular","voo doméstico",791,789,1580,976,896,1872,0,0,0,0
"8568",2016-04-01,"sbpr","transporte não regular","voo internacional",0,0,0,0,0,0,0,0,0,0
"8569",2016-04-01,"sbpv","transporte regular","voo doméstico",365,364,729,32746,31454,64200,0,0,0,0
"8570",2016-04-01,"sbpv","transporte regular","voo internacional",0,0,0,0,0,0,0,0,0,0
"8571",2016-04-01,"sbpv","transporte não regular","voo doméstico",221,228,449,153,174,327,0,0,0,0
"8572",2016-04-01,"sbpv","transporte não regular","voo internacional",0,0,0,0,0,0,0,0,0,0
"8573",2016-04-01,"sbrb","transporte regular","voo doméstico",150,151,301,15133,16083,31216,0,0,0,329
"8574",2016-04-01,"sbrb","transporte regular","voo internacional",0,0,0,0,0,0,0,0,0,0
"8575",2016-04-01,"sbrb","transporte não regular","voo doméstico",107,110,217,422,229,651,0,0,0,0
"8576",2016-04-01,"sbrb","transporte não regular","voo internacional",0,0,0,0,0,0,0,0,0,0
"8577",2016-04-01,"sbrj","transporte regular","voo doméstico",3783,3777,7560,359808,360073,719881,1,66,67,903
"8578",2016-04-01,"sbrj","transporte regular","voo internacional",0,0,0,3,33,36,0,0,0,0
"8579",2016-04-01,"sbrj","transporte não regular","voo doméstico",637,644,1281,1162,1238,2400,0,0,0,0
"8580",2016-04-01,"sbrj","transporte não regular","voo internacional",0,0,0,0,0,0,0,0,0,0
"8581",2016-04-01,"sbsj","transporte regular","voo doméstico",21,22,43,2180,2211,4391,0,0,0,0
"8582",2016-04-01,"sbsj","transporte regular","voo internacional",0,0,0,0,0,0,0,0,0,0
"8583",2016-04-01,"sbsj","transporte não regular","voo doméstico",568,549,1117,2119,2053,4172,0,0,0,0
"8584",2016-04-01,"sbsj","transporte não regular","voo internacional",1,14,15,47,8,55,0,0,0,0
"8585",2016-04-01,"sbsl","transporte regular","voo doméstico",474,473,947,54433,59028,113461,2319,0,2319,0
"8586",2016-04-01,"sbsl","transporte regular","voo internacional",0,0,0,0,0,0,0,0,0,0
"8587",2016-04-01,"sbsl","transporte não regular","voo doméstico",193,202,395,1257,446,1703,52483,197588,250071,0
"8588",2016-04-01,"sbsl","transporte não regular","voo internacional",1,1,2,0,0,0,0,0,0,0
"8589",2016-04-01,"sbsn","transporte regular","voo doméstico",222,223,445,17001,16121,33122,0,0,0,0
"8590",2016-04-01,"sbsn","transporte regular","voo internacional",0,0,0,0,0,0,0,0,0,0
"8591",2016-04-01,"sbsn","transporte não regular","voo doméstico",259,264,523,890,719,1609,0,0,0,0
"8592",2016-04-01,"sbsn","transporte não regular","voo internacional",1,1,2,0,0,0,0,0,0,0
"8593",2016-04-01,"sbsp","transporte regular","voo doméstico",6920,6981,13901,802493,788370,1590863,0,0,0,0
"8594",2016-04-01,"sbsp","transporte regular","voo internacional",0,0,0,0,0,0,0,0,0,0
"8595",2016-04-01,"sbsp","transporte não regular","voo doméstico",1882,1824,3706,15594,17252,32846,0,0,0,0
"8596",2016-04-01,"sbsp","transporte não regular","voo internacional",0,0,0,0,0,0,0,0,0,0
"8597",2016-04-01,"sbte","transporte regular","voo doméstico",427,429,856,42228,40730,82958,22252,70602,92854,220904
"8598",2016-04-01,"sbte","transporte regular","voo internacional",0,0,0,0,4,4,0,0,0,0
"8599",2016-04-01,"sbte","transporte não regular","voo doméstico",181,177,358,1033,961,1994,0,0,0,0
"8600",2016-04-01,"sbte","transporte não regular","voo internacional",0,0,0,0,0,0,0,0,0,0
"8601",2016-04-01,"sbtf","transporte regular","voo doméstico",40,40,80,1576,1691,3267,0,0,0,0
"8602",2016-04-01,"sbtf","transporte regular","voo internacional",0,0,0,0,0,0,0,0,0,0
"8603",2016-04-01,"sbtf","transporte não regular","voo doméstico",137,137,274,272,226,498,1685,2063,3748,12134
"8604",2016-04-01,"sbtf","transporte não regular","voo internacional",0,0,0,0,0,0,0,0,0,0
"8605",2016-04-01,"sbtt","transporte regular","voo doméstico",31,31,62,2124,2467,4591,0,0,0,0
"8606",2016-04-01,"sbtt","transporte regular","voo internacional",0,0,0,0,0,0,0,0,0,0
"8607",2016-04-01,"sbtt","transporte não regular","voo doméstico",77,74,151,320,294,614,1875,3749,5624,790
"8608",2016-04-01,"sbtt","transporte não regular","voo internacional",1,2,3,2,2,4,0,0,0,0
"8609",2016-04-01,"sbuf","transporte regular","voo doméstico",8,8,16,237,241,478,0,0,0,0
"8610",2016-04-01,"sbuf","transporte regular","voo internacional",0,0,0,0,0,0,0,0,0,0
"8611",2016-04-01,"sbuf","transporte não regular","voo doméstico",20,20,40,55,40,95,0,0,0,0
"8612",2016-04-01,"sbuf","transporte não regular","voo internacional",0,0,0,0,0,0,0,0,0,0
"8613",2016-04-01,"sbug","transporte regular","voo doméstico",24,24,48,1175,1105,2280,0,0,0,0
"8614",2016-04-01,"sbug","transporte regular","voo internacional",0,0,0,0,0,0,0,0,0,0
"8615",2016-04-01,"sbug","transporte não regular","voo doméstico",5,6,11,7,1,8,0,0,0,0
"8616",2016-04-01,"sbug","transporte não regular","voo internacional",0,0,0,0,0,0,0,0,0,0
"8617",2016-04-01,"sbul","transporte regular","voo doméstico",409,409,818,38575,37669,76244,0,0,0,0
"8618",2016-04-01,"sbul","transporte regular","voo internacional",0,0,0,0,0,0,0,0,0,0
"8619",2016-04-01,"sbul","transporte não regular","voo doméstico",619,627,1246,1355,1221,2576,0,0,0,0
"8620",2016-04-01,"sbul","transporte não regular","voo internacional",2,2,4,11,11,22,0,0,0,0
"8621",2016-04-01,"sbur","transporte regular","voo doméstico",100,101,201,4121,4395,8516,0,0,0,0
"8622",2016-04-01,"sbur","transporte regular","voo internacional",0,0,0,0,0,0,0,0,0,0
"8623",2016-04-01,"sbur","transporte não regular","voo doméstico",205,163,368,534,786,1320,0,0,0,0
"8624",2016-04-01,"sbur","transporte não regular","voo internacional",1,1,2,0,0,0,0,0,0,0
"8625",2016-08-01,"sbbe","transporte regular","voo doméstico",1165,1162,2327,126384,125913,252297,81226,83252,164478,0
"8626",2016-08-01,"sbbe","transporte regular","voo internacional",60,60,120,7231,7431,14662,0,58,58,0
"8627",2016-08-01,"sbbe","transporte não regular","voo doméstico",448,445,893,2211,2008,4219,69223,131106,200329,0
"8628",2016-08-01,"sbbe","transporte não regular","voo internacional",15,16,31,79,89,168,0,0,0,0
"8629",2016-08-01,"sbbg","transporte regular","voo doméstico",0,0,0,0,0,0,0,0,0,0
"8630",2016-08-01,"sbbg","transporte regular","voo internacional",0,0,0,0,0,0,0,0,0,0
"8631",2016-08-01,"sbbg","transporte não regular","voo doméstico",11,11,22,52,43,95,0,0,0,0
"8632",2016-08-01,"sbbg","transporte não regular","voo internacional",1,1,2,4,0,4,0,0,0,0
"8633",2016-08-01,"sbbh","transporte regular","voo doméstico",52,52,104,1888,1925,3813,0,0,0,0
"8634",2016-08-01,"sbbh","transporte regular","voo internacional",0,0,0,0,0,0,0,0,0,0
"8635",2016-08-01,"sbbh","transporte não regular","voo doméstico",1592,1619,3211,7410,7330,14740,0,0,0,0
"8636",2016-08-01,"sbbh","transporte não regular","voo internacional",24,24,48,151,151,302,0,0,0,0
"8637",2016-08-01,"sbbi","transporte regular","voo doméstico",0,0,0,0,0,0,0,0,0,0
"8638",2016-08-01,"sbbi","transporte regular","voo internacional",0,0,0,0,0,0,0,0,0,0
"8639",2016-08-01,"sbbi","transporte não regular","voo doméstico",919,918,1837,2114,2623,4737,0,0,0,0
"8640",2016-08-01,"sbbi","transporte não regular","voo internacional",13,12,25,0,0,0,0,0,0,0
"8641",2016-08-01,"sbbv","transporte regular","voo doméstico",96,96,192,11415,11026,22441,0,0,0,0
"8642",2016-08-01,"sbbv","transporte regular","voo internacional",4,4,8,73,99,172,0,0,0,0
"8643",2016-08-01,"sbbv","transporte não regular","voo doméstico",113,119,232,170,104,274,0,0,0,0
"8644",2016-08-01,"sbbv","transporte não regular","voo internacional",9,6,15,0,3,3,0,0,0,0
"8645",2016-08-01,"sbcg","transporte regular","voo doméstico",589,589,1178,63216,61966,125182,71603,154023,225626,0
"8646",2016-08-01,"sbcg","transporte regular","voo internacional",0,0,0,0,0,0,0,0,0,0
"8647",2016-08-01,"sbcg","transporte não regular","voo doméstico",262,263,525,322,410,732,0,0,0,0
"8648",2016-08-01,"sbcg","transporte não regular","voo internacional",8,6,14,0,2,2,0,0,0,0
"8649",2016-08-01,"sbcj","transporte regular","voo doméstico",68,68,136,6121,6502,12623,0,0,0,0
"8650",2016-08-01,"sbcj","transporte regular","voo internacional",0,0,0,0,0,0,0,0,0,0
"8651",2016-08-01,"sbcj","transporte não regular","voo doméstico",92,92,184,656,341,997,0,0,0,0
"8652",2016-08-01,"sbcj","transporte não regular","voo internacional",0,0,0,0,0,0,0,0,0,0
"8653",2016-08-01,"sbcr","transporte regular","voo doméstico",18,18,36,1397,1549,2946,0,0,0,0
"8654",2016-08-01,"sbcr","transporte regular","voo internacional",0,0,0,0,0,0,0,0,0,0
"8655",2016-08-01,"sbcr","transporte não regular","voo doméstico",41,43,84,87,64,151,0,0,0,0
"8656",2016-08-01,"sbcr","transporte não regular","voo internacional",5,6,11,16,12,28,0,0,0,0
"8657",2016-08-01,"sbct","transporte regular","voo doméstico",2202,2188,4390,242739,239507,482246,138407,28661,167068,213675
"8658",2016-08-01,"sbct","transporte regular","voo internacional",52,52,104,1759,1782,3541,0,6315,6315,0
"8659",2016-08-01,"sbct","transporte não regular","voo doméstico",444,458,902,19305,17871,37176,0,1244,1244,26971
"8660",2016-08-01,"sbct","transporte não regular","voo internacional",15,16,31,24,23,47,0,0,0,0
"8661",2016-08-01,"sbcz","transporte regular","voo doméstico",31,31,62,2845,2731,5576,0,0,0,0
"8662",2016-08-01,"sbcz","transporte regular","voo internacional",0,0,0,0,0,0,0,0,0,0
"8663",2016-08-01,"sbcz","transporte não regular","voo doméstico",266,264,530,938,929,1867,0,0,0,0
"8664",2016-08-01,"sbcz","transporte não regular","voo internacional",0,0,0,0,0,0,0,0,0,0
"8665",2016-08-01,"sbeg","transporte regular","voo doméstico",877,874,1751,92684,94072,186756,0,0,0,0
"8666",2016-08-01,"sbeg","transporte regular","voo internacional",108,111,219,4179,4663,8842,0,0,0,0
"8667",2016-08-01,"sbeg","transporte não regular","voo doméstico",452,454,906,3556,3418,6974,0,0,0,0
"8668",2016-08-01,"sbeg","transporte não regular","voo internacional",89,92,181,252,346,598,0,0,0,0
"8669",2016-08-01,"sbfi","transporte regular","voo doméstico",498,498,996,66149,69169,135318,0,0,0,0
"8670",2016-08-01,"sbfi","transporte regular","voo internacional",22,22,44,3039,2702,5741,0,0,0,0
"8671",2016-08-01,"sbfi","transporte não regular","voo doméstico",155,158,313,3736,4322,8058,0,0,0,0
"8672",2016-08-01,"sbfi","transporte não regular","voo internacional",47,42,89,70,106,176,0,0,0,0
"8673",2016-08-01,"sbgo","transporte regular","voo doméstico",1205,1191,2396,121761,120114,241875,132048,180533,312581,195800
"8674",2016-08-01,"sbgo","transporte regular","voo internacional",0,0,0,0,0,0,0,0,0,0
"8675",2016-08-01,"sbgo","transporte não regular","voo doméstico",1319,1335,2654,5957,3724,9681,0,0,0,0
"8676",2016-08-01,"sbgo","transporte não regular","voo internacional",3,3,6,0,0,0,0,0,0,0
"8677",2016-08-01,"sbht","transporte regular","voo doméstico",184,184,368,6486,6060,12546,0,0,0,0
"8678",2016-08-01,"sbht","transporte regular","voo internacional",0,0,0,0,0,0,0,0,0,0
"8679",2016-08-01,"sbht","transporte não regular","voo doméstico",138,137,275,135,104,239,120,80,200,100
"8680",2016-08-01,"sbht","transporte não regular","voo internacional",0,0,0,0,0,0,0,0,0,0
"8681",2016-08-01,"sbiz","transporte regular","voo doméstico",131,131,262,11053,10188,21241,0,0,0,0
"8682",2016-08-01,"sbiz","transporte regular","voo internacional",0,0,0,0,0,0,0,0,0,0
"8683",2016-08-01,"sbiz","transporte não regular","voo doméstico",162,163,325,385,387,772,0,0,0,0
"8684",2016-08-01,"sbiz","transporte não regular","voo internacional",0,0,0,0,0,0,0,0,0,0
"8685",2016-08-01,"sbjc","transporte regular","voo doméstico",0,0,0,0,0,0,0,0,0,0
"8686",2016-08-01,"sbjc","transporte regular","voo internacional",0,0,0,0,0,0,0,0,0,0
"8687",2016-08-01,"sbjc","transporte não regular","voo doméstico",404,402,806,758,529,1287,0,0,0,0
"8688",2016-08-01,"sbjc","transporte não regular","voo internacional",0,1,1,0,0,0,0,0,0,0
"8689",2016-08-01,"sbjr","transporte regular","voo doméstico",0,0,0,0,0,0,0,0,0,0
"8690",2016-08-01,"sbjr","transporte regular","voo internacional",0,0,0,0,0,0,0,0,0,0
"8691",2016-08-01,"sbjr","transporte não regular","voo doméstico",1336,1337,2673,3039,2188,5227,0,0,0,0
"8692",2016-08-01,"sbjr","transporte não regular","voo internacional",0,0,0,0,0,0,0,0,0,0
"8693",2016-08-01,"sbjv","transporte regular","voo doméstico",263,264,527,23834,22860,46694,0,3,3,0
"8694",2016-08-01,"sbjv","transporte regular","voo internacional",0,0,0,0,0,0,0,0,0,0
"8695",2016-08-01,"sbjv","transporte não regular","voo doméstico",129,129,258,472,595,1067,0,0,0,0
"8696",2016-08-01,"sbjv","transporte não regular","voo internacional",2,2,4,0,4,4,0,0,0,0
"8697",2016-08-01,"sblo","transporte regular","voo doméstico",277,278,555,30440,28742,59182,0,0,0,0
"8698",2016-08-01,"sblo","transporte regular","voo internacional",0,0,0,0,0,0,0,0,0,0
"8699",2016-08-01,"sblo","transporte não regular","voo doméstico",737,732,1469,8599,8445,17044,0,0,0,0
"8700",2016-08-01,"sblo","transporte não regular","voo internacional",0,0,0,0,0,0,0,0,0,0
"8701",2016-08-01,"sbma","transporte regular","voo doméstico",146,146,292,12421,11779,24200,300,0,300,0
"8702",2016-08-01,"sbma","transporte regular","voo internacional",0,0,0,0,0,0,0,0,0,0
"8703",2016-08-01,"sbma","transporte não regular","voo doméstico",230,236,466,594,604,1198,0,0,0,0
"8704",2016-08-01,"sbma","transporte não regular","voo internacional",0,0,0,0,0,0,0,0,0,0
"8705",2016-08-01,"sbmk","transporte regular","voo doméstico",174,174,348,12872,12347,25219,0,0,0,0
"8706",2016-08-01,"sbmk","transporte regular","voo internacional",0,0,0,0,0,0,0,0,0,0
"8707",2016-08-01,"sbmk","transporte não regular","voo doméstico",194,194,388,6,17,23,0,0,0,0
"8708",2016-08-01,"sbmk","transporte não regular","voo internacional",0,0,0,0,0,0,0,0,0,0
"8709",2016-08-01,"sbmq","transporte regular","voo doméstico",216,217,433,21520,24035,45555,10650,32800,43450,0
"8710",2016-08-01,"sbmq","transporte regular","voo internacional",0,0,0,0,0,0,0,0,0,0
"8711",2016-08-01,"sbmq","transporte não regular","voo doméstico",157,155,312,193,70,263,0,0,0,0
"8712",2016-08-01,"sbmq","transporte não regular","voo internacional",3,3,6,0,0,0,0,0,0,0
"8713",2016-08-01,"sbmt","transporte regular","voo doméstico",0,0,0,0,0,0,0,0,0,0
"8714",2016-08-01,"sbmt","transporte regular","voo internacional",0,0,0,0,0,0,0,0,0,0
"8715",2016-08-01,"sbmt","transporte não regular","voo doméstico",2536,2525,5061,4442,4511,8953,0,0,0,0
"8716",2016-08-01,"sbmt","transporte não regular","voo internacional",0,0,0,0,0,0,0,0,0,0
"8717",2016-08-01,"sbnf","transporte regular","voo doméstico",525,525,1050,57775,57339,115114,0,0,0,0
"8718",2016-08-01,"sbnf","transporte regular","voo internacional",0,0,0,0,0,0,0,0,0,0
"8719",2016-08-01,"sbnf","transporte não regular","voo doméstico",185,186,371,1020,1026,2046,0,0,0,0
"8720",2016-08-01,"sbnf","transporte não regular","voo internacional",1,2,3,6,2,8,0,0,0,0
"8721",2016-08-01,"sbpb","transporte regular","voo doméstico",4,4,8,315,277,592,0,0,0,0
"8722",2016-08-01,"sbpb","transporte regular","voo internacional",0,0,0,0,0,0,0,0,0,0
"8723",2016-08-01,"sbpb","transporte não regular","voo doméstico",41,41,82,112,124,236,0,0,0,0
"8724",2016-08-01,"sbpb","transporte não regular","voo internacional",1,1,2,0,0,0,0,0,0,0
"8725",2016-08-01,"sbpj","transporte regular","voo doméstico",257,255,512,25720,24058,49778,0,0,0,0
"8726",2016-08-01,"sbpj","transporte regular","voo internacional",0,0,0,0,0,0,0,0,0,0
"8727",2016-08-01,"sbpj","transporte não regular","voo doméstico",265,265,530,528,376,904,0,0,0,0
"8728",2016-08-01,"sbpj","transporte não regular","voo internacional",3,3,6,0,0,0,0,0,0,0
"8729",2016-08-01,"sbpk","transporte regular","voo doméstico",25,25,50,1281,1415,2696,0,0,0,0
"8730",2016-08-01,"sbpk","transporte regular","voo internacional",0,0,0,0,0,0,0,0,0,0
"8731",2016-08-01,"sbpk","transporte não regular","voo doméstico",29,30,59,83,79,162,0,0,0,0
"8732",2016-08-01,"sbpk","transporte não regular","voo internacional",4,3,7,6,12,18,0,0,0,0
"8733",2016-08-01,"sbpl","transporte regular","voo doméstico",170,170,340,19329,18069,37398,0,0,0,0
"8734",2016-08-01,"sbpl","transporte regular","voo internacional",2,2,4,0,0,0,0,0,0,0
"8735",2016-08-01,"sbpl","transporte não regular","voo doméstico",81,80,161,103,106,209,0,0,0,0
"8736",2016-08-01,"sbpl","transporte não regular","voo internacional",0,0,0,0,0,0,0,0,0,0
"8737",2016-08-01,"sbpp","transporte regular","voo doméstico",0,0,0,0,0,0,0,0,0,0
"8738",2016-08-01,"sbpp","transporte regular","voo internacional",0,0,0,0,0,0,0,0,0,0
"8739",2016-08-01,"sbpp","transporte não regular","voo doméstico",121,121,242,195,190,385,0,0,0,0
"8740",2016-08-01,"sbpp","transporte não regular","voo internacional",14,15,29,26,15,41,0,0,0,0
"8741",2016-08-01,"sbpr","transporte regular","voo doméstico",0,0,0,0,0,0,0,0,0,0
"8742",2016-08-01,"sbpr","transporte regular","voo internacional",0,0,0,0,0,0,0,0,0,0
"8743",2016-08-01,"sbpr","transporte não regular","voo doméstico",913,903,1816,1081,969,2050,0,0,0,0
"8744",2016-08-01,"sbpr","transporte não regular","voo internacional",1,0,1,0,0,0,0,0,0,0
"8745",2016-08-01,"sbpv","transporte regular","voo doméstico",356,356,712,33353,33631,66984,0,0,0,0
"8746",2016-08-01,"sbpv","transporte regular","voo internacional",0,0,0,0,0,0,0,0,0,0
"8747",2016-08-01,"sbpv","transporte não regular","voo doméstico",234,232,466,0,0,0,0,0,0,0
"8748",2016-08-01,"sbpv","transporte não regular","voo internacional",0,0,0,0,0,0,0,0,0,0
"8749",2016-08-01,"sbrb","transporte regular","voo doméstico",123,123,246,11637,13871,25508,0,69,69,884
"8750",2016-08-01,"sbrb","transporte regular","voo internacional",0,0,0,0,0,0,0,0,0,0
"8751",2016-08-01,"sbrb","transporte não regular","voo doméstico",116,119,235,304,241,545,0,0,0,0
"8752",2016-08-01,"sbrb","transporte não regular","voo internacional",0,0,0,0,0,0,0,0,0,0
"8753",2016-08-01,"sbrj","transporte regular","voo doméstico",3671,3691,7362,384505,377321,761826,1118,0,1118,0
"8754",2016-08-01,"sbrj","transporte regular","voo internacional",0,0,0,0,0,0,0,0,0,0
"8755",2016-08-01,"sbrj","transporte não regular","voo doméstico",503,483,986,3080,4284,7364,0,0,0,0
"8756",2016-08-01,"sbrj","transporte não regular","voo internacional",9,10,19,0,0,0,0,0,0,0
"8757",2016-08-01,"sbsj","transporte regular","voo doméstico",0,0,0,0,0,0,0,0,0,0
"8758",2016-08-01,"sbsj","transporte regular","voo internacional",0,0,0,0,0,0,0,0,0,0
"8759",2016-08-01,"sbsj","transporte não regular","voo doméstico",429,418,847,661,658,1319,0,0,0,0
"8760",2016-08-01,"sbsj","transporte não regular","voo internacional",6,21,27,43,24,67,0,0,0,0
"8761",2016-08-01,"sbsl","transporte regular","voo doméstico",479,477,956,52895,57349,110244,0,2348,2348,0
"8762",2016-08-01,"sbsl","transporte regular","voo internacional",0,0,0,0,0,0,0,0,0,0
"8763",2016-08-01,"sbsl","transporte não regular","voo doméstico",270,278,548,494,540,1034,50310,188046,238356,0
"8764",2016-08-01,"sbsl","transporte não regular","voo internacional",0,0,0,0,0,0,0,0,0,0
"8765",2016-08-01,"sbsn","transporte regular","voo doméstico",222,222,444,19945,18735,38680,0,0,0,0
"8766",2016-08-01,"sbsn","transporte regular","voo internacional",0,0,0,0,0,0,0,0,0,0
"8767",2016-08-01,"sbsn","transporte não regular","voo doméstico",276,272,548,709,385,1094,0,0,0,0
"8768",2016-08-01,"sbsn","transporte não regular","voo internacional",0,0,0,0,0,0,0,0,0,0
"8769",2016-08-01,"sbsp","transporte regular","voo doméstico",7401,7456,14857,891462,893994,1785456,0,0,0,0
"8770",2016-08-01,"sbsp","transporte regular","voo internacional",0,0,0,0,0,0,0,0,0,0
"8771",2016-08-01,"sbsp","transporte não regular","voo doméstico",1923,1811,3734,20394,21095,41489,0,0,0,0
"8772",2016-08-01,"sbsp","transporte não regular","voo internacional",0,0,0,0,0,0,0,0,0,0
"8773",2016-08-01,"sbte","transporte regular","voo doméstico",387,387,774,42949,39996,82945,21630,79489,101119,231842
"8774",2016-08-01,"sbte","transporte regular","voo internacional",0,0,0,0,0,0,0,0,0,0
"8775",2016-08-01,"sbte","transporte não regular","voo doméstico",249,246,495,1373,1372,2745,0,0,0,0
"8776",2016-08-01,"sbte","transporte não regular","voo internacional",0,0,0,0,0,0,0,0,0,0
"8777",2016-08-01,"sbtf","transporte regular","voo doméstico",42,42,84,1648,1716,3364,0,0,0,0
"8778",2016-08-01,"sbtf","transporte regular","voo internacional",0,0,0,0,0,0,0,0,0,0
"8779",2016-08-01,"sbtf","transporte não regular","voo doméstico",157,156,313,182,177,359,3206,3240,6446,12976
"8780",2016-08-01,"sbtf","transporte não regular","voo internacional",0,0,0,0,0,0,0,0,0,0
"8781",2016-08-01,"sbtt","transporte regular","voo doméstico",39,39,78,2364,2726,5090,0,150,150,0
"8782",2016-08-01,"sbtt","transporte regular","voo internacional",0,0,0,0,0,0,0,0,0,0
"8783",2016-08-01,"sbtt","transporte não regular","voo doméstico",64,65,129,251,266,517,1841,4431,6272,769
"8784",2016-08-01,"sbtt","transporte não regular","voo internacional",3,2,5,3,5,8,0,0,0,0
"8785",2016-08-01,"sbuf","transporte regular","voo doméstico",8,8,16,386,357,743,0,0,0,0
"8786",2016-08-01,"sbuf","transporte regular","voo internacional",0,0,0,0,0,0,0,0,0,0
"8787",2016-08-01,"sbuf","transporte não regular","voo doméstico",30,30,60,85,85,170,0,0,0,0
"8788",2016-08-01,"sbuf","transporte não regular","voo internacional",0,0,0,0,0,0,0,0,0,0
"8789",2016-08-01,"sbug","transporte regular","voo doméstico",24,24,48,1172,1202,2374,0,0,0,0
"8790",2016-08-01,"sbug","transporte regular","voo internacional",0,0,0,0,0,0,0,0,0,0
"8791",2016-08-01,"sbug","transporte não regular","voo doméstico",9,9,18,84,109,193,0,0,0,0
"8792",2016-08-01,"sbug","transporte não regular","voo internacional",0,0,0,0,0,0,0,0,0,0
"8793",2016-08-01,"sbul","transporte regular","voo doméstico",494,495,989,44982,44285,89267,0,0,0,0
"8794",2016-08-01,"sbul","transporte regular","voo internacional",0,0,0,0,0,0,0,0,0,0
"8795",2016-08-01,"sbul","transporte não regular","voo doméstico",524,521,1045,1298,1134,2432,0,0,0,0
"8796",2016-08-01,"sbul","transporte não regular","voo internacional",2,2,4,16,17,33,0,0,0,0
"8797",2016-08-01,"sbur","transporte regular","voo doméstico",71,68,139,3644,3679,7323,0,0,0,0
"8798",2016-08-01,"sbur","transporte regular","voo internacional",0,0,0,0,0,0,0,0,0,0
"8799",2016-08-01,"sbur","transporte não regular","voo doméstico",225,228,453,893,839,1732,0,0,0,0
"8800",2016-08-01,"sbur","transporte não regular","voo internacional",0,0,0,0,0,0,0,0,0,0
"8801",2016-12-01,"sbbe","transporte regular","voo doméstico",1330,1331,2661,154407,157156,311563,99970,313752,413722,0
"8802",2016-12-01,"sbbe","transporte regular","voo internacional",52,51,103,6094,6173,12267,0,15,15,0
"8803",2016-12-01,"sbbe","transporte não regular","voo doméstico",478,475,953,5485,5846,11331,0,0,0,0
"8804",2016-12-01,"sbbe","transporte não regular","voo internacional",5,8,13,120,4,124,0,0,0,0
"8805",2016-12-01,"sbbg","transporte regular","voo doméstico",0,0,0,0,0,0,0,0,0,0
"8806",2016-12-01,"sbbg","transporte regular","voo internacional",0,0,0,0,0,0,0,0,0,0
"8807",2016-12-01,"sbbg","transporte não regular","voo doméstico",18,19,37,98,92,190,0,0,0,0
"8808",2016-12-01,"sbbg","transporte não regular","voo internacional",1,1,2,0,4,4,0,0,0,0
"8809",2016-12-01,"sbbh","transporte regular","voo doméstico",46,46,92,1608,1662,3270,0,0,0,0
"8810",2016-12-01,"sbbh","transporte regular","voo internacional",0,0,0,0,0,0,0,0,0,0
"8811",2016-12-01,"sbbh","transporte não regular","voo doméstico",1470,1484,2954,7624,7488,15112,0,0,0,0
"8812",2016-12-01,"sbbh","transporte não regular","voo internacional",4,5,9,36,28,64,0,0,0,0
"8813",2016-12-01,"sbbi","transporte regular","voo doméstico",0,0,0,0,0,0,0,0,0,0
"8814",2016-12-01,"sbbi","transporte regular","voo internacional",0,0,0,0,0,0,0,0,0,0
"8815",2016-12-01,"sbbi","transporte não regular","voo doméstico",824,829,1653,2885,2680,5565,0,0,0,0
"8816",2016-12-01,"sbbi","transporte não regular","voo internacional",0,0,0,0,0,0,0,0,0,0
"8817",2016-12-01,"sbbv","transporte regular","voo doméstico",106,104,210,14507,12322,26829,0,0,0,0
"8818",2016-12-01,"sbbv","transporte regular","voo internacional",1,1,2,54,12,66,0,0,0,0
"8819",2016-12-01,"sbbv","transporte não regular","voo doméstico",97,98,195,260,60,320,0,0,0,0
"8820",2016-12-01,"sbbv","transporte não regular","voo internacional",17,17,34,0,0,0,0,0,0,0
"8821",2016-12-01,"sbcg","transporte regular","voo doméstico",515,515,1030,65551,58364,123915,19275,36697,55972,0
"8822",2016-12-01,"sbcg","transporte regular","voo internacional",0,0,0,0,0,0,0,0,0,0
"8823",2016-12-01,"sbcg","transporte não regular","voo doméstico",190,197,387,1382,1164,2546,31580,54286,85866,0
"8824",2016-12-01,"sbcg","transporte não regular","voo internacional",10,12,22,0,0,0,0,0,0,0
"8825",2016-12-01,"sbcj","transporte regular","voo doméstico",65,65,130,6747,5594,12341,0,0,0,0
"8826",2016-12-01,"sbcj","transporte regular","voo internacional",0,0,0,0,0,0,0,0,0,0
"8827",2016-12-01,"sbcj","transporte não regular","voo doméstico",96,96,192,967,539,1506,0,0,0,0
"8828",2016-12-01,"sbcj","transporte não regular","voo internacional",0,0,0,0,0,0,0,0,0,0
"8829",2016-12-01,"sbcr","transporte regular","voo doméstico",15,15,30,1469,1241,2710,0,0,0,0
"8830",2016-12-01,"sbcr","transporte regular","voo internacional",0,0,0,0,0,0,0,0,0,0
"8831",2016-12-01,"sbcr","transporte não regular","voo doméstico",29,30,59,71,47,118,0,0,0,0
"8832",2016-12-01,"sbcr","transporte não regular","voo internacional",6,5,11,9,10,19,0,0,0,0
"8833",2016-12-01,"sbct","transporte regular","voo doméstico",2543,2547,5090,282214,269427,551641,178136,71927,250063,326669
"8834",2016-12-01,"sbct","transporte regular","voo internacional",53,53,106,1518,1571,3089,0,26662,26662,6246
"8835",2016-12-01,"sbct","transporte não regular","voo doméstico",330,330,660,12774,11105,23879,0,0,0,8951
"8836",2016-12-01,"sbct","transporte não regular","voo internacional",13,15,28,153,169,322,0,0,0,0
"8837",2016-12-01,"sbcz","transporte regular","voo doméstico",31,30,61,3417,3907,7324,0,0,0,0
"8838",2016-12-01,"sbcz","transporte regular","voo internacional",0,0,0,0,0,0,0,0,0,0
"8839",2016-12-01,"sbcz","transporte não regular","voo doméstico",176,178,354,591,613,1204,0,0,0,0
"8840",2016-12-01,"sbcz","transporte não regular","voo internacional",0,0,0,0,0,0,0,0,0,0
"8841",2016-12-01,"sbeg","transporte regular","voo doméstico",915,921,1836,117981,92655,210636,0,107028,107028,0
"8842",2016-12-01,"sbeg","transporte regular","voo internacional",103,97,200,6580,4978,11558,0,0,0,0
"8843",2016-12-01,"sbeg","transporte não regular","voo doméstico",493,483,976,5817,5633,11450,0,0,0,0
"8844",2016-12-01,"sbeg","transporte não regular","voo internacional",84,93,177,589,539,1128,0,0,0,0
"8845",2016-12-01,"sbfi","transporte regular","voo doméstico",639,642,1281,74868,70447,145315,0,0,0,0
"8846",2016-12-01,"sbfi","transporte regular","voo internacional",23,23,46,3178,2110,5288,0,0,0,0
"8847",2016-12-01,"sbfi","transporte não regular","voo doméstico",178,175,353,9610,9152,18762,0,0,0,0
"8848",2016-12-01,"sbfi","transporte não regular","voo internacional",32,35,67,48,67,115,0,0,0,0
"8849",2016-12-01,"sbgo","transporte regular","voo doméstico",1163,1161,2324,125158,117830,242988,80050,93136,173186,111051
"8850",2016-12-01,"sbgo","transporte regular","voo internacional",0,0,0,0,0,0,0,0,0,0
"8851",2016-12-01,"sbgo","transporte não regular","voo doméstico",1176,1223,2399,14628,10875,25503,1432,8841,10273,7179
"8852",2016-12-01,"sbgo","transporte não regular","voo internacional",2,3,5,0,0,0,0,0,0,0
"8853",2016-12-01,"sbht","transporte regular","voo doméstico",138,136,274,6276,5216,11492,0,0,0,0
"8854",2016-12-01,"sbht","transporte regular","voo internacional",0,0,0,0,0,0,0,0,0,0
"8855",2016-12-01,"sbht","transporte não regular","voo doméstico",65,67,132,531,159,690,0,0,0,0
"8856",2016-12-01,"sbht","transporte não regular","voo internacional",0,0,0,0,0,0,0,0,0,0
"8857",2016-12-01,"sbiz","transporte regular","voo doméstico",129,130,259,12208,12177,24385,0,0,0,0
"8858",2016-12-01,"sbiz","transporte regular","voo internacional",0,0,0,0,0,0,0,0,0,0
"8859",2016-12-01,"sbiz","transporte não regular","voo doméstico",107,108,215,312,265,577,0,0,0,0
"8860",2016-12-01,"sbiz","transporte não regular","voo internacional",0,0,0,0,0,0,0,0,0,0
"8861",2016-12-01,"sbjc","transporte regular","voo doméstico",0,0,0,0,0,0,0,0,0,0
"8862",2016-12-01,"sbjc","transporte regular","voo internacional",0,0,0,0,0,0,0,0,0,0
"8863",2016-12-01,"sbjc","transporte não regular","voo doméstico",339,335,674,572,431,1003,0,0,0,0
"8864",2016-12-01,"sbjc","transporte não regular","voo internacional",0,0,0,0,0,0,0,0,0,0
"8865",2016-12-01,"sbjr","transporte regular","voo doméstico",0,0,0,0,0,0,0,0,0,0
"8866",2016-12-01,"sbjr","transporte regular","voo internacional",0,0,0,0,0,0,0,0,0,0
"8867",2016-12-01,"sbjr","transporte não regular","voo doméstico",2783,2782,5565,11054,9789,20843,0,0,0,0
"8868",2016-12-01,"sbjr","transporte não regular","voo internacional",0,0,0,0,0,0,0,0,0,0
"8869",2016-12-01,"sbjv","transporte regular","voo doméstico",220,207,427,18386,19585,37971,0,0,0,0
"8870",2016-12-01,"sbjv","transporte regular","voo internacional",0,0,0,0,0,0,0,0,0,0
"8871",2016-12-01,"sbjv","transporte não regular","voo doméstico",88,102,190,795,80,875,0,0,0,0
"8872",2016-12-01,"sbjv","transporte não regular","voo internacional",0,0,0,0,0,0,0,0,0,0
"8873",2016-12-01,"sblo","transporte regular","voo doméstico",383,395,778,37644,36112,73756,0,0,0,0
"8874",2016-12-01,"sblo","transporte regular","voo internacional",0,0,0,0,0,0,0,0,0,0
"8875",2016-12-01,"sblo","transporte não regular","voo doméstico",556,543,1099,3052,3931,6983,0,0,0,0
"8876",2016-12-01,"sblo","transporte não regular","voo internacional",1,1,2,0,0,0,0,0,0,0
"8877",2016-12-01,"sbma","transporte regular","voo doméstico",151,153,304,14795,13607,28402,0,0,0,0
"8878",2016-12-01,"sbma","transporte regular","voo internacional",0,0,0,0,0,0,0,0,0,0
"8879",2016-12-01,"sbma","transporte não regular","voo doméstico",175,173,348,796,913,1709,0,0,0,0
"8880",2016-12-01,"sbma","transporte não regular","voo internacional",1,1,2,0,0,0,0,0,0,0
"8881",2016-12-01,"sbmk","transporte regular","voo doméstico",159,153,312,11917,13112,25029,0,0,0,0
"8882",2016-12-01,"sbmk","transporte regular","voo internacional",0,0,0,0,0,0,0,0,0,0
"8883",2016-12-01,"sbmk","transporte não regular","voo doméstico",194,200,394,404,195,599,0,0,0,0
"8884",2016-12-01,"sbmk","transporte não regular","voo internacional",0,0,0,0,0,0,0,0,0,0
"8885",2016-12-01,"sbmq","transporte regular","voo doméstico",249,251,500,29044,26584,55628,8500,35465,43965,0
"8886",2016-12-01,"sbmq","transporte regular","voo internacional",0,0,0,0,0,0,0,0,0,0
"8887",2016-12-01,"sbmq","transporte não regular","voo doméstico",183,180,363,485,284,769,0,0,0,0
"8888",2016-12-01,"sbmq","transporte não regular","voo internacional",3,8,11,0,0,0,0,0,0,0
"8889",2016-12-01,"sbmt","transporte regular","voo doméstico",0,0,0,0,0,0,0,0,0,0
"8890",2016-12-01,"sbmt","transporte regular","voo internacional",0,0,0,0,0,0,0,0,0,0
"8891",2016-12-01,"sbmt","transporte não regular","voo doméstico",2691,2701,5392,4868,4779,9647,0,0,0,0
"8892",2016-12-01,"sbmt","transporte não regular","voo internacional",0,0,0,0,0,0,0,0,0,0
"8893",2016-12-01,"sbnf","transporte regular","voo doméstico",514,517,1031,52617,56949,109566,0,0,0,0
"8894",2016-12-01,"sbnf","transporte regular","voo internacional",0,0,0,0,0,0,0,0,0,0
"8895",2016-12-01,"sbnf","transporte não regular","voo doméstico",251,241,492,4960,5845,10805,0,0,0,0
"8896",2016-12-01,"sbnf","transporte não regular","voo internacional",8,8,16,7,13,20,0,0,0,0
"8897",2016-12-01,"sbpb","transporte regular","voo doméstico",5,5,10,459,489,948,0,0,0,0
"8898",2016-12-01,"sbpb","transporte regular","voo internacional",0,0,0,0,0,0,0,0,0,0
"8899",2016-12-01,"sbpb","transporte não regular","voo doméstico",58,48,106,90,126,216,0,0,0,0
"8900",2016-12-01,"sbpb","transporte não regular","voo internacional",0,0,0,0,0,0,0,0,0,0
"8901",2016-12-01,"sbpj","transporte regular","voo doméstico",257,258,515,26440,24898,51338,0,0,0,0
"8902",2016-12-01,"sbpj","transporte regular","voo internacional",0,0,0,0,0,0,0,0,0,0
"8903",2016-12-01,"sbpj","transporte não regular","voo doméstico",216,216,432,1309,1129,2438,0,0,0,0
"8904",2016-12-01,"sbpj","transporte não regular","voo internacional",0,0,0,0,0,0,0,0,0,0
"8905",2016-12-01,"sbpk","transporte regular","voo doméstico",24,24,48,1229,1301,2530,0,0,0,0
"8906",2016-12-01,"sbpk","transporte regular","voo internacional",0,0,0,0,0,0,0,0,0,0
"8907",2016-12-01,"sbpk","transporte não regular","voo doméstico",59,57,116,106,134,240,0,0,0,0
"8908",2016-12-01,"sbpk","transporte não regular","voo internacional",5,6,11,11,11,22,0,0,0,0
"8909",2016-12-01,"sbpl","transporte regular","voo doméstico",196,195,391,22962,22489,45451,0,0,0,0
"8910",2016-12-01,"sbpl","transporte regular","voo internacional",1,1,2,0,0,0,0,0,0,0
"8911",2016-12-01,"sbpl","transporte não regular","voo doméstico",85,89,174,644,667,1311,0,0,0,0
"8912",2016-12-01,"sbpl","transporte não regular","voo internacional",3,3,6,0,0,0,0,0,0,0
"8913",2016-12-01,"sbpp","transporte regular","voo doméstico",0,0,0,0,0,0,0,0,0,0
"8914",2016-12-01,"sbpp","transporte regular","voo internacional",0,0,0,0,0,0,0,0,0,0
"8915",2016-12-01,"sbpp","transporte não regular","voo doméstico",85,87,172,138,121,259,0,0,0,0
"8916",2016-12-01,"sbpp","transporte não regular","voo internacional",9,7,16,5,10,15,0,0,0,0
"8917",2016-12-01,"sbpr","transporte regular","voo doméstico",0,0,0,0,0,0,0,0,0,0
"8918",2016-12-01,"sbpr","transporte regular","voo internacional",0,0,0,0,0,0,0,0,0,0
"8919",2016-12-01,"sbpr","transporte não regular","voo doméstico",525,541,1066,580,509,1089,0,0,0,0
"8920",2016-12-01,"sbpr","transporte não regular","voo internacional",3,3,6,0,0,0,0,0,0,0
"8921",2016-12-01,"sbpv","transporte regular","voo doméstico",384,384,768,43251,37009,80260,0,0,0,0
"8922",2016-12-01,"sbpv","transporte regular","voo internacional",0,0,0,0,0,0,0,0,0,0
"8923",2016-12-01,"sbpv","transporte não regular","voo doméstico",223,222,445,385,381,766,0,0,0,0
"8924",2016-12-01,"sbpv","transporte não regular","voo internacional",2,2,4,0,0,0,0,0,0,0
"8925",2016-12-01,"sbrb","transporte regular","voo doméstico",154,158,312,18585,16295,34880,0,0,0,0
"8926",2016-12-01,"sbrb","transporte regular","voo internacional",0,0,0,0,0,0,0,0,0,0
"8927",2016-12-01,"sbrb","transporte não regular","voo doméstico",124,123,247,771,467,1238,0,0,0,0
"8928",2016-12-01,"sbrb","transporte não regular","voo internacional",1,0,1,0,0,0,0,0,0,0
"8929",2016-12-01,"sbrj","transporte regular","voo doméstico",3703,3725,7428,374394,415239,789633,0,0,0,0
"8930",2016-12-01,"sbrj","transporte regular","voo internacional",0,0,0,0,0,0,0,0,0,0
"8931",2016-12-01,"sbrj","transporte não regular","voo doméstico",691,669,1360,8878,9871,18749,0,0,0,0
"8932",2016-12-01,"sbrj","transporte não regular","voo internacional",0,0,0,0,0,0,0,0,0,0
"8933",2016-12-01,"sbsj","transporte regular","voo doméstico",0,0,0,0,0,0,0,0,0,0
"8934",2016-12-01,"sbsj","transporte regular","voo internacional",0,0,0,0,0,0,0,0,0,0
"8935",2016-12-01,"sbsj","transporte não regular","voo doméstico",268,267,535,1050,1020,2070,0,0,0,0
"8936",2016-12-01,"sbsj","transporte não regular","voo internacional",6,26,32,54,13,67,0,0,0,0
"8937",2016-12-01,"sbsl","transporte regular","voo doméstico",576,608,1184,57608,66803,124411,112,0,112,0
"8938",2016-12-01,"sbsl","transporte regular","voo internacional",0,0,0,0,0,0,0,0,0,0
"8939",2016-12-01,"sbsl","transporte não regular","voo doméstico",303,265,568,6669,14782,21451,57464,195414,252878,0
"8940",2016-12-01,"sbsl","transporte não regular","voo internacional",1,1,2,0,0,0,0,0,0,0
"8941",2016-12-01,"sbsn","transporte regular","voo doméstico",274,272,546,22423,22312,44735,0,0,0,0
"8942",2016-12-01,"sbsn","transporte regular","voo internacional",0,0,0,0,0,0,0,0,0,0
"8943",2016-12-01,"sbsn","transporte não regular","voo doméstico",208,208,416,760,655,1415,0,0,0,0
"8944",2016-12-01,"sbsn","transporte não regular","voo internacional",0,0,0,0,0,0,0,0,0,0
"8945",2016-12-01,"sbsp","transporte regular","voo doméstico",7353,7410,14763,978745,892555,1871300,0,0,0,0
"8946",2016-12-01,"sbsp","transporte regular","voo internacional",0,0,0,0,0,0,0,0,0,0
"8947",2016-12-01,"sbsp","transporte não regular","voo doméstico",1929,1893,3822,22307,17360,39667,0,0,0,0
"8948",2016-12-01,"sbsp","transporte não regular","voo internacional",0,0,0,0,0,0,0,0,0,0
"8949",2016-12-01,"sbte","transporte regular","voo doméstico",501,497,998,43390,55695,99085,21433,83405,104838,249734
"8950",2016-12-01,"sbte","transporte regular","voo internacional",0,0,0,0,0,0,0,0,0,0
"8951",2016-12-01,"sbte","transporte não regular","voo doméstico",183,198,381,2152,1819,3971,0,4459,4459,8511
"8952",2016-12-01,"sbte","transporte não regular","voo internacional",0,0,0,0,0,0,0,0,0,0
"8953",2016-12-01,"sbtf","transporte regular","voo doméstico",30,30,60,1441,1536,2977,0,0,0,0
"8954",2016-12-01,"sbtf","transporte regular","voo internacional",0,0,0,0,0,0,0,0,0,0
"8955",2016-12-01,"sbtf","transporte não regular","voo doméstico",121,121,242,885,959,1844,3865,4604,8469,8313
"8956",2016-12-01,"sbtf","transporte não regular","voo internacional",0,0,0,0,0,0,0,0,0,0
"8957",2016-12-01,"sbtt","transporte regular","voo doméstico",32,32,64,2536,3530,6066,0,75,75,0
"8958",2016-12-01,"sbtt","transporte regular","voo internacional",0,0,0,0,0,0,0,0,0,0
"8959",2016-12-01,"sbtt","transporte não regular","voo doméstico",86,87,173,396,342,738,1496,4193,5689,498
"8960",2016-12-01,"sbtt","transporte não regular","voo internacional",3,2,5,2,10,12,0,0,0,0
"8961",2016-12-01,"sbuf","transporte regular","voo doméstico",9,9,18,587,509,1096,0,0,0,0
"8962",2016-12-01,"sbuf","transporte regular","voo internacional",0,0,0,0,0,0,0,0,0,0
"8963",2016-12-01,"sbuf","transporte não regular","voo doméstico",33,33,66,84,77,161,0,0,0,0
"8964",2016-12-01,"sbuf","transporte não regular","voo internacional",0,0,0,0,0,0,0,0,0,0
"8965",2016-12-01,"sbug","transporte regular","voo doméstico",14,14,28,780,809,1589,0,0,0,0
"8966",2016-12-01,"sbug","transporte regular","voo internacional",0,0,0,0,0,0,0,0,0,0
"8967",2016-12-01,"sbug","transporte não regular","voo doméstico",20,20,40,494,445,939,0,0,0,0
"8968",2016-12-01,"sbug","transporte não regular","voo internacional",0,0,0,0,0,0,0,0,0,0
"8969",2016-12-01,"sbul","transporte regular","voo doméstico",458,460,918,43331,42378,85709,0,0,0,0
"8970",2016-12-01,"sbul","transporte regular","voo internacional",0,0,0,0,0,0,0,0,0,0
"8971",2016-12-01,"sbul","transporte não regular","voo doméstico",519,516,1035,3188,2285,5473,0,0,0,0
"8972",2016-12-01,"sbul","transporte não regular","voo internacional",0,0,0,0,0,0,0,0,0,0
"8973",2016-12-01,"sbur","transporte regular","voo doméstico",58,57,115,2625,3036,5661,0,0,0,0
"8974",2016-12-01,"sbur","transporte regular","voo internacional",0,0,0,0,0,0,0,0,0,0
"8975",2016-12-01,"sbur","transporte não regular","voo doméstico",144,143,287,488,510,998,0,0,0,0
"8976",2016-12-01,"sbur","transporte não regular","voo internacional",0,0,0,0,0,0,0,0,0,0
"8977",2016-02-01,"sbbe","transporte regular","voo doméstico",1154,1178,2332,116208,107090,223298,91157,286058,377215,0
"8978",2016-02-01,"sbbe","transporte regular","voo internacional",54,54,108,4499,4715,9214,0,6,6,0
"8979",2016-02-01,"sbbe","transporte não regular","voo doméstico",400,382,782,2935,4709,7644,0,0,0,0
"8980",2016-02-01,"sbbe","transporte não regular","voo internacional",13,10,23,223,208,431,0,0,0,0
"8981",2016-02-01,"sbbg","transporte regular","voo doméstico",0,0,0,0,0,0,0,0,0,0
"8982",2016-02-01,"sbbg","transporte regular","voo internacional",0,0,0,0,0,0,0,0,0,0
"8983",2016-02-01,"sbbg","transporte não regular","voo doméstico",11,12,23,52,52,104,0,0,0,0
"8984",2016-02-01,"sbbg","transporte não regular","voo internacional",1,1,2,2,0,2,0,0,0,0
"8985",2016-02-01,"sbbh","transporte regular","voo doméstico",153,151,304,7733,6831,14564,0,0,0,0
"8986",2016-02-01,"sbbh","transporte regular","voo internacional",0,0,0,0,0,0,0,0,0,0
"8987",2016-02-01,"sbbh","transporte não regular","voo doméstico",1674,1675,3349,10535,10646,21181,0,0,0,0
"8988",2016-02-01,"sbbh","transporte não regular","voo internacional",3,2,5,7,13,20,0,0,0,0
"8989",2016-02-01,"sbbi","transporte regular","voo doméstico",0,0,0,0,0,0,0,0,0,0
"8990",2016-02-01,"sbbi","transporte regular","voo internacional",0,0,0,0,0,0,0,0,0,0
"8991",2016-02-01,"sbbi","transporte não regular","voo doméstico",794,786,1580,4198,4263,8461,0,0,0,0
"8992",2016-02-01,"sbbi","transporte não regular","voo internacional",2,2,4,0,0,0,0,0,0,0
"8993",2016-02-01,"sbbv","transporte regular","voo doméstico",97,97,194,10997,12589,23586,0,0,0,0
"8994",2016-02-01,"sbbv","transporte regular","voo internacional",0,0,0,0,0,0,0,0,0,0
"8995",2016-02-01,"sbbv","transporte não regular","voo doméstico",220,220,440,125,67,192,0,0,0,0
"8996",2016-02-01,"sbbv","transporte não regular","voo internacional",12,12,24,0,0,0,0,0,0,0
"8997",2016-02-01,"sbcg","transporte regular","voo doméstico",563,562,1125,50980,53125,104105,61185,123615,184800,0
"8998",2016-02-01,"sbcg","transporte regular","voo internacional",0,0,0,0,0,0,0,0,0,0
"8999",2016-02-01,"sbcg","transporte não regular","voo doméstico",202,205,407,403,653,1056,0,0,0,0
"9000",2016-02-01,"sbcg","transporte não regular","voo internacional",1,1,2,0,0,0,0,0,0,0
"9001",2016-02-01,"sbcj","transporte regular","voo doméstico",77,77,154,6552,6242,12794,0,0,0,0
"9002",2016-02-01,"sbcj","transporte regular","voo internacional",0,0,0,0,0,0,0,0,0,0
"9003",2016-02-01,"sbcj","transporte não regular","voo doméstico",70,69,139,218,61,279,0,0,0,0
"9004",2016-02-01,"sbcj","transporte não regular","voo internacional",0,0,0,0,0,0,0,0,0,0
"9005",2016-02-01,"sbcr","transporte regular","voo doméstico",16,16,32,1146,1284,2430,0,0,0,0
"9006",2016-02-01,"sbcr","transporte regular","voo internacional",0,0,0,0,0,0,0,0,0,0
"9007",2016-02-01,"sbcr","transporte não regular","voo doméstico",41,40,81,310,381,691,0,0,0,0
"9008",2016-02-01,"sbcr","transporte não regular","voo internacional",2,2,4,5,5,10,0,0,0,0
"9009",2016-02-01,"sbct","transporte regular","voo doméstico",2468,2455,4923,243267,246259,489526,124466,0,124466,138876
"9010",2016-02-01,"sbct","transporte regular","voo internacional",60,59,119,1804,2424,4228,0,668,668,0
"9011",2016-02-01,"sbct","transporte não regular","voo doméstico",221,233,454,2743,2235,4978,0,0,0,0
"9012",2016-02-01,"sbct","transporte não regular","voo internacional",6,7,13,27,85,112,0,0,0,0
"9013",2016-02-01,"sbcz","transporte regular","voo doméstico",26,26,52,2462,2205,4667,0,0,0,0
"9014",2016-02-01,"sbcz","transporte regular","voo internacional",0,0,0,0,0,0,0,0,0,0
"9015",2016-02-01,"sbcz","transporte não regular","voo doméstico",136,137,273,471,485,956,0,0,0,0
"9016",2016-02-01,"sbcz","transporte não regular","voo internacional",0,0,0,0,0,0,0,0,0,0
"9017",2016-02-01,"sbeg","transporte regular","voo doméstico",965,966,1931,102569,105976,208545,0,0,0,0
"9018",2016-02-01,"sbeg","transporte regular","voo internacional",119,122,241,5133,7220,12353,0,0,0,0
"9019",2016-02-01,"sbeg","transporte não regular","voo doméstico",448,453,901,6054,5764,11818,0,0,0,0
"9020",2016-02-01,"sbeg","transporte não regular","voo internacional",111,111,222,625,627,1252,0,0,0,0
"9021",2016-02-01,"sbfi","transporte regular","voo doméstico",576,577,1153,76120,77025,153145,0,0,0,0
"9022",2016-02-01,"sbfi","transporte regular","voo internacional",21,21,42,2830,2810,5640,0,0,0,0
"9023",2016-02-01,"sbfi","transporte não regular","voo doméstico",104,108,212,1793,3207,5000,0,0,0,0
"9024",2016-02-01,"sbfi","transporte não regular","voo internacional",27,25,52,217,92,309,0,0,0,0
"9025",2016-02-01,"sbgo","transporte regular","voo doméstico",1233,1228,2461,105658,103652,209310,134181,141733,275914,154810
"9026",2016-02-01,"sbgo","transporte regular","voo internacional",0,0,0,0,0,0,0,0,0,0
"9027",2016-02-01,"sbgo","transporte não regular","voo doméstico",1139,1151,2290,5887,5916,11803,0,0,0,0
"9028",2016-02-01,"sbgo","transporte não regular","voo internacional",0,0,0,0,0,0,0,0,0,0
"9029",2016-02-01,"sbht","transporte regular","voo doméstico",174,174,348,10373,9017,19390,0,0,0,0
"9030",2016-02-01,"sbht","transporte regular","voo internacional",0,0,0,0,0,0,0,0,0,0
"9031",2016-02-01,"sbht","transporte não regular","voo doméstico",175,177,352,361,389,750,0,220,220,200
"9032",2016-02-01,"sbht","transporte não regular","voo internacional",0,0,0,0,0,0,0,0,0,0
"9033",2016-02-01,"sbiz","transporte regular","voo doméstico",185,184,369,14015,12180,26195,0,0,0,0
"9034",2016-02-01,"sbiz","transporte regular","voo internacional",0,0,0,0,0,0,0,0,0,0
"9035",2016-02-01,"sbiz","transporte não regular","voo doméstico",85,85,170,190,192,382,0,0,0,0
"9036",2016-02-01,"sbiz","transporte não regular","voo internacional",0,0,0,0,0,0,0,0,0,0
"9037",2016-02-01,"sbjc","transporte regular","voo doméstico",0,0,0,0,0,0,0,0,0,0
"9038",2016-02-01,"sbjc","transporte regular","voo internacional",0,0,0,0,0,0,0,0,0,0
"9039",2016-02-01,"sbjc","transporte não regular","voo doméstico",387,389,776,767,567,1334,0,0,0,0
"9040",2016-02-01,"sbjc","transporte não regular","voo internacional",1,0,1,0,0,0,0,0,0,0
"9041",2016-02-01,"sbjr","transporte regular","voo doméstico",0,0,0,0,0,0,0,0,0,0
"9042",2016-02-01,"sbjr","transporte regular","voo internacional",0,0,0,0,0,0,0,0,0,0
"9043",2016-02-01,"sbjr","transporte não regular","voo doméstico",2764,2768,5532,9483,7024,16507,0,0,0,0
"9044",2016-02-01,"sbjr","transporte não regular","voo internacional",0,0,0,0,0,0,0,0,0,0
"9045",2016-02-01,"sbjv","transporte regular","voo doméstico",227,227,454,16623,16678,33301,0,0,0,0
"9046",2016-02-01,"sbjv","transporte regular","voo internacional",0,0,0,0,0,0,0,0,0,0
"9047",2016-02-01,"sbjv","transporte não regular","voo doméstico",120,120,240,75,72,147,0,0,0,0
"9048",2016-02-01,"sbjv","transporte não regular","voo internacional",0,0,0,0,0,0,0,0,0,0
"9049",2016-02-01,"sblo","transporte regular","voo doméstico",431,439,870,35374,33842,69216,0,0,0,0
"9050",2016-02-01,"sblo","transporte regular","voo internacional",0,0,0,0,0,0,0,0,0,0
"9051",2016-02-01,"sblo","transporte não regular","voo doméstico",465,461,926,463,778,1241,0,0,0,0
"9052",2016-02-01,"sblo","transporte não regular","voo internacional",1,1,2,0,0,0,0,0,0,0
"9053",2016-02-01,"sbma","transporte regular","voo doméstico",139,138,277,11953,10806,22759,0,0,0,0
"9054",2016-02-01,"sbma","transporte regular","voo internacional",0,0,0,0,0,0,0,0,0,0
"9055",2016-02-01,"sbma","transporte não regular","voo doméstico",172,172,344,482,531,1013,0,0,0,0
"9056",2016-02-01,"sbma","transporte não regular","voo internacional",0,0,0,0,0,0,0,0,0,0
"9057",2016-02-01,"sbmk","transporte regular","voo doméstico",149,146,295,10535,10414,20949,0,0,0,0
"9058",2016-02-01,"sbmk","transporte regular","voo internacional",0,0,0,0,0,0,0,0,0,0
"9059",2016-02-01,"sbmk","transporte não regular","voo doméstico",202,202,404,259,206,465,0,0,0,0
"9060",2016-02-01,"sbmk","transporte não regular","voo internacional",0,0,0,0,0,0,0,0,0,0
"9061",2016-02-01,"sbmq","transporte regular","voo doméstico",197,199,396,20945,21691,42636,15700,30900,46600,0
"9062",2016-02-01,"sbmq","transporte regular","voo internacional",0,0,0,0,0,0,0,0,0,0
"9063",2016-02-01,"sbmq","transporte não regular","voo doméstico",162,161,323,186,212,398,0,0,0,0
"9064",2016-02-01,"sbmq","transporte não regular","voo internacional",3,4,7,0,0,0,0,0,0,0
"9065",2016-02-01,"sbmt","transporte regular","voo doméstico",0,0,0,0,0,0,0,0,0,0
"9066",2016-02-01,"sbmt","transporte regular","voo internacional",0,0,0,0,0,0,0,0,0,0
"9067",2016-02-01,"sbmt","transporte não regular","voo doméstico",3142,3165,6307,5759,5602,11361,0,0,0,0
"9068",2016-02-01,"sbmt","transporte não regular","voo internacional",0,0,0,0,0,0,0,0,0,0
"9069",2016-02-01,"sbnf","transporte regular","voo doméstico",629,628,1257,60615,58831,119446,0,0,0,0
"9070",2016-02-01,"sbnf","transporte regular","voo internacional",0,0,0,0,0,0,0,0,0,0
"9071",2016-02-01,"sbnf","transporte não regular","voo doméstico",251,253,504,987,1413,2400,0,0,0,0
"9072",2016-02-01,"sbnf","transporte não regular","voo internacional",5,5,10,13,11,24,0,0,0,0
"9073",2016-02-01,"sbpb","transporte regular","voo doméstico",1,1,2,14,44,58,0,0,0,0
"9074",2016-02-01,"sbpb","transporte regular","voo internacional",0,0,0,0,0,0,0,0,0,0
"9075",2016-02-01,"sbpb","transporte não regular","voo doméstico",58,58,116,493,403,896,0,0,0,0
"9076",2016-02-01,"sbpb","transporte não regular","voo internacional",0,0,0,0,0,0,0,0,0,0
"9077",2016-02-01,"sbpj","transporte regular","voo doméstico",282,285,567,23856,22841,46697,0,0,0,0
"9078",2016-02-01,"sbpj","transporte regular","voo internacional",0,0,0,0,0,0,0,0,0,0
"9079",2016-02-01,"sbpj","transporte não regular","voo doméstico",241,237,478,711,459,1170,0,0,0,0
"9080",2016-02-01,"sbpj","transporte não regular","voo internacional",1,1,2,0,0,0,0,0,0,0
"9081",2016-02-01,"sbpk","transporte regular","voo doméstico",40,41,81,1748,1853,3601,0,0,0,0
"9082",2016-02-01,"sbpk","transporte regular","voo internacional",0,0,0,0,2,2,0,0,0,0
"9083",2016-02-01,"sbpk","transporte não regular","voo doméstico",30,26,56,55,57,112,0,0,0,0
"9084",2016-02-01,"sbpk","transporte não regular","voo internacional",6,9,15,11,11,22,0,0,0,0
"9085",2016-02-01,"sbpl","transporte regular","voo doméstico",117,117,234,14921,15117,30038,0,0,0,0
"9086",2016-02-01,"sbpl","transporte regular","voo internacional",1,1,2,0,0,0,0,0,0,0
"9087",2016-02-01,"sbpl","transporte não regular","voo doméstico",94,91,185,1587,1254,2841,0,0,0,0
"9088",2016-02-01,"sbpl","transporte não regular","voo internacional",0,0,0,0,0,0,0,0,0,0
"9089",2016-02-01,"sbpp","transporte regular","voo doméstico",0,0,0,0,0,0,0,0,0,0
"9090",2016-02-01,"sbpp","transporte regular","voo internacional",0,0,0,0,0,0,0,0,0,0
"9091",2016-02-01,"sbpp","transporte não regular","voo doméstico",63,60,123,106,105,211,0,0,0,0
"9092",2016-02-01,"sbpp","transporte não regular","voo internacional",6,7,13,1,1,2,0,0,0,0
"9093",2016-02-01,"sbpr","transporte regular","voo doméstico",0,0,0,0,0,0,0,0,0,0
"9094",2016-02-01,"sbpr","transporte regular","voo internacional",0,0,0,0,0,0,0,0,0,0
"9095",2016-02-01,"sbpr","transporte não regular","voo doméstico",761,756,1517,918,850,1768,0,0,0,0
"9096",2016-02-01,"sbpr","transporte não regular","voo internacional",0,0,0,0,0,0,0,0,0,0
"9097",2016-02-01,"sbpv","transporte regular","voo doméstico",395,396,791,32226,36390,68616,0,0,0,0
"9098",2016-02-01,"sbpv","transporte regular","voo internacional",0,0,0,0,0,0,0,0,0,0
"9099",2016-02-01,"sbpv","transporte não regular","voo doméstico",199,193,392,0,75,75,0,0,0,0
"9100",2016-02-01,"sbpv","transporte não regular","voo internacional",0,0,0,0,0,0,0,0,0,0
"9101",2016-02-01,"sbrb","transporte regular","voo doméstico",167,168,335,14465,16321,30786,0,0,0,313
"9102",2016-02-01,"sbrb","transporte regular","voo internacional",0,0,0,0,0,0,0,0,0,0
"9103",2016-02-01,"sbrb","transporte não regular","voo doméstico",82,80,162,386,107,493,0,0,0,0
"9104",2016-02-01,"sbrb","transporte não regular","voo internacional",0,0,0,0,0,0,0,0,0,0
"9105",2016-02-01,"sbrj","transporte regular","voo doméstico",3755,3762,7517,356402,353850,710252,0,0,0,0
"9106",2016-02-01,"sbrj","transporte regular","voo internacional",0,0,0,0,11,11,0,0,0,0
"9107",2016-02-01,"sbrj","transporte não regular","voo doméstico",713,712,1425,5828,5268,11096,0,0,0,0
"9108",2016-02-01,"sbrj","transporte não regular","voo internacional",2,2,4,0,0,0,0,0,0,0
"9109",2016-02-01,"sbsj","transporte regular","voo doméstico",25,25,50,2066,2327,4393,0,0,0,0
"9110",2016-02-01,"sbsj","transporte regular","voo internacional",0,0,0,0,0,0,0,0,0,0
"9111",2016-02-01,"sbsj","transporte não regular","voo doméstico",467,446,913,1370,1367,2737,0,0,0,0
"9112",2016-02-01,"sbsj","transporte não regular","voo internacional",2,14,16,35,11,46,0,0,0,0
"9113",2016-02-01,"sbsl","transporte regular","voo doméstico",612,607,1219,66581,64602,131183,0,0,0,0
"9114",2016-02-01,"sbsl","transporte regular","voo internacional",0,0,0,0,0,0,0,0,0,0
"9115",2016-02-01,"sbsl","transporte não regular","voo doméstico",215,224,439,1723,993,2716,51394,177984,229378,0
"9116",2016-02-01,"sbsl","transporte não regular","voo internacional",0,1,1,0,0,0,0,0,0,0
"9117",2016-02-01,"sbsn","transporte regular","voo doméstico",309,307,616,21238,18475,39713,0,0,0,0
"9118",2016-02-01,"sbsn","transporte regular","voo internacional",0,0,0,0,0,0,0,0,0,0
"9119",2016-02-01,"sbsn","transporte não regular","voo doméstico",250,249,499,814,581,1395,0,0,0,0
"9120",2016-02-01,"sbsn","transporte não regular","voo internacional",0,0,0,0,0,0,0,0,0,0
"9121",2016-02-01,"sbsp","transporte regular","voo doméstico",6663,6752,13415,738738,737663,1476401,0,0,0,0
"9122",2016-02-01,"sbsp","transporte regular","voo internacional",0,0,0,0,0,0,0,0,0,0
"9123",2016-02-01,"sbsp","transporte não regular","voo doméstico",1588,1482,3070,8885,9667,18552,0,0,0,0
"9124",2016-02-01,"sbsp","transporte não regular","voo internacional",0,0,0,0,0,0,0,0,0,0
"9125",2016-02-01,"sbte","transporte regular","voo doméstico",487,484,971,44352,39799,84151,20922,63271,84193,207817
"9126",2016-02-01,"sbte","transporte regular","voo internacional",0,0,0,0,0,0,0,0,0,0
"9127",2016-02-01,"sbte","transporte não regular","voo doméstico",160,167,327,1693,1494,3187,0,0,0,0
"9128",2016-02-01,"sbte","transporte não regular","voo internacional",6,6,12,0,0,0,0,0,0,0
"9129",2016-02-01,"sbtf","transporte regular","voo doméstico",40,40,80,1419,1837,3256,0,0,0,0
"9130",2016-02-01,"sbtf","transporte regular","voo internacional",0,0,0,0,0,0,0,0,0,0
"9131",2016-02-01,"sbtf","transporte não regular","voo doméstico",148,147,295,258,272,530,1789,1774,3563,8681
"9132",2016-02-01,"sbtf","transporte não regular","voo internacional",2,1,3,0,0,0,0,0,0,0
"9133",2016-02-01,"sbtt","transporte regular","voo doméstico",30,30,60,2050,2962,5012,0,0,0,0
"9134",2016-02-01,"sbtt","transporte regular","voo internacional",0,0,0,0,0,0,0,0,0,0
"9135",2016-02-01,"sbtt","transporte não regular","voo doméstico",68,67,135,309,317,626,626,1509,2135,170
"9136",2016-02-01,"sbtt","transporte não regular","voo internacional",1,1,2,2,1,3,0,0,0,0
"9137",2016-02-01,"sbuf","transporte regular","voo doméstico",9,9,18,481,353,834,0,0,0,0
"9138",2016-02-01,"sbuf","transporte regular","voo internacional",0,0,0,0,0,0,0,0,0,0
"9139",2016-02-01,"sbuf","transporte não regular","voo doméstico",32,32,64,96,105,201,0,0,0,0
"9140",2016-02-01,"sbuf","transporte não regular","voo internacional",0,0,0,0,0,0,0,0,0,0
"9141",2016-02-01,"sbug","transporte regular","voo doméstico",21,21,42,1092,1128,2220,0,0,0,0
"9142",2016-02-01,"sbug","transporte regular","voo internacional",0,0,0,0,0,0,0,0,0,0
"9143",2016-02-01,"sbug","transporte não regular","voo doméstico",11,11,22,84,84,168,0,0,0,0
"9144",2016-02-01,"sbug","transporte não regular","voo internacional",0,0,0,0,0,0,0,0,0,0
"9145",2016-02-01,"sbul","transporte regular","voo doméstico",459,460,919,38517,38698,77215,0,0,0,0
"9146",2016-02-01,"sbul","transporte regular","voo internacional",0,0,0,0,0,0,0,0,0,0
"9147",2016-02-01,"sbul","transporte não regular","voo doméstico",449,449,898,1091,1282,2373,0,0,0,0
"9148",2016-02-01,"sbul","transporte não regular","voo internacional",0,0,0,0,0,0,0,0,0,0
"9149",2016-02-01,"sbur","transporte regular","voo doméstico",65,67,132,2831,2855,5686,0,0,0,0
"9150",2016-02-01,"sbur","transporte regular","voo internacional",0,0,0,0,0,0,0,0,0,0
"9151",2016-02-01,"sbur","transporte não regular","voo doméstico",182,185,367,1447,1413,2860,0,0,0,0
"9152",2016-02-01,"sbur","transporte não regular","voo internacional",0,0,0,0,0,0,0,0,0,0
"9153",2016-01-01,"sbbe","transporte regular","voo doméstico",1416,1419,2835,152233,146694,298927,90920,295966,386886,0
"9154",2016-01-01,"sbbe","transporte regular","voo internacional",61,62,123,6093,5204,11297,0,34,34,0
"9155",2016-01-01,"sbbe","transporte não regular","voo doméstico",443,432,875,4039,4672,8711,0,0,0,0
"9156",2016-01-01,"sbbe","transporte não regular","voo internacional",8,10,18,20,40,60,0,0,0,0
"9157",2016-01-01,"sbbg","transporte regular","voo doméstico",0,0,0,0,0,0,0,0,0,0
"9158",2016-01-01,"sbbg","transporte regular","voo internacional",0,0,0,0,0,0,0,0,0,0
"9159",2016-01-01,"sbbg","transporte não regular","voo doméstico",17,15,32,71,92,163,0,0,0,0
"9160",2016-01-01,"sbbg","transporte não regular","voo internacional",2,3,5,12,7,19,0,0,0,0
"9161",2016-01-01,"sbbh","transporte regular","voo doméstico",127,137,264,6090,6600,12690,0,0,0,0
"9162",2016-01-01,"sbbh","transporte regular","voo internacional",0,0,0,0,0,0,0,0,0,0
"9163",2016-01-01,"sbbh","transporte não regular","voo doméstico",1403,1370,2773,9568,8880,18448,0,0,0,0
"9164",2016-01-01,"sbbh","transporte não regular","voo internacional",1,1,2,7,7,14,0,0,0,0
"9165",2016-01-01,"sbbi","transporte regular","voo doméstico",0,0,0,0,0,0,0,0,0,0
"9166",2016-01-01,"sbbi","transporte regular","voo internacional",0,0,0,0,0,0,0,0,0,0
"9167",2016-01-01,"sbbi","transporte não regular","voo doméstico",958,944,1902,3027,3433,6460,0,0,0,0
"9168",2016-01-01,"sbbi","transporte não regular","voo internacional",0,0,0,0,0,0,0,0,0,0
"9169",2016-01-01,"sbbv","transporte regular","voo doméstico",113,113,226,14840,15734,30574,0,0,0,0
"9170",2016-01-01,"sbbv","transporte regular","voo internacional",0,0,0,0,0,0,0,0,0,0
"9171",2016-01-01,"sbbv","transporte não regular","voo doméstico",229,232,461,196,185,381,0,0,0,0
"9172",2016-01-01,"sbbv","transporte não regular","voo internacional",14,9,23,4,4,8,0,0,0,0
"9173",2016-01-01,"sbcg","transporte regular","voo doméstico",688,689,1377,67263,69032,136295,61805,132094,193899,0
"9174",2016-01-01,"sbcg","transporte regular","voo internacional",0,0,0,0,0,0,0,0,0,0
"9175",2016-01-01,"sbcg","transporte não regular","voo doméstico",156,151,307,777,792,1569,0,0,0,0
"9176",2016-01-01,"sbcg","transporte não regular","voo internacional",3,2,5,0,0,0,0,0,0,0
"9177",2016-01-01,"sbcj","transporte regular","voo doméstico",81,83,164,6592,7602,14194,0,0,0,0
"9178",2016-01-01,"sbcj","transporte regular","voo internacional",0,0,0,0,0,0,0,0,0,0
"9179",2016-01-01,"sbcj","transporte não regular","voo doméstico",54,52,106,42,105,147,0,0,0,0
"9180",2016-01-01,"sbcj","transporte não regular","voo internacional",0,0,0,0,0,0,0,0,0,0
"9181",2016-01-01,"sbcr","transporte regular","voo doméstico",18,18,36,1391,1396,2787,0,0,0,0
"9182",2016-01-01,"sbcr","transporte regular","voo internacional",0,0,0,0,0,0,0,0,0,0
"9183",2016-01-01,"sbcr","transporte não regular","voo doméstico",32,32,64,348,334,682,0,0,0,0
"9184",2016-01-01,"sbcr","transporte não regular","voo internacional",7,7,14,10,10,20,0,0,0,0
"9185",2016-01-01,"sbct","transporte regular","voo doméstico",2626,2620,5246,278982,273185,552167,147909,0,147909,147641
"9186",2016-01-01,"sbct","transporte regular","voo internacional",80,80,160,2966,4842,7808,0,2357,2357,0
"9187",2016-01-01,"sbct","transporte não regular","voo doméstico",189,195,384,2207,2208,4415,0,0,0,0
"9188",2016-01-01,"sbct","transporte não regular","voo internacional",10,7,17,2,190,192,0,0,0,0
"9189",2016-01-01,"sbcz","transporte regular","voo doméstico",30,30,60,3558,2675,6233,0,0,0,0
"9190",2016-01-01,"sbcz","transporte regular","voo internacional",0,0,0,0,0,0,0,0,0,0
"9191",2016-01-01,"sbcz","transporte não regular","voo doméstico",149,146,295,602,576,1178,0,0,0,0
"9192",2016-01-01,"sbcz","transporte não regular","voo internacional",1,1,2,0,0,0,0,0,0,0
"9193",2016-01-01,"sbeg","transporte regular","voo doméstico",1152,1141,2293,134040,139653,273693,7,0,7,0
"9194",2016-01-01,"sbeg","transporte regular","voo internacional",141,139,280,9161,10464,19625,0,0,0,0
"9195",2016-01-01,"sbeg","transporte não regular","voo doméstico",540,552,1092,8111,8464,16575,0,0,0,0
"9196",2016-01-01,"sbeg","transporte não regular","voo internacional",94,95,189,648,829,1477,0,0,0,0
"9197",2016-01-01,"sbfi","transporte regular","voo doméstico",656,655,1311,93370,82620,175990,0,0,0,0
"9198",2016-01-01,"sbfi","transporte regular","voo internacional",22,22,44,3013,2811,5824,0,0,0,0
"9199",2016-01-01,"sbfi","transporte não regular","voo doméstico",181,181,362,6615,6552,13167,0,0,0,0
"9200",2016-01-01,"sbfi","transporte não regular","voo internacional",32,35,67,57,49,106,0,0,0,0
"9201",2016-01-01,"sbgo","transporte regular","voo doméstico",1398,1403,2801,137288,141922,279210,106138,157353,263491,174692
"9202",2016-01-01,"sbgo","transporte regular","voo internacional",0,0,0,0,0,0,0,0,0,0
"9203",2016-01-01,"sbgo","transporte não regular","voo doméstico",851,818,1669,6057,6941,12998,0,0,0,0
"9204",2016-01-01,"sbgo","transporte não regular","voo internacional",2,2,4,0,0,0,0,0,0,0
"9205",2016-01-01,"sbht","transporte regular","voo doméstico",188,188,376,10781,11523,22304,0,0,0,0
"9206",2016-01-01,"sbht","transporte regular","voo internacional",0,0,0,0,0,0,0,0,0,0
"9207",2016-01-01,"sbht","transporte não regular","voo doméstico",163,160,323,464,964,1428,300,1450,1750,1200
"9208",2016-01-01,"sbht","transporte não regular","voo internacional",0,0,0,0,0,0,0,0,0,0
"9209",2016-01-01,"sbiz","transporte regular","voo doméstico",202,201,403,14506,14703,29209,0,0,0,0
"9210",2016-01-01,"sbiz","transporte regular","voo internacional",0,0,0,0,0,0,0,0,0,0
"9211",2016-01-01,"sbiz","transporte não regular","voo doméstico",103,108,211,192,179,371,0,0,0,0
"9212",2016-01-01,"sbiz","transporte não regular","voo internacional",0,0,0,0,0,0,0,0,0,0
"9213",2016-01-01,"sbjc","transporte regular","voo doméstico",0,0,0,0,0,0,0,0,0,0
"9214",2016-01-01,"sbjc","transporte regular","voo internacional",0,0,0,0,0,0,0,0,0,0
"9215",2016-01-01,"sbjc","transporte não regular","voo doméstico",397,397,794,754,756,1510,0,0,0,0
"9216",2016-01-01,"sbjc","transporte não regular","voo internacional",0,0,0,0,0,0,0,0,0,0
"9217",2016-01-01,"sbjr","transporte regular","voo doméstico",0,0,0,0,0,0,0,0,0,0
"9218",2016-01-01,"sbjr","transporte regular","voo internacional",0,0,0,0,0,0,0,0,0,0
"9219",2016-01-01,"sbjr","transporte não regular","voo doméstico",2500,2497,4997,9255,7590,16845,0,0,0,0
"9220",2016-01-01,"sbjr","transporte não regular","voo internacional",0,0,0,0,0,0,0,0,0,0
"9221",2016-01-01,"sbjv","transporte regular","voo doméstico",231,232,463,21198,18987,40185,0,0,0,0
"9222",2016-01-01,"sbjv","transporte regular","voo internacional",0,0,0,0,0,0,0,0,0,0
"9223",2016-01-01,"sbjv","transporte não regular","voo doméstico",159,157,316,63,294,357,0,0,0,0
"9224",2016-01-01,"sbjv","transporte não regular","voo internacional",0,0,0,0,0,0,0,0,0,0
"9225",2016-01-01,"sblo","transporte regular","voo doméstico",413,430,843,38134,35020,73154,0,0,0,0
"9226",2016-01-01,"sblo","transporte regular","voo internacional",0,0,0,0,0,0,0,0,0,0
"9227",2016-01-01,"sblo","transporte não regular","voo doméstico",652,632,1284,3155,4501,7656,0,0,0,0
"9228",2016-01-01,"sblo","transporte não regular","voo internacional",2,2,4,0,0,0,0,0,0,0
"9229",2016-01-01,"sbma","transporte regular","voo doméstico",190,189,379,15243,15881,31124,0,0,0,0
"9230",2016-01-01,"sbma","transporte regular","voo internacional",0,0,0,0,0,0,0,0,0,0
"9231",2016-01-01,"sbma","transporte não regular","voo doméstico",137,138,275,494,1118,1612,0,0,0,0
"9232",2016-01-01,"sbma","transporte não regular","voo internacional",1,1,2,0,0,0,0,0,0,0
"9233",2016-01-01,"sbmk","transporte regular","voo doméstico",109,108,217,11142,9359,20501,0,0,0,0
"9234",2016-01-01,"sbmk","transporte regular","voo internacional",0,0,0,0,0,0,0,0,0,0
"9235",2016-01-01,"sbmk","transporte não regular","voo doméstico",166,162,328,1126,1095,2221,0,0,0,0
"9236",2016-01-01,"sbmk","transporte não regular","voo internacional",1,1,2,0,0,0,0,0,0,0
"9237",2016-01-01,"sbmq","transporte regular","voo doméstico",243,240,483,27586,28792,56378,15650,26700,42350,0
"9238",2016-01-01,"sbmq","transporte regular","voo internacional",0,0,0,0,0,0,0,0,0,0
"9239",2016-01-01,"sbmq","transporte não regular","voo doméstico",165,170,335,341,54,395,0,0,0,0
"9240",2016-01-01,"sbmq","transporte não regular","voo internacional",2,2,4,0,0,0,0,0,0,0
"9241",2016-01-01,"sbmt","transporte regular","voo doméstico",0,0,0,0,0,0,0,0,0,0
"9242",2016-01-01,"sbmt","transporte regular","voo internacional",0,0,0,0,0,0,0,0,0,0
"9243",2016-01-01,"sbmt","transporte não regular","voo doméstico",3123,3081,6204,5367,5524,10891,0,0,0,0
"9244",2016-01-01,"sbmt","transporte não regular","voo internacional",0,0,0,0,0,0,0,0,0,0
"9245",2016-01-01,"sbnf","transporte regular","voo doméstico",744,738,1482,85050,75912,160962,0,0,0,0
"9246",2016-01-01,"sbnf","transporte regular","voo internacional",0,0,0,0,0,0,0,0,0,0
"9247",2016-01-01,"sbnf","transporte não regular","voo doméstico",400,409,809,3733,2912,6645,0,0,0,0
"9248",2016-01-01,"sbnf","transporte não regular","voo internacional",12,12,24,29,22,51,0,0,0,0
"9249",2016-01-01,"sbpb","transporte regular","voo doméstico",1,1,2,28,26,54,0,0,0,0
"9250",2016-01-01,"sbpb","transporte regular","voo internacional",0,0,0,0,0,0,0,0,0,0
"9251",2016-01-01,"sbpb","transporte não regular","voo doméstico",73,81,154,1074,889,1963,0,0,0,0
"9252",2016-01-01,"sbpb","transporte não regular","voo internacional",0,0,0,0,0,0,0,0,0,0
"9253",2016-01-01,"sbpj","transporte regular","voo doméstico",341,341,682,27221,29054,56275,0,0,0,0
"9254",2016-01-01,"sbpj","transporte regular","voo internacional",0,0,0,0,0,0,0,0,0,0
"9255",2016-01-01,"sbpj","transporte não regular","voo doméstico",166,167,333,472,396,868,0,0,0,0
"9256",2016-01-01,"sbpj","transporte não regular","voo internacional",1,1,2,0,0,0,0,0,0,0
"9257",2016-01-01,"sbpk","transporte regular","voo doméstico",29,29,58,1672,1397,3069,0,0,0,0
"9258",2016-01-01,"sbpk","transporte regular","voo internacional",0,0,0,0,0,0,0,0,0,0
"9259",2016-01-01,"sbpk","transporte não regular","voo doméstico",37,37,74,90,93,183,0,0,0,0
"9260",2016-01-01,"sbpk","transporte não regular","voo internacional",2,2,4,0,0,0,0,0,0,0
"9261",2016-01-01,"sbpl","transporte regular","voo doméstico",112,112,224,15897,16327,32224,0,0,0,0
"9262",2016-01-01,"sbpl","transporte regular","voo internacional",0,0,0,0,0,0,0,0,0,0
"9263",2016-01-01,"sbpl","transporte não regular","voo doméstico",128,127,255,4694,4725,9419,0,0,0,0
"9264",2016-01-01,"sbpl","transporte não regular","voo internacional",1,1,2,0,0,0,0,0,0,0
"9265",2016-01-01,"sbpp","transporte regular","voo doméstico",0,0,0,0,0,0,0,0,0,0
"9266",2016-01-01,"sbpp","transporte regular","voo internacional",0,0,0,0,0,0,0,0,0,0
"9267",2016-01-01,"sbpp","transporte não regular","voo doméstico",75,78,153,123,96,219,0,0,0,0
"9268",2016-01-01,"sbpp","transporte não regular","voo internacional",2,3,5,6,5,11,0,0,0,0
"9269",2016-01-01,"sbpr","transporte regular","voo doméstico",0,0,0,0,0,0,0,0,0,0
"9270",2016-01-01,"sbpr","transporte regular","voo internacional",0,0,0,0,0,0,0,0,0,0
"9271",2016-01-01,"sbpr","transporte não regular","voo doméstico",590,574,1164,665,673,1338,0,0,0,0
"9272",2016-01-01,"sbpr","transporte não regular","voo internacional",0,0,0,0,0,0,0,0,0,0
"9273",2016-01-01,"sbpv","transporte regular","voo doméstico",472,472,944,45717,46977,92694,0,0,0,0
"9274",2016-01-01,"sbpv","transporte regular","voo internacional",0,0,0,0,0,0,0,0,0,0
"9275",2016-01-01,"sbpv","transporte não regular","voo doméstico",175,174,349,324,293,617,0,0,0,0
"9276",2016-01-01,"sbpv","transporte não regular","voo internacional",0,0,0,0,0,0,0,0,0,0
"9277",2016-01-01,"sbrb","transporte regular","voo doméstico",187,186,373,18971,17765,36736,0,0,0,0
"9278",2016-01-01,"sbrb","transporte regular","voo internacional",0,0,0,0,0,0,0,0,0,0
"9279",2016-01-01,"sbrb","transporte não regular","voo doméstico",86,86,172,353,137,490,0,0,0,0
"9280",2016-01-01,"sbrb","transporte não regular","voo internacional",0,0,0,0,0,0,0,0,0,0
"9281",2016-01-01,"sbrj","transporte regular","voo doméstico",3894,3949,7843,417372,363857,781229,355,106,461,0
"9282",2016-01-01,"sbrj","transporte regular","voo internacional",0,0,0,0,0,0,0,0,0,0
"9283",2016-01-01,"sbrj","transporte não regular","voo doméstico",577,519,1096,6795,9523,16318,0,0,0,0
"9284",2016-01-01,"sbrj","transporte não regular","voo internacional",0,0,0,0,0,0,0,0,0,0
"9285",2016-01-01,"sbsj","transporte regular","voo doméstico",26,26,52,2633,2959,5592,0,0,0,0
"9286",2016-01-01,"sbsj","transporte regular","voo internacional",0,0,0,0,0,0,0,0,0,0
"9287",2016-01-01,"sbsj","transporte não regular","voo doméstico",423,410,833,849,939,1788,0,0,0,0
"9288",2016-01-01,"sbsj","transporte não regular","voo internacional",8,16,24,42,28,70,0,0,0,0
"9289",2016-01-01,"sbsl","transporte regular","voo doméstico",763,760,1523,88283,87640,175923,0,0,0,0
"9290",2016-01-01,"sbsl","transporte regular","voo internacional",0,0,0,0,0,0,0,0,0,0
"9291",2016-01-01,"sbsl","transporte não regular","voo doméstico",193,194,387,962,738,1700,53935,192404,246339,0
"9292",2016-01-01,"sbsl","transporte não regular","voo internacional",1,1,2,0,0,0,0,0,0,0
"9293",2016-01-01,"sbsn","transporte regular","voo doméstico",376,377,753,28051,23276,51327,0,685,685,0
"9294",2016-01-01,"sbsn","transporte regular","voo internacional",1,1,2,2,0,2,0,0,0,0
"9295",2016-01-01,"sbsn","transporte não regular","voo doméstico",294,295,589,1068,776,1844,0,0,0,0
"9296",2016-01-01,"sbsn","transporte não regular","voo internacional",0,0,0,0,0,0,0,0,0,0
"9297",2016-01-01,"sbsp","transporte regular","voo doméstico",7161,7259,14420,810798,866822,1677620,0,0,0,0
"9298",2016-01-01,"sbsp","transporte regular","voo internacional",0,0,0,0,0,0,0,0,0,0
"9299",2016-01-01,"sbsp","transporte não regular","voo doméstico",1487,1377,2864,14773,14813,29586,0,0,0,0
"9300",2016-01-01,"sbsp","transporte não regular","voo internacional",0,0,0,0,0,0,0,0,0,0
"9301",2016-01-01,"sbte","transporte regular","voo doméstico",566,557,1123,54275,50320,104595,17558,67044,84602,212033
"9302",2016-01-01,"sbte","transporte regular","voo internacional",0,0,0,0,0,0,0,0,0,0
"9303",2016-01-01,"sbte","transporte não regular","voo doméstico",202,199,401,5614,3333,8947,0,0,0,0
"9304",2016-01-01,"sbte","transporte não regular","voo internacional",0,0,0,0,0,0,0,0,0,0
"9305",2016-01-01,"sbtf","transporte regular","voo doméstico",42,42,84,1988,1877,3865,0,0,0,0
"9306",2016-01-01,"sbtf","transporte regular","voo internacional",0,0,0,0,0,0,0,0,0,0
"9307",2016-01-01,"sbtf","transporte não regular","voo doméstico",125,125,250,250,232,482,1623,2150,3773,11576
"9308",2016-01-01,"sbtf","transporte não regular","voo internacional",0,0,0,0,0,0,0,0,0,0
"9309",2016-01-01,"sbtt","transporte regular","voo doméstico",35,35,70,2778,3031,5809,0,0,0,0
"9310",2016-01-01,"sbtt","transporte regular","voo internacional",0,0,0,0,0,0,0,0,0,0
"9311",2016-01-01,"sbtt","transporte não regular","voo doméstico",65,68,133,272,303,575,806,2714,3520,399
"9312",2016-01-01,"sbtt","transporte não regular","voo internacional",1,0,1,0,1,1,0,0,0,0
"9313",2016-01-01,"sbuf","transporte regular","voo doméstico",13,13,26,687,687,1374,0,0,0,0
"9314",2016-01-01,"sbuf","transporte regular","voo internacional",0,0,0,0,0,0,0,0,0,0
"9315",2016-01-01,"sbuf","transporte não regular","voo doméstico",36,36,72,84,64,148,0,0,0,0
"9316",2016-01-01,"sbuf","transporte não regular","voo internacional",0,0,0,0,0,0,0,0,0,0
"9317",2016-01-01,"sbug","transporte regular","voo doméstico",21,21,42,1262,1124,2386,0,0,0,0
"9318",2016-01-01,"sbug","transporte regular","voo internacional",0,0,0,0,0,0,0,0,0,0
"9319",2016-01-01,"sbug","transporte não regular","voo doméstico",13,13,26,31,31,62,0,0,0,0
"9320",2016-01-01,"sbug","transporte não regular","voo internacional",0,0,0,0,0,0,0,0,0,0
"9321",2016-01-01,"sbul","transporte regular","voo doméstico",537,541,1078,45413,45179,90592,0,0,0,0
"9322",2016-01-01,"sbul","transporte regular","voo internacional",0,0,0,0,0,0,0,0,0,0
"9323",2016-01-01,"sbul","transporte não regular","voo doméstico",278,279,557,1251,1548,2799,0,0,0,0
"9324",2016-01-01,"sbul","transporte não regular","voo internacional",0,0,0,0,0,0,0,0,0,0
"9325",2016-01-01,"sbur","transporte regular","voo doméstico",50,49,99,2488,2714,5202,0,0,0,0
"9326",2016-01-01,"sbur","transporte regular","voo internacional",0,0,0,0,0,0,0,0,0,0
"9327",2016-01-01,"sbur","transporte não regular","voo doméstico",100,98,198,704,649,1353,0,0,0,0
"9328",2016-01-01,"sbur","transporte não regular","voo internacional",0,0,0,0,0,0,0,0,0,0
"9329",2016-07-01,"sbbe","transporte regular","voo doméstico",1124,1107,2231,136226,136775,273001,30133,159753,189886,0
"9330",2016-07-01,"sbbe","transporte regular","voo internacional",57,59,116,6324,7551,13875,0,2,2,0
"9331",2016-07-01,"sbbe","transporte não regular","voo doméstico",460,475,935,6006,4617,10623,61383,162472,223855,0
"9332",2016-07-01,"sbbe","transporte não regular","voo internacional",6,6,12,256,271,527,0,0,0,0
"9333",2016-07-01,"sbbg","transporte regular","voo doméstico",0,0,0,0,0,0,0,0,0,0
"9334",2016-07-01,"sbbg","transporte regular","voo internacional",0,0,0,0,0,0,0,0,0,0
"9335",2016-07-01,"sbbg","transporte não regular","voo doméstico",10,10,20,42,40,82,0,0,0,0
"9336",2016-07-01,"sbbg","transporte não regular","voo internacional",0,0,0,0,0,0,0,0,0,0
"9337",2016-07-01,"sbbh","transporte regular","voo doméstico",62,62,124,3129,2561,5690,0,0,0,0
"9338",2016-07-01,"sbbh","transporte regular","voo internacional",0,0,0,0,0,0,0,0,0,0
"9339",2016-07-01,"sbbh","transporte não regular","voo doméstico",1765,1748,3513,8244,8314,16558,0,0,0,0
"9340",2016-07-01,"sbbh","transporte não regular","voo internacional",0,0,0,0,0,0,0,0,0,0
"9341",2016-07-01,"sbbi","transporte regular","voo doméstico",0,0,0,0,0,0,0,0,0,0
"9342",2016-07-01,"sbbi","transporte regular","voo internacional",0,0,0,0,0,0,0,0,0,0
"9343",2016-07-01,"sbbi","transporte não regular","voo doméstico",1038,1043,2081,4461,4427,8888,0,0,0,0
"9344",2016-07-01,"sbbi","transporte não regular","voo internacional",1,0,1,0,0,0,0,0,0,0
"9345",2016-07-01,"sbbv","transporte regular","voo doméstico",87,87,174,11737,11298,23035,0,0,0,0
"9346",2016-07-01,"sbbv","transporte regular","voo internacional",4,4,8,33,69,102,0,0,0,0
"9347",2016-07-01,"sbbv","transporte não regular","voo doméstico",132,130,262,57,5,62,0,0,0,0
"9348",2016-07-01,"sbbv","transporte não regular","voo internacional",10,12,22,0,0,0,0,0,0,0
"9349",2016-07-01,"sbcg","transporte regular","voo doméstico",563,568,1131,66700,65069,131769,66758,165810,232568,0
"9350",2016-07-01,"sbcg","transporte regular","voo internacional",0,0,0,0,0,0,0,0,0,0
"9351",2016-07-01,"sbcg","transporte não regular","voo doméstico",320,310,630,547,986,1533,0,0,0,0
"9352",2016-07-01,"sbcg","transporte não regular","voo internacional",10,11,21,0,0,0,0,0,0,0
"9353",2016-07-01,"sbcj","transporte regular","voo doméstico",77,77,154,7851,7497,15348,0,0,0,0
"9354",2016-07-01,"sbcj","transporte regular","voo internacional",0,0,0,0,0,0,0,0,0,0
"9355",2016-07-01,"sbcj","transporte não regular","voo doméstico",87,87,174,529,635,1164,0,0,0,0
"9356",2016-07-01,"sbcj","transporte não regular","voo internacional",0,0,0,0,0,0,0,0,0,0
"9357",2016-07-01,"sbcr","transporte regular","voo doméstico",18,18,36,1558,1554,3112,0,0,0,0
"9358",2016-07-01,"sbcr","transporte regular","voo internacional",0,0,0,0,0,0,0,0,0,0
"9359",2016-07-01,"sbcr","transporte não regular","voo doméstico",38,37,75,80,65,145,0,0,0,0
"9360",2016-07-01,"sbcr","transporte não regular","voo internacional",6,5,11,9,9,18,0,0,0,0
"9361",2016-07-01,"sbct","transporte regular","voo doméstico",2210,2189,4399,268920,266225,535145,142417,0,142417,156167
"9362",2016-07-01,"sbct","transporte regular","voo internacional",57,57,114,1938,2122,4060,0,5177,5177,0
"9363",2016-07-01,"sbct","transporte não regular","voo doméstico",443,464,907,18392,16231,34623,0,0,0,0
"9364",2016-07-01,"sbct","transporte não regular","voo internacional",7,6,13,14,9,23,0,0,0,0
"9365",2016-07-01,"sbcz","transporte regular","voo doméstico",31,31,62,2738,2752,5490,0,0,0,0
"9366",2016-07-01,"sbcz","transporte regular","voo internacional",0,0,0,0,0,0,0,0,0,0
"9367",2016-07-01,"sbcz","transporte não regular","voo doméstico",229,231,460,856,768,1624,0,0,0,0
"9368",2016-07-01,"sbcz","transporte não regular","voo internacional",2,2,4,0,0,0,0,0,0,0
"9369",2016-07-01,"sbeg","transporte regular","voo doméstico",871,861,1732,100727,104935,205662,0,0,0,0
"9370",2016-07-01,"sbeg","transporte regular","voo internacional",108,111,219,4053,5128,9181,0,0,0,0
"9371",2016-07-01,"sbeg","transporte não regular","voo doméstico",419,416,835,5813,4512,10325,0,0,0,0
"9372",2016-07-01,"sbeg","transporte não regular","voo internacional",61,67,128,368,426,794,0,0,0,0
"9373",2016-07-01,"sbfi","transporte regular","voo doméstico",543,544,1087,74424,71614,146038,0,0,0,0
"9374",2016-07-01,"sbfi","transporte regular","voo internacional",23,23,46,3117,2681,5798,0,0,0,0
"9375",2016-07-01,"sbfi","transporte não regular","voo doméstico",156,161,317,4029,4283,8312,0,0,0,0
"9376",2016-07-01,"sbfi","transporte não regular","voo internacional",23,23,46,52,59,111,0,0,0,0
"9377",2016-07-01,"sbgo","transporte regular","voo doméstico",1216,1214,2430,133295,132595,265890,120779,193382,314161,201995
"9378",2016-07-01,"sbgo","transporte regular","voo internacional",0,0,0,0,0,0,0,0,0,0
"9379",2016-07-01,"sbgo","transporte não regular","voo doméstico",1412,1414,2826,4971,3846,8817,862,8201,9063,6880
"9380",2016-07-01,"sbgo","transporte não regular","voo internacional",4,3,7,0,0,0,0,0,0,0
"9381",2016-07-01,"sbht","transporte regular","voo doméstico",166,167,333,6370,6411,12781,0,0,0,0
"9382",2016-07-01,"sbht","transporte regular","voo internacional",0,0,0,0,0,0,0,0,0,0
"9383",2016-07-01,"sbht","transporte não regular","voo doméstico",127,127,254,128,150,278,0,0,0,0
"9384",2016-07-01,"sbht","transporte não regular","voo internacional",0,0,0,0,0,0,0,0,0,0
"9385",2016-07-01,"sbiz","transporte regular","voo doméstico",130,130,260,12633,12671,25304,0,0,0,0
"9386",2016-07-01,"sbiz","transporte regular","voo internacional",0,0,0,0,0,0,0,0,0,0
"9387",2016-07-01,"sbiz","transporte não regular","voo doméstico",162,161,323,422,385,807,0,0,0,0
"9388",2016-07-01,"sbiz","transporte não regular","voo internacional",0,0,0,0,0,0,0,0,0,0
"9389",2016-07-01,"sbjc","transporte regular","voo doméstico",0,0,0,0,0,0,0,0,0,0
"9390",2016-07-01,"sbjc","transporte regular","voo internacional",0,0,0,0,0,0,0,0,0,0
"9391",2016-07-01,"sbjc","transporte não regular","voo doméstico",359,356,715,654,476,1130,0,0,0,0
"9392",2016-07-01,"sbjc","transporte não regular","voo internacional",1,1,2,0,0,0,0,0,0,0
"9393",2016-07-01,"sbjr","transporte regular","voo doméstico",0,0,0,0,0,0,0,0,0,0
"9394",2016-07-01,"sbjr","transporte regular","voo internacional",0,0,0,0,0,0,0,0,0,0
"9395",2016-07-01,"sbjr","transporte não regular","voo doméstico",2803,2827,5630,10562,7812,18374,0,0,0,0
"9396",2016-07-01,"sbjr","transporte não regular","voo internacional",0,0,0,0,0,0,0,0,0,0
"9397",2016-07-01,"sbjv","transporte regular","voo doméstico",258,261,519,27156,26737,53893,256,0,256,0
"9398",2016-07-01,"sbjv","transporte regular","voo internacional",0,0,0,0,0,0,0,0,0,0
"9399",2016-07-01,"sbjv","transporte não regular","voo doméstico",159,155,314,389,2242,2631,0,0,0,0
"9400",2016-07-01,"sbjv","transporte não regular","voo internacional",0,0,0,0,0,0,0,0,0,0
"9401",2016-07-01,"sblo","transporte regular","voo doméstico",300,301,601,35414,34320,69734,0,0,0,0
"9402",2016-07-01,"sblo","transporte regular","voo internacional",0,0,0,0,0,0,0,0,0,0
"9403",2016-07-01,"sblo","transporte não regular","voo doméstico",809,804,1613,7308,7216,14524,0,0,0,0
"9404",2016-07-01,"sblo","transporte não regular","voo internacional",1,1,2,0,0,0,0,0,0,0
"9405",2016-07-01,"sbma","transporte regular","voo doméstico",151,151,302,14001,13692,27693,0,0,0,0
"9406",2016-07-01,"sbma","transporte regular","voo internacional",0,0,0,0,0,0,0,0,0,0
"9407",2016-07-01,"sbma","transporte não regular","voo doméstico",283,281,564,885,847,1732,0,0,0,0
"9408",2016-07-01,"sbma","transporte não regular","voo internacional",4,4,8,0,0,0,0,0,0,0
"9409",2016-07-01,"sbmk","transporte regular","voo doméstico",133,125,258,11435,12003,23438,0,0,0,0
"9410",2016-07-01,"sbmk","transporte regular","voo internacional",0,0,0,0,0,0,0,0,0,0
"9411",2016-07-01,"sbmk","transporte não regular","voo doméstico",231,243,474,1345,545,1890,0,0,0,0
"9412",2016-07-01,"sbmk","transporte não regular","voo internacional",0,0,0,0,0,0,0,0,0,0
"9413",2016-07-01,"sbmq","transporte regular","voo doméstico",204,202,406,25799,24344,50143,23700,38080,61780,0
"9414",2016-07-01,"sbmq","transporte regular","voo internacional",0,0,0,0,0,0,0,0,0,0
"9415",2016-07-01,"sbmq","transporte não regular","voo doméstico",160,162,322,203,61,264,0,0,0,0
"9416",2016-07-01,"sbmq","transporte não regular","voo internacional",3,4,7,0,0,0,0,0,0,0
"9417",2016-07-01,"sbmt","transporte regular","voo doméstico",0,0,0,0,0,0,0,0,0,0
"9418",2016-07-01,"sbmt","transporte regular","voo internacional",0,0,0,0,0,0,0,0,0,0
"9419",2016-07-01,"sbmt","transporte não regular","voo doméstico",3306,3317,6623,5658,5654,11312,0,0,0,0
"9420",2016-07-01,"sbmt","transporte não regular","voo internacional",0,0,0,0,0,0,0,0,0,0
"9421",2016-07-01,"sbnf","transporte regular","voo doméstico",493,497,990,58093,56531,114624,0,0,0,0
"9422",2016-07-01,"sbnf","transporte regular","voo internacional",0,0,0,0,0,0,0,0,0,0
"9423",2016-07-01,"sbnf","transporte não regular","voo doméstico",202,197,399,1146,1026,2172,0,0,0,0
"9424",2016-07-01,"sbnf","transporte não regular","voo internacional",2,3,5,23,6,29,0,0,0,0
"9425",2016-07-01,"sbpb","transporte regular","voo doméstico",5,5,10,431,466,897,0,0,0,0
"9426",2016-07-01,"sbpb","transporte regular","voo internacional",0,0,0,0,0,0,0,0,0,0
"9427",2016-07-01,"sbpb","transporte não regular","voo doméstico",100,100,200,426,564,990,0,0,0,0
"9428",2016-07-01,"sbpb","transporte não regular","voo internacional",0,0,0,0,0,0,0,0,0,0
"9429",2016-07-01,"sbpj","transporte regular","voo doméstico",259,259,518,28538,28340,56878,0,0,0,0
"9430",2016-07-01,"sbpj","transporte regular","voo internacional",0,0,0,0,0,0,0,0,0,0
"9431",2016-07-01,"sbpj","transporte não regular","voo doméstico",312,314,626,1766,1859,3625,0,0,0,0
"9432",2016-07-01,"sbpj","transporte não regular","voo internacional",1,1,2,0,0,0,0,0,0,0
"9433",2016-07-01,"sbpk","transporte regular","voo doméstico",24,24,48,1319,1277,2596,0,0,0,0
"9434",2016-07-01,"sbpk","transporte regular","voo internacional",0,0,0,0,0,0,0,0,0,0
"9435",2016-07-01,"sbpk","transporte não regular","voo doméstico",34,32,66,58,69,127,0,0,0,0
"9436",2016-07-01,"sbpk","transporte não regular","voo internacional",5,7,12,16,13,29,0,0,0,0
"9437",2016-07-01,"sbpl","transporte regular","voo doméstico",170,170,340,19680,19022,38702,0,0,0,0
"9438",2016-07-01,"sbpl","transporte regular","voo internacional",3,3,6,0,0,0,0,0,0,0
"9439",2016-07-01,"sbpl","transporte não regular","voo doméstico",93,92,185,174,146,320,0,0,0,0
"9440",2016-07-01,"sbpl","transporte não regular","voo internacional",0,0,0,0,0,0,0,0,0,0
"9441",2016-07-01,"sbpp","transporte regular","voo doméstico",0,0,0,0,0,0,0,0,0,0
"9442",2016-07-01,"sbpp","transporte regular","voo internacional",0,0,0,0,0,0,0,0,0,0
"9443",2016-07-01,"sbpp","transporte não regular","voo doméstico",136,135,271,244,225,469,0,0,0,0
"9444",2016-07-01,"sbpp","transporte não regular","voo internacional",8,6,14,16,13,29,0,0,0,0
"9445",2016-07-01,"sbpr","transporte regular","voo doméstico",0,0,0,0,0,0,0,0,0,0
"9446",2016-07-01,"sbpr","transporte regular","voo internacional",0,0,0,0,0,0,0,0,0,0
"9447",2016-07-01,"sbpr","transporte não regular","voo doméstico",962,965,1927,1163,1056,2219,0,0,0,0
"9448",2016-07-01,"sbpr","transporte não regular","voo internacional",0,0,0,0,0,0,0,0,0,0
"9449",2016-07-01,"sbpv","transporte regular","voo doméstico",363,363,726,37892,38724,76616,0,0,0,0
"9450",2016-07-01,"sbpv","transporte regular","voo internacional",0,0,0,0,0,0,0,0,0,0
"9451",2016-07-01,"sbpv","transporte não regular","voo doméstico",252,257,509,0,0,0,0,0,0,0
"9452",2016-07-01,"sbpv","transporte não regular","voo internacional",0,0,0,0,0,0,0,0,0,0
"9453",2016-07-01,"sbrb","transporte regular","voo doméstico",124,124,248,12952,15189,28141,0,13,13,0
"9454",2016-07-01,"sbrb","transporte regular","voo internacional",0,0,0,0,0,0,0,0,0,0
"9455",2016-07-01,"sbrb","transporte não regular","voo doméstico",143,142,285,249,215,464,0,0,0,0
"9456",2016-07-01,"sbrb","transporte não regular","voo internacional",0,0,0,0,0,0,0,0,0,0
"9457",2016-07-01,"sbrj","transporte regular","voo doméstico",3966,4009,7975,401298,399083,800381,1314,0,1314,0
"9458",2016-07-01,"sbrj","transporte regular","voo internacional",0,0,0,0,0,0,0,0,0,0
"9459",2016-07-01,"sbrj","transporte não regular","voo doméstico",619,576,1195,269,3586,3855,0,0,0,0
"9460",2016-07-01,"sbrj","transporte não regular","voo internacional",2,1,3,0,0,0,0,0,0,0
"9461",2016-07-01,"sbsj","transporte regular","voo doméstico",0,0,0,0,0,0,0,0,0,0
"9462",2016-07-01,"sbsj","transporte regular","voo internacional",0,0,0,0,0,0,0,0,0,0
"9463",2016-07-01,"sbsj","transporte não regular","voo doméstico",527,516,1043,871,821,1692,0,0,0,0
"9464",2016-07-01,"sbsj","transporte não regular","voo internacional",1,8,9,11,0,11,0,0,0,0
"9465",2016-07-01,"sbsl","transporte regular","voo doméstico",499,501,1000,64497,71103,135600,0,0,0,0
"9466",2016-07-01,"sbsl","transporte regular","voo internacional",0,0,0,0,0,0,0,0,0,0
"9467",2016-07-01,"sbsl","transporte não regular","voo doméstico",287,282,569,2592,2833,5425,50162,201508,251670,0
"9468",2016-07-01,"sbsl","transporte não regular","voo internacional",1,2,3,0,0,0,0,0,0,0
"9469",2016-07-01,"sbsn","transporte regular","voo doméstico",251,251,502,22107,21135,43242,0,0,0,0
"9470",2016-07-01,"sbsn","transporte regular","voo internacional",0,0,0,0,0,0,0,0,0,0
"9471",2016-07-01,"sbsn","transporte não regular","voo doméstico",274,273,547,914,626,1540,0,0,0,0
"9472",2016-07-01,"sbsn","transporte não regular","voo internacional",0,0,0,0,0,0,0,0,0,0
"9473",2016-07-01,"sbsp","transporte regular","voo doméstico",7232,7258,14490,932974,936128,1869102,0,0,0,0
"9474",2016-07-01,"sbsp","transporte regular","voo internacional",0,0,0,0,0,0,0,0,0,0
"9475",2016-07-01,"sbsp","transporte não regular","voo doméstico",1699,1662,3361,29773,27832,57605,0,0,0,0
"9476",2016-07-01,"sbsp","transporte não regular","voo internacional",0,0,0,0,0,0,0,0,0,0
"9477",2016-07-01,"sbte","transporte regular","voo doméstico",422,423,845,46633,47649,94282,23274,77824,101098,254594
"9478",2016-07-01,"sbte","transporte regular","voo internacional",0,0,0,0,0,0,0,0,0,0
"9479",2016-07-01,"sbte","transporte não regular","voo doméstico",289,294,583,2125,2306,4431,0,0,0,0
"9480",2016-07-01,"sbte","transporte não regular","voo internacional",0,0,0,0,0,0,0,0,0,0
"9481",2016-07-01,"sbtf","transporte regular","voo doméstico",43,43,86,1839,2163,4002,0,0,0,0
"9482",2016-07-01,"sbtf","transporte regular","voo internacional",0,0,0,0,0,0,0,0,0,0
"9483",2016-07-01,"sbtf","transporte não regular","voo doméstico",145,146,291,188,141,329,3174,2771,5945,11813
"9484",2016-07-01,"sbtf","transporte não regular","voo internacional",0,0,0,0,0,0,0,0,0,0
"9485",2016-07-01,"sbtt","transporte regular","voo doméstico",32,32,64,2284,2842,5126,0,257,257,0
"9486",2016-07-01,"sbtt","transporte regular","voo internacional",0,0,0,0,0,0,0,0,0,0
"9487",2016-07-01,"sbtt","transporte não regular","voo doméstico",76,76,152,356,303,659,1407,3570,4977,576
"9488",2016-07-01,"sbtt","transporte não regular","voo internacional",2,2,4,6,6,12,0,0,0,0
"9489",2016-07-01,"sbuf","transporte regular","voo doméstico",9,9,18,445,373,818,0,0,0,0
"9490",2016-07-01,"sbuf","transporte regular","voo internacional",0,0,0,0,0,0,0,0,0,0
"9491",2016-07-01,"sbuf","transporte não regular","voo doméstico",16,18,34,60,48,108,0,0,0,0
"9492",2016-07-01,"sbuf","transporte não regular","voo internacional",0,0,0,0,0,0,0,0,0,0
"9493",2016-07-01,"sbug","transporte regular","voo doméstico",24,24,48,1154,1072,2226,0,0,0,0
"9494",2016-07-01,"sbug","transporte regular","voo internacional",0,0,0,0,0,0,0,0,0,0
"9495",2016-07-01,"sbug","transporte não regular","voo doméstico",10,10,20,14,10,24,0,0,0,0
"9496",2016-07-01,"sbug","transporte não regular","voo internacional",0,0,0,0,0,0,0,0,0,0
"9497",2016-07-01,"sbul","transporte regular","voo doméstico",435,433,868,46008,44614,90622,0,0,0,0
"9498",2016-07-01,"sbul","transporte regular","voo internacional",0,0,0,0,0,0,0,0,0,0
"9499",2016-07-01,"sbul","transporte não regular","voo doméstico",508,515,1023,1737,1550,3287,0,0,0,0
"9500",2016-07-01,"sbul","transporte não regular","voo internacional",1,1,2,13,13,26,0,0,0,0
"9501",2016-07-01,"sbur","transporte regular","voo doméstico",53,53,106,2926,3087,6013,0,0,0,0
"9502",2016-07-01,"sbur","transporte regular","voo internacional",0,0,0,0,0,0,0,0,0,0
"9503",2016-07-01,"sbur","transporte não regular","voo doméstico",207,202,409,669,713,1382,0,0,0,0
"9504",2016-07-01,"sbur","transporte não regular","voo internacional",0,0,0,0,0,0,0,0,0,0
"9505",2016-06-01,"sbbe","transporte regular","voo doméstico",1048,1064,2112,125490,121524,247014,37697,163641,201338,0
"9506",2016-06-01,"sbbe","transporte regular","voo internacional",53,54,107,5143,5466,10609,0,18,18,0
"9507",2016-06-01,"sbbe","transporte não regular","voo doméstico",467,462,929,2930,5238,8168,69583,141241,210824,0
"9508",2016-06-01,"sbbe","transporte não regular","voo internacional",17,17,34,28,12,40,0,0,0,0
"9509",2016-06-01,"sbbg","transporte regular","voo doméstico",0,0,0,0,0,0,0,0,0,0
"9510",2016-06-01,"sbbg","transporte regular","voo internacional",0,0,0,0,0,0,0,0,0,0
"9511",2016-06-01,"sbbg","transporte não regular","voo doméstico",13,13,26,61,60,121,0,0,0,0
"9512",2016-06-01,"sbbg","transporte não regular","voo internacional",0,0,0,0,0,0,0,0,0,0
"9513",2016-06-01,"sbbh","transporte regular","voo doméstico",106,107,213,4648,3913,8561,0,0,0,0
"9514",2016-06-01,"sbbh","transporte regular","voo internacional",0,0,0,0,0,0,0,0,0,0
"9515",2016-06-01,"sbbh","transporte não regular","voo doméstico",1632,1638,3270,8176,8200,16376,0,0,0,0
"9516",2016-06-01,"sbbh","transporte não regular","voo internacional",4,4,8,25,25,50,0,0,0,0
"9517",2016-06-01,"sbbi","transporte regular","voo doméstico",0,0,0,0,0,0,0,0,0,0
"9518",2016-06-01,"sbbi","transporte regular","voo internacional",0,0,0,0,0,0,0,0,0,0
"9519",2016-06-01,"sbbi","transporte não regular","voo doméstico",1054,1051,2105,2644,2938,5582,0,0,0,0
"9520",2016-06-01,"sbbi","transporte não regular","voo internacional",1,1,2,0,0,0,0,0,0,0
"9521",2016-06-01,"sbbv","transporte regular","voo doméstico",80,80,160,10227,9546,19773,0,0,0,0
"9522",2016-06-01,"sbbv","transporte regular","voo internacional",0,0,0,0,0,0,0,0,0,0
"9523",2016-06-01,"sbbv","transporte não regular","voo doméstico",124,124,248,259,184,443,0,0,0,0
"9524",2016-06-01,"sbbv","transporte não regular","voo internacional",18,17,35,0,5,5,0,0,0,0
"9525",2016-06-01,"sbcg","transporte regular","voo doméstico",578,576,1154,57832,57215,115047,71073,150699,221772,0
"9526",2016-06-01,"sbcg","transporte regular","voo internacional",0,0,0,0,0,0,0,0,0,0
"9527",2016-06-01,"sbcg","transporte não regular","voo doméstico",245,244,489,310,520,830,0,0,0,0
"9528",2016-06-01,"sbcg","transporte não regular","voo internacional",6,6,12,0,0,0,0,0,0,0
"9529",2016-06-01,"sbcj","transporte regular","voo doméstico",78,78,156,7158,6906,14064,0,0,0,0
"9530",2016-06-01,"sbcj","transporte regular","voo internacional",0,0,0,0,0,0,0,0,0,0
"9531",2016-06-01,"sbcj","transporte não regular","voo doméstico",73,74,147,235,0,235,0,0,0,0
"9532",2016-06-01,"sbcj","transporte não regular","voo internacional",0,0,0,0,0,0,0,0,0,0
"9533",2016-06-01,"sbcr","transporte regular","voo doméstico",16,16,32,1317,1149,2466,0,0,0,0
"9534",2016-06-01,"sbcr","transporte regular","voo internacional",0,0,0,0,0,0,0,0,0,0
"9535",2016-06-01,"sbcr","transporte não regular","voo doméstico",35,36,71,95,83,178,0,0,0,0
"9536",2016-06-01,"sbcr","transporte não regular","voo internacional",2,2,4,0,1,1,0,0,0,0
"9537",2016-06-01,"sbct","transporte regular","voo doméstico",2115,2116,4231,224487,222009,446496,112198,19963,132161,108528
"9538",2016-06-01,"sbct","transporte regular","voo internacional",52,52,104,1495,1459,2954,0,7997,7997,0
"9539",2016-06-01,"sbct","transporte não regular","voo doméstico",427,422,849,13818,15192,29010,0,0,0,0
"9540",2016-06-01,"sbct","transporte não regular","voo internacional",5,7,12,21,15,36,0,0,0,0
"9541",2016-06-01,"sbcz","transporte regular","voo doméstico",29,29,58,2763,2705,5468,0,0,0,0
"9542",2016-06-01,"sbcz","transporte regular","voo internacional",0,0,0,0,0,0,0,0,0,0
"9543",2016-06-01,"sbcz","transporte não regular","voo doméstico",198,201,399,665,589,1254,0,0,0,0
"9544",2016-06-01,"sbcz","transporte não regular","voo internacional",0,0,0,0,0,0,0,0,0,0
"9545",2016-06-01,"sbeg","transporte regular","voo doméstico",847,845,1692,95586,94500,190086,0,0,0,0
"9546",2016-06-01,"sbeg","transporte regular","voo internacional",95,94,189,3655,3282,6937,0,0,0,0
"9547",2016-06-01,"sbeg","transporte não regular","voo doméstico",481,486,967,6335,5901,12236,90,0,90,0
"9548",2016-06-01,"sbeg","transporte não regular","voo internacional",73,76,149,429,448,877,0,0,0,0
"9549",2016-06-01,"sbfi","transporte regular","voo doméstico",499,497,996,59062,58523,117585,0,0,0,0
"9550",2016-06-01,"sbfi","transporte regular","voo internacional",21,21,42,2559,2223,4782,0,0,0,0
"9551",2016-06-01,"sbfi","transporte não regular","voo doméstico",145,147,292,1101,1691,2792,0,0,0,0
"9552",2016-06-01,"sbfi","transporte não regular","voo internacional",37,34,71,50,51,101,0,0,0,0
"9553",2016-06-01,"sbgo","transporte regular","voo doméstico",1169,1169,2338,120460,120716,241176,213514,190925,404439,204998
"9554",2016-06-01,"sbgo","transporte regular","voo internacional",0,0,0,0,0,0,0,0,0,0
"9555",2016-06-01,"sbgo","transporte não regular","voo doméstico",1373,1372,2745,3810,3583,7393,816,7565,8381,5527
"9556",2016-06-01,"sbgo","transporte não regular","voo internacional",3,3,6,0,0,0,0,0,0,0
"9557",2016-06-01,"sbht","transporte regular","voo doméstico",143,140,283,5800,5854,11654,0,0,0,0
"9558",2016-06-01,"sbht","transporte regular","voo internacional",0,0,0,0,0,0,0,0,0,0
"9559",2016-06-01,"sbht","transporte não regular","voo doméstico",167,167,334,929,831,1760,100,230,330,110
"9560",2016-06-01,"sbht","transporte não regular","voo internacional",1,1,2,0,0,0,0,0,0,0
"9561",2016-06-01,"sbiz","transporte regular","voo doméstico",125,125,250,11093,11144,22237,0,0,0,0
"9562",2016-06-01,"sbiz","transporte regular","voo internacional",0,0,0,0,0,0,0,0,0,0
"9563",2016-06-01,"sbiz","transporte não regular","voo doméstico",142,140,282,312,304,616,0,0,0,0
"9564",2016-06-01,"sbiz","transporte não regular","voo internacional",2,2,4,0,0,0,0,0,0,0
"9565",2016-06-01,"sbjc","transporte regular","voo doméstico",0,0,0,0,0,0,0,0,0,0
"9566",2016-06-01,"sbjc","transporte regular","voo internacional",0,0,0,0,0,0,0,0,0,0
"9567",2016-06-01,"sbjc","transporte não regular","voo doméstico",402,404,806,766,724,1490,0,0,0,0
"9568",2016-06-01,"sbjc","transporte não regular","voo internacional",1,0,1,0,0,0,0,0,0,0
"9569",2016-06-01,"sbjr","transporte regular","voo doméstico",0,0,0,0,0,0,0,0,0,0
"9570",2016-06-01,"sbjr","transporte regular","voo internacional",0,0,0,0,0,0,0,0,0,0
"9571",2016-06-01,"sbjr","transporte não regular","voo doméstico",2355,2354,4709,9601,7400,17001,0,0,0,0
"9572",2016-06-01,"sbjr","transporte não regular","voo internacional",0,0,0,0,0,0,0,0,0,0
"9573",2016-06-01,"sbjv","transporte regular","voo doméstico",230,232,462,20978,20424,41402,0,0,0,0
"9574",2016-06-01,"sbjv","transporte regular","voo internacional",0,0,0,0,0,0,0,0,0,0
"9575",2016-06-01,"sbjv","transporte não regular","voo doméstico",124,122,246,273,862,1135,0,0,0,0
"9576",2016-06-01,"sbjv","transporte não regular","voo internacional",1,2,3,0,0,0,0,0,0,0
"9577",2016-06-01,"sblo","transporte regular","voo doméstico",302,302,604,31006,29926,60932,0,0,0,0
"9578",2016-06-01,"sblo","transporte regular","voo internacional",0,0,0,0,0,0,0,0,0,0
"9579",2016-06-01,"sblo","transporte não regular","voo doméstico",669,677,1346,6705,7178,13883,0,0,0,0
"9580",2016-06-01,"sblo","transporte não regular","voo internacional",1,2,3,0,0,0,0,0,0,0
"9581",2016-06-01,"sbma","transporte regular","voo doméstico",145,145,290,12576,12437,25013,0,0,0,0
"9582",2016-06-01,"sbma","transporte regular","voo internacional",0,0,0,0,0,0,0,0,0,0
"9583",2016-06-01,"sbma","transporte não regular","voo doméstico",203,200,403,585,585,1170,0,0,0,0
"9584",2016-06-01,"sbma","transporte não regular","voo internacional",0,0,0,0,0,0,0,0,0,0
"9585",2016-06-01,"sbmk","transporte regular","voo doméstico",173,172,345,11899,12309,24208,0,0,0,0
"9586",2016-06-01,"sbmk","transporte regular","voo internacional",0,0,0,0,0,0,0,0,0,0
"9587",2016-06-01,"sbmk","transporte não regular","voo doméstico",203,198,401,17,17,34,0,0,0,0
"9588",2016-06-01,"sbmk","transporte não regular","voo internacional",0,0,0,0,0,0,0,0,0,0
"9589",2016-06-01,"sbmq","transporte regular","voo doméstico",188,191,379,21988,19902,41890,11900,36615,48515,0
"9590",2016-06-01,"sbmq","transporte regular","voo internacional",0,0,0,0,0,0,0,0,0,0
"9591",2016-06-01,"sbmq","transporte não regular","voo doméstico",171,171,342,965,759,1724,0,0,0,0
"9592",2016-06-01,"sbmq","transporte não regular","voo internacional",4,6,10,0,0,0,0,0,0,0
"9593",2016-06-01,"sbmt","transporte regular","voo doméstico",0,0,0,0,0,0,0,0,0,0
"9594",2016-06-01,"sbmt","transporte regular","voo internacional",0,0,0,0,0,0,0,0,0,0
"9595",2016-06-01,"sbmt","transporte não regular","voo doméstico",3068,3076,6144,5392,5315,10707,0,0,0,0
"9596",2016-06-01,"sbmt","transporte não regular","voo internacional",0,0,0,0,0,0,0,0,0,0
"9597",2016-06-01,"sbnf","transporte regular","voo doméstico",491,495,986,50016,49056,99072,0,0,0,0
"9598",2016-06-01,"sbnf","transporte regular","voo internacional",0,0,0,0,0,0,0,0,0,0
"9599",2016-06-01,"sbnf","transporte não regular","voo doméstico",197,194,391,834,1421,2255,0,0,0,0
"9600",2016-06-01,"sbnf","transporte não regular","voo internacional",1,1,2,3,4,7,0,0,0,0
"9601",2016-06-01,"sbpb","transporte regular","voo doméstico",0,0,0,0,0,0,0,0,0,0
"9602",2016-06-01,"sbpb","transporte regular","voo internacional",0,0,0,0,0,0,0,0,0,0
"9603",2016-06-01,"sbpb","transporte não regular","voo doméstico",48,48,96,147,112,259,0,0,0,0
"9604",2016-06-01,"sbpb","transporte não regular","voo internacional",0,0,0,0,0,0,0,0,0,0
"9605",2016-06-01,"sbpj","transporte regular","voo doméstico",250,250,500,25921,25748,51669,0,0,0,0
"9606",2016-06-01,"sbpj","transporte regular","voo internacional",0,0,0,0,0,0,0,0,0,0
"9607",2016-06-01,"sbpj","transporte não regular","voo doméstico",278,275,553,740,583,1323,0,0,0,0
"9608",2016-06-01,"sbpj","transporte não regular","voo internacional",1,1,2,0,0,0,0,0,0,0
"9609",2016-06-01,"sbpk","transporte regular","voo doméstico",24,24,48,1361,1200,2561,0,0,0,0
"9610",2016-06-01,"sbpk","transporte regular","voo internacional",0,0,0,0,0,0,0,0,0,0
"9611",2016-06-01,"sbpk","transporte não regular","voo doméstico",33,32,65,44,59,103,0,0,0,0
"9612",2016-06-01,"sbpk","transporte não regular","voo internacional",1,3,4,0,3,3,0,0,0,0
"9613",2016-06-01,"sbpl","transporte regular","voo doméstico",163,166,329,17774,18117,35891,0,0,0,0
"9614",2016-06-01,"sbpl","transporte regular","voo internacional",3,3,6,0,0,0,0,0,0,0
"9615",2016-06-01,"sbpl","transporte não regular","voo doméstico",137,136,273,426,607,1033,0,0,0,0
"9616",2016-06-01,"sbpl","transporte não regular","voo internacional",2,2,4,0,0,0,0,0,0,0
"9617",2016-06-01,"sbpp","transporte regular","voo doméstico",0,0,0,0,0,0,0,0,0,0
"9618",2016-06-01,"sbpp","transporte regular","voo internacional",0,0,0,0,0,0,0,0,0,0
"9619",2016-06-01,"sbpp","transporte não regular","voo doméstico",81,77,158,97,115,212,0,0,0,0
"9620",2016-06-01,"sbpp","transporte não regular","voo internacional",6,12,18,17,4,21,0,0,0,0
"9621",2016-06-01,"sbpr","transporte regular","voo doméstico",0,0,0,0,0,0,0,0,0,0
"9622",2016-06-01,"sbpr","transporte regular","voo internacional",0,0,0,0,0,0,0,0,0,0
"9623",2016-06-01,"sbpr","transporte não regular","voo doméstico",884,879,1763,1009,969,1978,0,0,0,0
"9624",2016-06-01,"sbpr","transporte não regular","voo internacional",0,0,0,0,0,0,0,0,0,0
"9625",2016-06-01,"sbpv","transporte regular","voo doméstico",336,336,672,31770,31977,63747,0,0,0,0
"9626",2016-06-01,"sbpv","transporte regular","voo internacional",0,0,0,0,0,0,0,0,0,0
"9627",2016-06-01,"sbpv","transporte não regular","voo doméstico",237,237,474,0,0,0,0,0,0,0
"9628",2016-06-01,"sbpv","transporte não regular","voo internacional",2,2,4,0,0,0,0,0,0,0
"9629",2016-06-01,"sbrb","transporte regular","voo doméstico",118,118,236,12348,13670,26018,0,40,40,46
"9630",2016-06-01,"sbrb","transporte regular","voo internacional",0,0,0,0,0,0,0,0,0,0
"9631",2016-06-01,"sbrb","transporte não regular","voo doméstico",117,118,235,301,273,574,0,0,0,0
"9632",2016-06-01,"sbrb","transporte não regular","voo internacional",1,1,2,0,0,0,0,0,0,0
"9633",2016-06-01,"sbrj","transporte regular","voo doméstico",3767,3776,7543,341014,346535,687549,62,431,493,0
"9634",2016-06-01,"sbrj","transporte regular","voo internacional",0,0,0,0,0,0,0,0,0,0
"9635",2016-06-01,"sbrj","transporte não regular","voo doméstico",550,539,1089,696,517,1213,0,0,0,0
"9636",2016-06-01,"sbrj","transporte não regular","voo internacional",2,2,4,0,0,0,0,0,0,0
"9637",2016-06-01,"sbsj","transporte regular","voo doméstico",0,0,0,0,0,0,0,0,0,0
"9638",2016-06-01,"sbsj","transporte regular","voo internacional",0,0,0,0,0,0,0,0,0,0
"9639",2016-06-01,"sbsj","transporte não regular","voo doméstico",491,461,952,1860,1903,3763,0,0,0,0
"9640",2016-06-01,"sbsj","transporte não regular","voo internacional",3,25,28,65,11,76,0,0,0,0
"9641",2016-06-01,"sbsl","transporte regular","voo doméstico",449,449,898,52060,60620,112680,0,0,0,0
"9642",2016-06-01,"sbsl","transporte regular","voo internacional",0,0,0,0,0,0,0,0,0,0
"9643",2016-06-01,"sbsl","transporte não regular","voo doméstico",262,262,524,1533,1603,3136,55048,187969,243017,0
"9644",2016-06-01,"sbsl","transporte não regular","voo internacional",0,0,0,0,0,0,0,0,0,0
"9645",2016-06-01,"sbsn","transporte regular","voo doméstico",235,234,469,17896,17193,35089,0,0,0,0
"9646",2016-06-01,"sbsn","transporte regular","voo internacional",0,0,0,0,0,0,0,0,0,0
"9647",2016-06-01,"sbsn","transporte não regular","voo doméstico",321,319,640,1038,689,1727,0,0,0,0
"9648",2016-06-01,"sbsn","transporte não regular","voo internacional",2,4,6,0,0,0,0,0,0,0
"9649",2016-06-01,"sbsp","transporte regular","voo doméstico",6907,6974,13881,816511,794991,1611502,0,0,0,0
"9650",2016-06-01,"sbsp","transporte regular","voo internacional",0,0,0,0,0,0,0,0,0,0
"9651",2016-06-01,"sbsp","transporte não regular","voo doméstico",1669,1598,3267,5784,5021,10805,0,0,0,0
"9652",2016-06-01,"sbsp","transporte não regular","voo internacional",0,0,0,0,0,0,0,0,0,0
"9653",2016-06-01,"sbte","transporte regular","voo doméstico",424,423,847,41079,43935,85014,23826,72999,96825,218851
"9654",2016-06-01,"sbte","transporte regular","voo internacional",0,0,0,0,0,0,0,0,0,0
"9655",2016-06-01,"sbte","transporte não regular","voo doméstico",252,250,502,1435,1541,2976,0,0,0,0
"9656",2016-06-01,"sbte","transporte não regular","voo internacional",0,0,0,0,0,0,0,0,0,0
"9657",2016-06-01,"sbtf","transporte regular","voo doméstico",44,44,88,1836,1952,3788,0,0,0,0
"9658",2016-06-01,"sbtf","transporte regular","voo internacional",0,0,0,0,0,0,0,0,0,0
"9659",2016-06-01,"sbtf","transporte não regular","voo doméstico",142,141,283,202,188,390,2423,3435,5858,11684
"9660",2016-06-01,"sbtf","transporte não regular","voo internacional",0,0,0,0,0,0,0,0,0,0
"9661",2016-06-01,"sbtt","transporte regular","voo doméstico",31,31,62,2263,2630,4893,0,50,50,0
"9662",2016-06-01,"sbtt","transporte regular","voo internacional",0,0,0,0,0,0,0,0,0,0
"9663",2016-06-01,"sbtt","transporte não regular","voo doméstico",91,90,181,491,458,949,1404,2939,4343,550
"9664",2016-06-01,"sbtt","transporte não regular","voo internacional",0,1,1,4,0,4,0,0,0,0
"9665",2016-06-01,"sbuf","transporte regular","voo doméstico",7,7,14,301,423,724,0,0,0,0
"9666",2016-06-01,"sbuf","transporte regular","voo internacional",0,0,0,0,0,0,0,0,0,0
"9667",2016-06-01,"sbuf","transporte não regular","voo doméstico",31,28,59,93,111,204,0,0,0,0
"9668",2016-06-01,"sbuf","transporte não regular","voo internacional",0,0,0,0,0,0,0,0,0,0
"9669",2016-06-01,"sbug","transporte regular","voo doméstico",24,24,48,1068,989,2057,0,0,0,0
"9670",2016-06-01,"sbug","transporte regular","voo internacional",0,0,0,0,0,0,0,0,0,0
"9671",2016-06-01,"sbug","transporte não regular","voo doméstico",13,13,26,33,22,55,0,0,0,0
"9672",2016-06-01,"sbug","transporte não regular","voo internacional",0,0,0,0,0,0,0,0,0,0
"9673",2016-06-01,"sbul","transporte regular","voo doméstico",456,454,910,39338,39557,78895,0,0,0,0
"9674",2016-06-01,"sbul","transporte regular","voo internacional",0,0,0,0,0,0,0,0,0,0
"9675",2016-06-01,"sbul","transporte não regular","voo doméstico",542,545,1087,1185,1085,2270,0,0,0,0
"9676",2016-06-01,"sbul","transporte não regular","voo internacional",0,0,0,0,0,0,0,0,0,0
"9677",2016-06-01,"sbur","transporte regular","voo doméstico",92,92,184,3841,4080,7921,0,0,0,0
"9678",2016-06-01,"sbur","transporte regular","voo internacional",0,0,0,0,0,0,0,0,0,0
"9679",2016-06-01,"sbur","transporte não regular","voo doméstico",176,174,350,608,685,1293,0,0,0,0
"9680",2016-06-01,"sbur","transporte não regular","voo internacional",2,2,4,0,0,0,0,0,0,0
"9681",2016-05-01,"sbbe","transporte regular","voo doméstico",1012,1022,2034,119565,118408,237973,14395,27800,42195,0
"9682",2016-05-01,"sbbe","transporte regular","voo internacional",60,56,116,5112,5050,10162,0,7,7,0
"9683",2016-05-01,"sbbe","transporte não regular","voo doméstico",434,422,856,2497,3026,5523,32250,115264,147514,0
"9684",2016-05-01,"sbbe","transporte não regular","voo internacional",6,11,17,246,12,258,0,0,0,0
"9685",2016-05-01,"sbbg","transporte regular","voo doméstico",0,0,0,0,0,0,0,0,0,0
"9686",2016-05-01,"sbbg","transporte regular","voo internacional",0,0,0,0,0,0,0,0,0,0
"9687",2016-05-01,"sbbg","transporte não regular","voo doméstico",21,19,40,88,84,172,0,0,0,0
"9688",2016-05-01,"sbbg","transporte não regular","voo internacional",1,3,4,0,6,6,0,0,0,0
"9689",2016-05-01,"sbbh","transporte regular","voo doméstico",151,150,301,4762,4529,9291,0,0,0,0
"9690",2016-05-01,"sbbh","transporte regular","voo internacional",0,0,0,0,0,0,0,0,0,0
"9691",2016-05-01,"sbbh","transporte não regular","voo doméstico",1721,1724,3445,9775,9432,19207,0,0,0,0
"9692",2016-05-01,"sbbh","transporte não regular","voo internacional",8,8,16,48,48,96,0,0,0,0
"9693",2016-05-01,"sbbi","transporte regular","voo doméstico",0,0,0,0,0,0,0,0,0,0
"9694",2016-05-01,"sbbi","transporte regular","voo internacional",0,0,0,0,0,0,0,0,0,0
"9695",2016-05-01,"sbbi","transporte não regular","voo doméstico",838,840,1678,3197,3187,6384,0,0,0,0
"9696",2016-05-01,"sbbi","transporte não regular","voo internacional",0,0,0,0,0,0,0,0,0,0
"9697",2016-05-01,"sbbv","transporte regular","voo doméstico",85,85,170,10142,9938,20080,0,0,0,0
"9698",2016-05-01,"sbbv","transporte regular","voo internacional",0,0,0,0,0,0,0,0,0,0
"9699",2016-05-01,"sbbv","transporte não regular","voo doméstico",117,115,232,114,54,168,0,0,0,0
"9700",2016-05-01,"sbbv","transporte não regular","voo internacional",9,8,17,0,0,0,0,0,0,0
"9701",2016-05-01,"sbcg","transporte regular","voo doméstico",580,577,1157,59094,58536,117630,65347,150908,216255,0
"9702",2016-05-01,"sbcg","transporte regular","voo internacional",0,0,0,0,0,0,0,0,0,0
"9703",2016-05-01,"sbcg","transporte não regular","voo doméstico",236,239,475,176,167,343,0,0,0,0
"9704",2016-05-01,"sbcg","transporte não regular","voo internacional",8,7,15,0,0,0,0,0,0,0
"9705",2016-05-01,"sbcj","transporte regular","voo doméstico",73,73,146,6246,6873,13119,0,0,0,0
"9706",2016-05-01,"sbcj","transporte regular","voo internacional",0,0,0,0,0,0,0,0,0,0
"9707",2016-05-01,"sbcj","transporte não regular","voo doméstico",97,96,193,616,722,1338,0,0,0,0
"9708",2016-05-01,"sbcj","transporte não regular","voo internacional",0,0,0,0,0,0,0,0,0,0
"9709",2016-05-01,"sbcr","transporte regular","voo doméstico",18,18,36,1385,1442,2827,0,0,0,0
"9710",2016-05-01,"sbcr","transporte regular","voo internacional",0,0,0,0,0,0,0,0,0,0
"9711",2016-05-01,"sbcr","transporte não regular","voo doméstico",29,28,57,96,102,198,0,0,0,0
"9712",2016-05-01,"sbcr","transporte não regular","voo internacional",4,3,7,4,9,13,0,0,0,0
"9713",2016-05-01,"sbct","transporte regular","voo doméstico",2243,2241,4484,250598,244321,494919,149404,0,149404,149979
"9714",2016-05-01,"sbct","transporte regular","voo internacional",61,60,121,1422,1565,2987,0,6793,6793,0
"9715",2016-05-01,"sbct","transporte não regular","voo doméstico",314,312,626,8310,7961,16271,0,0,0,0
"9716",2016-05-01,"sbct","transporte não regular","voo internacional",10,7,17,4,91,95,0,0,0,0
"9717",2016-05-01,"sbcz","transporte regular","voo doméstico",28,28,56,2852,2851,5703,0,0,0,0
"9718",2016-05-01,"sbcz","transporte regular","voo internacional",0,0,0,0,0,0,0,0,0,0
"9719",2016-05-01,"sbcz","transporte não regular","voo doméstico",153,151,304,625,680,1305,0,0,0,0
"9720",2016-05-01,"sbcz","transporte não regular","voo internacional",0,1,1,0,0,0,0,0,0,0
"9721",2016-05-01,"sbeg","transporte regular","voo doméstico",795,785,1580,89235,93794,183029,0,0,0,0
"9722",2016-05-01,"sbeg","transporte regular","voo internacional",96,102,198,3315,3434,6749,0,0,0,0
"9723",2016-05-01,"sbeg","transporte não regular","voo doméstico",420,428,848,5531,4823,10354,0,0,0,0
"9724",2016-05-01,"sbeg","transporte não regular","voo internacional",80,77,157,624,509,1133,0,0,0,0
"9725",2016-05-01,"sbfi","transporte regular","voo doméstico",538,539,1077,68243,62264,130507,0,0,0,0
"9726",2016-05-01,"sbfi","transporte regular","voo internacional",22,22,44,2855,2314,5169,0,0,0,0
"9727",2016-05-01,"sbfi","transporte não regular","voo doméstico",162,164,326,1362,2190,3552,0,0,0,0
"9728",2016-05-01,"sbfi","transporte não regular","voo internacional",45,44,89,219,196,415,0,0,0,0
"9729",2016-05-01,"sbgo","transporte regular","voo doméstico",1164,1161,2325,118809,118324,237133,146179,192759,338938,208849
"9730",2016-05-01,"sbgo","transporte regular","voo internacional",0,0,0,0,0,0,0,0,0,0
"9731",2016-05-01,"sbgo","transporte não regular","voo doméstico",1334,1331,2665,3947,3984,7931,0,0,0,0
"9732",2016-05-01,"sbgo","transporte não regular","voo internacional",5,5,10,0,0,0,0,0,0,0
"9733",2016-05-01,"sbht","transporte regular","voo doméstico",124,124,248,6065,5853,11918,0,0,0,0
"9734",2016-05-01,"sbht","transporte regular","voo internacional",0,0,0,0,0,0,0,0,0,0
"9735",2016-05-01,"sbht","transporte não regular","voo doméstico",143,145,288,541,565,1106,0,100,100,200
"9736",2016-05-01,"sbht","transporte não regular","voo internacional",0,0,0,0,0,0,0,0,0,0
"9737",2016-05-01,"sbiz","transporte regular","voo doméstico",110,109,219,9366,9771,19137,0,0,0,0
"9738",2016-05-01,"sbiz","transporte regular","voo internacional",0,0,0,0,0,0,0,0,0,0
"9739",2016-05-01,"sbiz","transporte não regular","voo doméstico",96,91,187,217,223,440,0,0,0,0
"9740",2016-05-01,"sbiz","transporte não regular","voo internacional",0,0,0,0,0,0,0,0,0,0
"9741",2016-05-01,"sbjc","transporte regular","voo doméstico",0,0,0,0,0,0,0,0,0,0
"9742",2016-05-01,"sbjc","transporte regular","voo internacional",0,0,0,0,0,0,0,0,0,0
"9743",2016-05-01,"sbjc","transporte não regular","voo doméstico",400,400,800,639,445,1084,0,0,0,0
"9744",2016-05-01,"sbjc","transporte não regular","voo internacional",0,0,0,0,0,0,0,0,0,0
"9745",2016-05-01,"sbjr","transporte regular","voo doméstico",0,0,0,0,0,0,0,0,0,0
"9746",2016-05-01,"sbjr","transporte regular","voo internacional",0,0,0,0,0,0,0,0,0,0
"9747",2016-05-01,"sbjr","transporte não regular","voo doméstico",2183,2171,4354,8467,6584,15051,0,0,0,0
"9748",2016-05-01,"sbjr","transporte não regular","voo internacional",0,0,0,0,0,0,0,0,0,0
"9749",2016-05-01,"sbjv","transporte regular","voo doméstico",248,249,497,23222,21707,44929,0,0,0,0
"9750",2016-05-01,"sbjv","transporte regular","voo internacional",0,0,0,0,0,0,0,0,0,0
"9751",2016-05-01,"sbjv","transporte não regular","voo doméstico",87,85,172,134,206,340,0,0,0,0
"9752",2016-05-01,"sbjv","transporte não regular","voo internacional",2,1,3,0,3,3,0,0,0,0
"9753",2016-05-01,"sblo","transporte regular","voo doméstico",330,330,660,31790,31050,62840,0,0,0,0
"9754",2016-05-01,"sblo","transporte regular","voo internacional",0,0,0,0,0,0,0,0,0,0
"9755",2016-05-01,"sblo","transporte não regular","voo doméstico",560,563,1123,3892,4580,8472,0,0,0,0
"9756",2016-05-01,"sblo","transporte não regular","voo internacional",2,1,3,0,0,0,0,0,0,0
"9757",2016-05-01,"sbma","transporte regular","voo doméstico",140,139,279,12372,11939,24311,0,0,0,0
"9758",2016-05-01,"sbma","transporte regular","voo internacional",0,0,0,0,0,0,0,0,0,0
"9759",2016-05-01,"sbma","transporte não regular","voo doméstico",206,204,410,556,524,1080,0,0,0,0
"9760",2016-05-01,"sbma","transporte não regular","voo internacional",0,0,0,0,0,0,0,0,0,0
"9761",2016-05-01,"sbmk","transporte regular","voo doméstico",167,167,334,11750,11502,23252,0,0,0,0
"9762",2016-05-01,"sbmk","transporte regular","voo internacional",0,0,0,0,0,0,0,0,0,0
"9763",2016-05-01,"sbmk","transporte não regular","voo doméstico",200,203,403,13,3,16,0,0,0,0
"9764",2016-05-01,"sbmk","transporte não regular","voo internacional",0,0,0,0,0,0,0,0,0,0
"9765",2016-05-01,"sbmq","transporte regular","voo doméstico",210,211,421,20688,20725,41413,15900,33510,49410,0
"9766",2016-05-01,"sbmq","transporte regular","voo internacional",0,0,0,0,0,0,0,0,0,0
"9767",2016-05-01,"sbmq","transporte não regular","voo doméstico",166,162,328,1252,1088,2340,0,0,0,0
"9768",2016-05-01,"sbmq","transporte não regular","voo internacional",0,0,0,0,0,0,0,0,0,0
"9769",2016-05-01,"sbmt","transporte regular","voo doméstico",0,0,0,0,0,0,0,0,0,0
"9770",2016-05-01,"sbmt","transporte regular","voo internacional",0,0,0,0,0,0,0,0,0,0
"9771",2016-05-01,"sbmt","transporte não regular","voo doméstico",2812,2804,5616,5087,5087,10174,0,0,0,0
"9772",2016-05-01,"sbmt","transporte não regular","voo internacional",0,0,0,0,0,0,0,0,0,0
"9773",2016-05-01,"sbnf","transporte regular","voo doméstico",550,551,1101,58957,56166,115123,0,0,0,0
"9774",2016-05-01,"sbnf","transporte regular","voo internacional",0,0,0,0,0,0,0,0,0,0
"9775",2016-05-01,"sbnf","transporte não regular","voo doméstico",194,194,388,466,1057,1523,0,0,0,0
"9776",2016-05-01,"sbnf","transporte não regular","voo internacional",2,2,4,9,7,16,0,0,0,0
"9777",2016-05-01,"sbpb","transporte regular","voo doméstico",0,0,0,0,0,0,0,0,0,0
"9778",2016-05-01,"sbpb","transporte regular","voo internacional",0,0,0,0,0,0,0,0,0,0
"9779",2016-05-01,"sbpb","transporte não regular","voo doméstico",31,33,64,78,63,141,0,0,0,0
"9780",2016-05-01,"sbpb","transporte não regular","voo internacional",0,0,0,0,0,0,0,0,0,0
"9781",2016-05-01,"sbpj","transporte regular","voo doméstico",261,262,523,26338,26245,52583,0,0,0,0
"9782",2016-05-01,"sbpj","transporte regular","voo internacional",0,0,0,0,0,0,0,0,0,0
"9783",2016-05-01,"sbpj","transporte não regular","voo doméstico",282,281,563,524,385,909,0,0,0,0
"9784",2016-05-01,"sbpj","transporte não regular","voo internacional",0,0,0,0,0,0,0,0,0,0
"9785",2016-05-01,"sbpk","transporte regular","voo doméstico",37,38,75,1628,1656,3284,0,0,0,0
"9786",2016-05-01,"sbpk","transporte regular","voo internacional",0,0,0,0,0,0,0,0,0,0
"9787",2016-05-01,"sbpk","transporte não regular","voo doméstico",36,39,75,78,75,153,0,0,0,0
"9788",2016-05-01,"sbpk","transporte não regular","voo internacional",5,2,7,5,12,17,0,0,0,0
"9789",2016-05-01,"sbpl","transporte regular","voo doméstico",163,164,327,18014,18104,36118,0,0,0,0
"9790",2016-05-01,"sbpl","transporte regular","voo internacional",0,0,0,0,0,0,0,0,0,0
"9791",2016-05-01,"sbpl","transporte não regular","voo doméstico",93,89,182,341,472,813,0,0,0,0
"9792",2016-05-01,"sbpl","transporte não regular","voo internacional",6,6,12,0,0,0,0,0,0,0
"9793",2016-05-01,"sbpp","transporte regular","voo doméstico",0,0,0,0,0,0,0,0,0,0
"9794",2016-05-01,"sbpp","transporte regular","voo internacional",0,0,0,0,0,0,0,0,0,0
"9795",2016-05-01,"sbpp","transporte não regular","voo doméstico",58,54,112,108,110,218,0,0,0,0
"9796",2016-05-01,"sbpp","transporte não regular","voo internacional",4,3,7,3,3,6,0,0,0,0
"9797",2016-05-01,"sbpr","transporte regular","voo doméstico",0,1,1,3,0,3,0,0,0,0
"9798",2016-05-01,"sbpr","transporte regular","voo internacional",0,0,0,0,0,0,0,0,0,0
"9799",2016-05-01,"sbpr","transporte não regular","voo doméstico",751,753,1504,879,798,1677,0,0,0,0
"9800",2016-05-01,"sbpr","transporte não regular","voo internacional",0,0,0,0,0,0,0,0,0,0
"9801",2016-05-01,"sbpv","transporte regular","voo doméstico",341,340,681,33231,33127,66358,0,0,0,0
"9802",2016-05-01,"sbpv","transporte regular","voo internacional",0,0,0,0,0,0,0,0,0,0
"9803",2016-05-01,"sbpv","transporte não regular","voo doméstico",266,265,531,407,289,696,0,0,0,0
"9804",2016-05-01,"sbpv","transporte não regular","voo internacional",1,1,2,0,0,0,0,0,0,0
"9805",2016-05-01,"sbrb","transporte regular","voo doméstico",121,121,242,13125,14360,27485,0,0,0,0
"9806",2016-05-01,"sbrb","transporte regular","voo internacional",0,0,0,0,0,0,0,0,0,0
"9807",2016-05-01,"sbrb","transporte não regular","voo doméstico",127,125,252,395,182,577,0,0,0,0
"9808",2016-05-01,"sbrb","transporte não regular","voo internacional",0,0,0,0,0,0,0,0,0,0
"9809",2016-05-01,"sbrj","transporte regular","voo doméstico",3850,3866,7716,372237,371014,743251,0,481,481,0
"9810",2016-05-01,"sbrj","transporte regular","voo internacional",0,0,0,0,0,0,0,0,0,0
"9811",2016-05-01,"sbrj","transporte não regular","voo doméstico",581,564,1145,364,1246,1610,0,0,0,0
"9812",2016-05-01,"sbrj","transporte não regular","voo internacional",3,2,5,0,0,0,0,0,0,0
"9813",2016-05-01,"sbsj","transporte regular","voo doméstico",22,22,44,2084,2122,4206,0,0,0,0
"9814",2016-05-01,"sbsj","transporte regular","voo internacional",0,0,0,0,0,0,0,0,0,0
"9815",2016-05-01,"sbsj","transporte não regular","voo doméstico",493,476,969,1781,1790,3571,0,0,0,0
"9816",2016-05-01,"sbsj","transporte não regular","voo internacional",0,14,14,31,0,31,0,0,0,0
"9817",2016-05-01,"sbsl","transporte regular","voo doméstico",445,443,888,52375,59487,111862,0,592,592,0
"9818",2016-05-01,"sbsl","transporte regular","voo internacional",0,0,0,0,0,0,0,0,0,0
"9819",2016-05-01,"sbsl","transporte não regular","voo doméstico",218,214,432,580,664,1244,50014,193799,243813,0
"9820",2016-05-01,"sbsl","transporte não regular","voo internacional",0,0,0,0,0,0,0,0,0,0
"9821",2016-05-01,"sbsn","transporte regular","voo doméstico",227,227,454,17381,16858,34239,0,0,0,0
"9822",2016-05-01,"sbsn","transporte regular","voo internacional",0,0,0,0,0,0,0,0,0,0
"9823",2016-05-01,"sbsn","transporte não regular","voo doméstico",276,278,554,1052,719,1771,0,0,0,0
"9824",2016-05-01,"sbsn","transporte não regular","voo internacional",0,0,0,0,0,0,0,0,0,0
"9825",2016-05-01,"sbsp","transporte regular","voo doméstico",7175,7229,14404,863374,860706,1724080,0,0,0,0
"9826",2016-05-01,"sbsp","transporte regular","voo internacional",0,0,0,0,0,0,0,0,0,0
"9827",2016-05-01,"sbsp","transporte não regular","voo doméstico",1773,1717,3490,6546,6779,13325,0,0,0,0
"9828",2016-05-01,"sbsp","transporte não regular","voo internacional",0,0,0,0,0,0,0,0,0,0
"9829",2016-05-01,"sbte","transporte regular","voo doméstico",436,435,871,41957,42964,84921,21676,76676,98352,232312
"9830",2016-05-01,"sbte","transporte regular","voo internacional",0,0,0,0,0,0,0,0,0,0
"9831",2016-05-01,"sbte","transporte não regular","voo doméstico",178,178,356,938,954,1892,0,0,0,0
"9832",2016-05-01,"sbte","transporte não regular","voo internacional",0,0,0,0,0,0,0,0,0,0
"9833",2016-05-01,"sbtf","transporte regular","voo doméstico",41,41,82,1903,1953,3856,0,0,0,0
"9834",2016-05-01,"sbtf","transporte regular","voo internacional",0,0,0,0,0,0,0,0,0,0
"9835",2016-05-01,"sbtf","transporte não regular","voo doméstico",161,161,322,274,209,483,1920,2884,4804,14724
"9836",2016-05-01,"sbtf","transporte não regular","voo internacional",0,0,0,0,0,0,0,0,0,0
"9837",2016-05-01,"sbtt","transporte regular","voo doméstico",30,30,60,2216,2604,4820,0,0,0,0
"9838",2016-05-01,"sbtt","transporte regular","voo internacional",0,0,0,0,0,0,0,0,0,0
"9839",2016-05-01,"sbtt","transporte não regular","voo doméstico",71,71,142,294,285,579,1303,4307,5610,672
"9840",2016-05-01,"sbtt","transporte não regular","voo internacional",1,1,2,3,4,7,0,0,0,0
"9841",2016-05-01,"sbuf","transporte regular","voo doméstico",9,9,18,357,354,711,0,0,0,0
"9842",2016-05-01,"sbuf","transporte regular","voo internacional",0,0,0,0,0,0,0,0,0,0
"9843",2016-05-01,"sbuf","transporte não regular","voo doméstico",30,31,61,77,67,144,0,0,0,0
"9844",2016-05-01,"sbuf","transporte não regular","voo internacional",0,0,0,0,0,0,0,0,0,0
"9845",2016-05-01,"sbug","transporte regular","voo doméstico",25,25,50,1183,1232,2415,0,0,0,0
"9846",2016-05-01,"sbug","transporte regular","voo internacional",0,0,0,0,0,0,0,0,0,0
"9847",2016-05-01,"sbug","transporte não regular","voo doméstico",15,15,30,13,17,30,0,0,0,0
"9848",2016-05-01,"sbug","transporte não regular","voo internacional",0,0,0,0,0,0,0,0,0,0
"9849",2016-05-01,"sbul","transporte regular","voo doméstico",442,439,881,40994,41173,82167,0,0,0,0
"9850",2016-05-01,"sbul","transporte regular","voo internacional",0,0,0,0,0,0,0,0,0,0
"9851",2016-05-01,"sbul","transporte não regular","voo doméstico",550,549,1099,1222,1042,2264,0,0,0,0
"9852",2016-05-01,"sbul","transporte não regular","voo internacional",0,0,0,0,0,0,0,0,0,0
"9853",2016-05-01,"sbur","transporte regular","voo doméstico",104,103,207,4773,4630,9403,0,0,0,0
"9854",2016-05-01,"sbur","transporte regular","voo internacional",0,0,0,0,0,0,0,0,0,0
"9855",2016-05-01,"sbur","transporte não regular","voo doméstico",216,254,470,1039,839,1878,0,0,0,0
"9856",2016-05-01,"sbur","transporte não regular","voo internacional",1,1,2,0,0,0,0,0,0,0
"9857",2016-03-01,"sbbe","transporte regular","voo doméstico",1153,1156,2309,114963,113373,228336,100012,333882,433894,0
"9858",2016-03-01,"sbbe","transporte regular","voo internacional",54,54,108,4049,4427,8476,0,156,156,0
"9859",2016-03-01,"sbbe","transporte não regular","voo doméstico",426,419,845,2586,2210,4796,0,14266,14266,0
"9860",2016-03-01,"sbbe","transporte não regular","voo internacional",14,14,28,285,251,536,0,0,0,0
"9861",2016-03-01,"sbbg","transporte regular","voo doméstico",0,0,0,0,0,0,0,0,0,0
"9862",2016-03-01,"sbbg","transporte regular","voo internacional",0,0,0,0,0,0,0,0,0,0
"9863",2016-03-01,"sbbg","transporte não regular","voo doméstico",12,13,25,57,53,110,0,0,0,0
"9864",2016-03-01,"sbbg","transporte não regular","voo internacional",3,2,5,5,5,10,0,0,0,0
"9865",2016-03-01,"sbbh","transporte regular","voo doméstico",181,180,361,9262,8233,17495,0,0,0,0
"9866",2016-03-01,"sbbh","transporte regular","voo internacional",0,0,0,0,0,0,0,0,0,0
"9867",2016-03-01,"sbbh","transporte não regular","voo doméstico",1865,1879,3744,10388,9953,20341,0,0,0,0
"9868",2016-03-01,"sbbh","transporte não regular","voo internacional",2,3,5,22,16,38,0,0,0,0
"9869",2016-03-01,"sbbi","transporte regular","voo doméstico",0,0,0,0,0,0,0,0,0,0
"9870",2016-03-01,"sbbi","transporte regular","voo internacional",0,0,0,0,0,0,0,0,0,0
"9871",2016-03-01,"sbbi","transporte não regular","voo doméstico",1124,1142,2266,3632,3603,7235,0,0,0,0
"9872",2016-03-01,"sbbi","transporte não regular","voo internacional",0,0,0,0,0,0,0,0,0,0
"9873",2016-03-01,"sbbv","transporte regular","voo doméstico",100,100,200,12125,12066,24191,0,0,0,0
"9874",2016-03-01,"sbbv","transporte regular","voo internacional",0,0,0,0,0,0,0,0,0,0
"9875",2016-03-01,"sbbv","transporte não regular","voo doméstico",155,152,307,124,62,186,0,0,0,0
"9876",2016-03-01,"sbbv","transporte não regular","voo internacional",14,14,28,0,0,0,0,0,0,0
"9877",2016-03-01,"sbcg","transporte regular","voo doméstico",605,607,1212,56534,57081,113615,74270,153493,227763,0
"9878",2016-03-01,"sbcg","transporte regular","voo internacional",0,0,0,0,0,0,0,0,0,0
"9879",2016-03-01,"sbcg","transporte não regular","voo doméstico",259,255,514,455,468,923,0,0,0,0
"9880",2016-03-01,"sbcg","transporte não regular","voo internacional",14,14,28,0,6,6,0,0,0,0
"9881",2016-03-01,"sbcj","transporte regular","voo doméstico",61,61,122,6338,6091,12429,0,0,0,0
"9882",2016-03-01,"sbcj","transporte regular","voo internacional",0,0,0,0,0,0,0,0,0,0
"9883",2016-03-01,"sbcj","transporte não regular","voo doméstico",82,80,162,328,8,336,0,0,0,0
"9884",2016-03-01,"sbcj","transporte não regular","voo internacional",0,0,0,0,0,0,0,0,0,0
"9885",2016-03-01,"sbcr","transporte regular","voo doméstico",17,17,34,1299,1436,2735,0,0,0,0
"9886",2016-03-01,"sbcr","transporte regular","voo internacional",0,0,0,0,0,0,0,0,0,0
"9887",2016-03-01,"sbcr","transporte não regular","voo doméstico",49,48,97,132,105,237,0,0,0,0
"9888",2016-03-01,"sbcr","transporte não regular","voo internacional",5,5,10,7,6,13,0,0,0,0
"9889",2016-03-01,"sbct","transporte regular","voo doméstico",2557,2536,5093,264541,263272,527813,163553,0,163553,164125
"9890",2016-03-01,"sbct","transporte regular","voo internacional",59,59,118,1834,1653,3487,0,3095,3095,0
"9891",2016-03-01,"sbct","transporte não regular","voo doméstico",242,264,506,5141,2423,7564,7137,0,7137,8900
"9892",2016-03-01,"sbct","transporte não regular","voo internacional",10,10,20,25,24,49,0,0,0,0
"9893",2016-03-01,"sbcz","transporte regular","voo doméstico",26,26,52,2396,2360,4756,0,0,0,0
"9894",2016-03-01,"sbcz","transporte regular","voo internacional",0,0,0,0,0,0,0,0,0,0
"9895",2016-03-01,"sbcz","transporte não regular","voo doméstico",142,142,284,493,475,968,0,0,0,0
"9896",2016-03-01,"sbcz","transporte não regular","voo internacional",2,2,4,0,0,0,0,0,0,0
"9897",2016-03-01,"sbeg","transporte regular","voo doméstico",992,988,1980,101759,98295,200054,0,0,0,0
"9898",2016-03-01,"sbeg","transporte regular","voo internacional",107,104,211,4684,4519,9203,0,0,0,0
"9899",2016-03-01,"sbeg","transporte não regular","voo doméstico",421,421,842,5161,4435,9596,0,0,0,0
"9900",2016-03-01,"sbeg","transporte não regular","voo internacional",106,111,217,719,633,1352,0,0,0,0
"9901",2016-03-01,"sbfi","transporte regular","voo doméstico",576,573,1149,74643,73643,148286,0,0,0,0
"9902",2016-03-01,"sbfi","transporte regular","voo internacional",21,21,42,2755,2332,5087,0,0,0,0
"9903",2016-03-01,"sbfi","transporte não regular","voo doméstico",152,156,308,1910,2258,4168,0,0,0,0
"9904",2016-03-01,"sbfi","transporte não regular","voo internacional",41,40,81,223,203,426,0,0,0,0
"9905",2016-03-01,"sbgo","transporte regular","voo doméstico",1284,1286,2570,118864,118017,236881,121098,181526,302624,200605
"9906",2016-03-01,"sbgo","transporte regular","voo internacional",0,0,0,0,0,0,0,0,0,0
"9907",2016-03-01,"sbgo","transporte não regular","voo doméstico",1361,1350,2711,4953,5317,10270,0,0,0,0
"9908",2016-03-01,"sbgo","transporte não regular","voo internacional",2,4,6,0,0,0,0,0,0,0
"9909",2016-03-01,"sbht","transporte regular","voo doméstico",177,176,353,8792,8332,17124,0,0,0,0
"9910",2016-03-01,"sbht","transporte regular","voo internacional",0,0,0,0,0,0,0,0,0,0
"9911",2016-03-01,"sbht","transporte não regular","voo doméstico",169,168,337,418,417,835,0,0,0,0
"9912",2016-03-01,"sbht","transporte não regular","voo internacional",0,0,0,0,0,0,0,0,0,0
"9913",2016-03-01,"sbiz","transporte regular","voo doméstico",203,204,407,15047,14322,29369,0,0,0,0
"9914",2016-03-01,"sbiz","transporte regular","voo internacional",0,0,0,0,0,0,0,0,0,0
"9915",2016-03-01,"sbiz","transporte não regular","voo doméstico",102,102,204,237,230,467,0,0,0,0
"9916",2016-03-01,"sbiz","transporte não regular","voo internacional",0,0,0,0,0,0,0,0,0,0
"9917",2016-03-01,"sbjc","transporte regular","voo doméstico",0,0,0,0,0,0,0,0,0,0
"9918",2016-03-01,"sbjc","transporte regular","voo internacional",0,0,0,0,0,0,0,0,0,0
"9919",2016-03-01,"sbjc","transporte não regular","voo doméstico",346,343,689,676,455,1131,0,0,0,0
"9920",2016-03-01,"sbjc","transporte não regular","voo internacional",0,1,1,0,0,0,0,0,0,0
"9921",2016-03-01,"sbjr","transporte regular","voo doméstico",0,0,0,0,0,0,0,0,0,0
"9922",2016-03-01,"sbjr","transporte regular","voo internacional",0,0,0,0,0,0,0,0,0,0
"9923",2016-03-01,"sbjr","transporte não regular","voo doméstico",2580,2573,5153,9728,8030,17758,0,0,0,0
"9924",2016-03-01,"sbjr","transporte não regular","voo internacional",0,0,0,0,0,0,0,0,0,0
"9925",2016-03-01,"sbjv","transporte regular","voo doméstico",240,240,480,18816,18771,37587,0,0,0,0
"9926",2016-03-01,"sbjv","transporte regular","voo internacional",0,0,0,0,0,0,0,0,0,0
"9927",2016-03-01,"sbjv","transporte não regular","voo doméstico",117,116,233,62,51,113,0,0,0,0
"9928",2016-03-01,"sbjv","transporte não regular","voo internacional",0,0,0,0,0,0,0,0,0,0
"9929",2016-03-01,"sblo","transporte regular","voo doméstico",437,436,873,37171,36421,73592,0,0,0,0
"9930",2016-03-01,"sblo","transporte regular","voo internacional",0,0,0,0,0,0,0,0,0,0
"9931",2016-03-01,"sblo","transporte não regular","voo doméstico",659,657,1316,371,537,908,0,0,0,0
"9932",2016-03-01,"sblo","transporte não regular","voo internacional",1,1,2,0,0,0,0,0,0,0
"9933",2016-03-01,"sbma","transporte regular","voo doméstico",138,138,276,12426,11930,24356,0,0,0,0
"9934",2016-03-01,"sbma","transporte regular","voo internacional",0,0,0,0,0,0,0,0,0,0
"9935",2016-03-01,"sbma","transporte não regular","voo doméstico",160,161,321,825,1030,1855,0,0,0,0
"9936",2016-03-01,"sbma","transporte não regular","voo internacional",3,3,6,0,0,0,0,0,0,0
"9937",2016-03-01,"sbmk","transporte regular","voo doméstico",162,166,328,11487,10971,22458,0,0,0,0
"9938",2016-03-01,"sbmk","transporte regular","voo internacional",0,0,0,0,0,0,0,0,0,0
"9939",2016-03-01,"sbmk","transporte não regular","voo doméstico",191,190,381,11,382,393,0,0,0,0
"9940",2016-03-01,"sbmk","transporte não regular","voo internacional",0,0,0,0,0,0,0,0,0,0
"9941",2016-03-01,"sbmq","transporte regular","voo doméstico",225,225,450,21276,21710,42986,13280,36300,49580,0
"9942",2016-03-01,"sbmq","transporte regular","voo internacional",0,0,0,0,0,0,0,0,0,0
"9943",2016-03-01,"sbmq","transporte não regular","voo doméstico",156,154,310,708,582,1290,0,0,0,0
"9944",2016-03-01,"sbmq","transporte não regular","voo internacional",4,5,9,0,0,0,0,0,0,0
"9945",2016-03-01,"sbmt","transporte regular","voo doméstico",0,0,0,0,0,0,0,0,0,0
"9946",2016-03-01,"sbmt","transporte regular","voo internacional",0,0,0,0,0,0,0,0,0,0
"9947",2016-03-01,"sbmt","transporte não regular","voo doméstico",3365,3362,6727,6007,5925,11932,0,0,0,0
"9948",2016-03-01,"sbmt","transporte não regular","voo internacional",0,0,0,0,0,0,0,0,0,0
"9949",2016-03-01,"sbnf","transporte regular","voo doméstico",620,645,1265,63753,62001,125754,0,64,64,0
"9950",2016-03-01,"sbnf","transporte regular","voo internacional",0,0,0,0,0,0,0,0,0,0
"9951",2016-03-01,"sbnf","transporte não regular","voo doméstico",235,210,445,644,2985,3629,0,0,0,0
"9952",2016-03-01,"sbnf","transporte não regular","voo internacional",4,4,8,4,5,9,0,0,0,0
"9953",2016-03-01,"sbpb","transporte regular","voo doméstico",0,0,0,0,0,0,0,0,0,0
"9954",2016-03-01,"sbpb","transporte regular","voo internacional",0,0,0,0,0,0,0,0,0,0
"9955",2016-03-01,"sbpb","transporte não regular","voo doméstico",29,28,57,68,81,149,0,0,0,0
"9956",2016-03-01,"sbpb","transporte não regular","voo internacional",0,0,0,0,0,0,0,0,0,0
"9957",2016-03-01,"sbpj","transporte regular","voo doméstico",254,253,507,23980,23801,47781,0,0,0,0
"9958",2016-03-01,"sbpj","transporte regular","voo internacional",0,0,0,0,0,0,0,0,0,0
"9959",2016-03-01,"sbpj","transporte não regular","voo doméstico",261,265,526,663,424,1087,0,0,0,0
"9960",2016-03-01,"sbpj","transporte não regular","voo internacional",3,3,6,0,0,0,0,0,0,0
"9961",2016-03-01,"sbpk","transporte regular","voo doméstico",52,52,104,2156,2363,4519,0,0,0,0
"9962",2016-03-01,"sbpk","transporte regular","voo internacional",0,0,0,0,0,0,0,0,0,0
"9963",2016-03-01,"sbpk","transporte não regular","voo doméstico",40,40,80,119,130,249,0,0,0,0
"9964",2016-03-01,"sbpk","transporte não regular","voo internacional",4,4,8,13,17,30,0,0,0,0
"9965",2016-03-01,"sbpl","transporte regular","voo doméstico",149,149,298,17107,17741,34848,0,0,0,0
"9966",2016-03-01,"sbpl","transporte regular","voo internacional",5,5,10,0,0,0,0,0,0,0
"9967",2016-03-01,"sbpl","transporte não regular","voo doméstico",134,134,268,1040,1057,2097,0,0,0,0
"9968",2016-03-01,"sbpl","transporte não regular","voo internacional",0,0,0,0,0,0,0,0,0,0
"9969",2016-03-01,"sbpp","transporte regular","voo doméstico",0,0,0,0,0,0,0,0,0,0
"9970",2016-03-01,"sbpp","transporte regular","voo internacional",0,0,0,0,0,0,0,0,0,0
"9971",2016-03-01,"sbpp","transporte não regular","voo doméstico",87,87,174,159,150,309,0,0,0,0
"9972",2016-03-01,"sbpp","transporte não regular","voo internacional",11,12,23,14,9,23,0,0,0,0
"9973",2016-03-01,"sbpr","transporte regular","voo doméstico",0,0,0,0,0,0,0,0,0,0
"9974",2016-03-01,"sbpr","transporte regular","voo internacional",0,0,0,0,0,0,0,0,0,0
"9975",2016-03-01,"sbpr","transporte não regular","voo doméstico",643,648,1291,836,795,1631,0,0,0,0
"9976",2016-03-01,"sbpr","transporte não regular","voo internacional",0,0,0,0,0,0,0,0,0,0
"9977",2016-03-01,"sbpv","transporte regular","voo doméstico",410,410,820,34805,33196,68001,0,0,0,3
"9978",2016-03-01,"sbpv","transporte regular","voo internacional",0,0,0,0,0,0,0,0,0,0
"9979",2016-03-01,"sbpv","transporte não regular","voo doméstico",261,262,523,263,333,596,0,0,0,0
"9980",2016-03-01,"sbpv","transporte não regular","voo internacional",1,1,2,0,0,0,0,0,0,0
"9981",2016-03-01,"sbrb","transporte regular","voo doméstico",175,177,352,16222,16953,33175,0,0,0,0
"9982",2016-03-01,"sbrb","transporte regular","voo internacional",0,0,0,0,0,0,0,0,0,0
"9983",2016-03-01,"sbrb","transporte não regular","voo doméstico",120,116,236,504,597,1101,0,0,0,0
"9984",2016-03-01,"sbrb","transporte não regular","voo internacional",1,1,2,0,0,0,0,0,0,0
"9985",2016-03-01,"sbrj","transporte regular","voo doméstico",4022,4039,8061,364165,360834,724999,55,0,55,0
"9986",2016-03-01,"sbrj","transporte regular","voo internacional",0,0,0,0,36,36,0,0,0,0
"9987",2016-03-01,"sbrj","transporte não regular","voo doméstico",651,634,1285,3513,4211,7724,0,0,0,0
"9988",2016-03-01,"sbrj","transporte não regular","voo internacional",2,2,4,0,0,0,0,0,0,0
"9989",2016-03-01,"sbsj","transporte regular","voo doméstico",26,26,52,2194,2402,4596,0,0,0,0
"9990",2016-03-01,"sbsj","transporte regular","voo internacional",0,0,0,0,0,0,0,0,0,0
"9991",2016-03-01,"sbsj","transporte não regular","voo doméstico",509,500,1009,2024,2140,4164,0,0,0,0
"9992",2016-03-01,"sbsj","transporte não regular","voo internacional",4,21,25,47,8,55,0,0,0,0
"9993",2016-03-01,"sbsl","transporte regular","voo doméstico",593,591,1184,63068,67371,130439,0,0,0,0
"9994",2016-03-01,"sbsl","transporte regular","voo internacional",0,0,0,0,0,0,0,0,0,0
"9995",2016-03-01,"sbsl","transporte não regular","voo doméstico",217,216,433,761,374,1135,57484,215892,273376,0
"9996",2016-03-01,"sbsl","transporte não regular","voo internacional",2,2,4,0,0,0,0,0,0,0
"9997",2016-03-01,"sbsn","transporte regular","voo doméstico",296,296,592,19520,18094,37614,0,0,0,0
"9998",2016-03-01,"sbsn","transporte regular","voo internacional",0,0,0,0,0,0,0,0,0,0
"9999",2016-03-01,"sbsn","transporte não regular","voo doméstico",303,298,601,1091,947,2038,0,0,0,0
"10000",2016-03-01,"sbsn","transporte não regular","voo internacional",1,2,3,0,0,0,0,0,0,0
"10001",2016-03-01,"sbsp","transporte regular","voo doméstico",7363,7430,14793,809021,801050,1610071,0,0,0,0
"10002",2016-03-01,"sbsp","transporte regular","voo internacional",0,0,0,0,0,0,0,0,0,0
"10003",2016-03-01,"sbsp","transporte não regular","voo doméstico",1802,1744,3546,8836,10218,19054,0,0,0,0
"10004",2016-03-01,"sbsp","transporte não regular","voo internacional",0,0,0,0,0,0,0,0,0,0
"10005",2016-03-01,"sbte","transporte regular","voo doméstico",484,482,966,44361,45440,89801,23302,85861,109163,270965
"10006",2016-03-01,"sbte","transporte regular","voo internacional",0,0,0,0,0,0,0,0,0,0
"10007",2016-03-01,"sbte","transporte não regular","voo doméstico",140,142,282,826,824,1650,0,0,0,0
"10008",2016-03-01,"sbte","transporte não regular","voo internacional",0,0,0,0,0,0,0,0,0,0
"10009",2016-03-01,"sbtf","transporte regular","voo doméstico",45,45,90,1829,2023,3852,0,0,0,0
"10010",2016-03-01,"sbtf","transporte regular","voo internacional",0,0,0,0,0,0,0,0,0,0
"10011",2016-03-01,"sbtf","transporte não regular","voo doméstico",161,163,324,241,193,434,1710,3845,5555,10673
"10012",2016-03-01,"sbtf","transporte não regular","voo internacional",0,1,1,0,0,0,0,0,0,0
"10013",2016-03-01,"sbtt","transporte regular","voo doméstico",31,31,62,1921,2555,4476,0,0,0,0
"10014",2016-03-01,"sbtt","transporte regular","voo internacional",0,0,0,0,0,0,0,0,0,0
"10015",2016-03-01,"sbtt","transporte não regular","voo doméstico",53,53,106,248,223,471,1108,3460,4568,733
"10016",2016-03-01,"sbtt","transporte não regular","voo internacional",3,3,6,3,1,4,0,0,0,0
"10017",2016-03-01,"sbuf","transporte regular","voo doméstico",4,4,8,114,137,251,0,0,0,0
"10018",2016-03-01,"sbuf","transporte regular","voo internacional",0,0,0,0,0,0,0,0,0,0
"10019",2016-03-01,"sbuf","transporte não regular","voo doméstico",52,53,105,329,339,668,0,0,0,0
"10020",2016-03-01,"sbuf","transporte não regular","voo internacional",0,0,0,0,0,0,0,0,0,0
"10021",2016-03-01,"sbug","transporte regular","voo doméstico",27,27,54,1449,1413,2862,0,0,0,0
"10022",2016-03-01,"sbug","transporte regular","voo internacional",0,0,0,0,0,0,0,0,0,0
"10023",2016-03-01,"sbug","transporte não regular","voo doméstico",10,9,19,19,12,31,0,0,0,0
"10024",2016-03-01,"sbug","transporte não regular","voo internacional",0,0,0,0,0,0,0,0,0,0
"10025",2016-03-01,"sbul","transporte regular","voo doméstico",479,477,956,41288,40880,82168,0,0,0,0
"10026",2016-03-01,"sbul","transporte regular","voo internacional",0,0,0,0,0,0,0,0,0,0
"10027",2016-03-01,"sbul","transporte não regular","voo doméstico",632,629,1261,1409,1389,2798,0,0,0,0
"10028",2016-03-01,"sbul","transporte não regular","voo internacional",0,0,0,0,0,0,0,0,0,0
"10029",2016-03-01,"sbur","transporte regular","voo doméstico",78,81,159,3482,3502,6984,0,0,0,0
"10030",2016-03-01,"sbur","transporte regular","voo internacional",0,0,0,0,0,0,0,0,0,0
"10031",2016-03-01,"sbur","transporte não regular","voo doméstico",177,180,357,1444,1562,3006,0,0,0,0
"10032",2016-03-01,"sbur","transporte não regular","voo internacional",0,0,0,0,0,0,0,0,0,0
"10033",2016-11-01,"sbbe","transporte regular","voo doméstico",1264,1267,2531,138284,134631,272915,117648,295394,413042,0
"10034",2016-11-01,"sbbe","transporte regular","voo internacional",51,49,100,5787,5775,11562,0,9,9,0
"10035",2016-11-01,"sbbe","transporte não regular","voo doméstico",456,450,906,2237,2206,4443,0,0,0,0
"10036",2016-11-01,"sbbe","transporte não regular","voo internacional",6,8,14,140,16,156,0,0,0,0
"10037",2016-11-01,"sbbg","transporte regular","voo doméstico",0,0,0,0,0,0,0,0,0,0
"10038",2016-11-01,"sbbg","transporte regular","voo internacional",0,0,0,0,0,0,0,0,0,0
"10039",2016-11-01,"sbbg","transporte não regular","voo doméstico",20,20,40,82,98,180,0,0,0,0
"10040",2016-11-01,"sbbg","transporte não regular","voo internacional",5,5,10,20,24,44,0,0,0,0
"10041",2016-11-01,"sbbh","transporte regular","voo doméstico",50,50,100,1742,1697,3439,0,0,0,0
"10042",2016-11-01,"sbbh","transporte regular","voo internacional",0,0,0,0,0,0,0,0,0,0
"10043",2016-11-01,"sbbh","transporte não regular","voo doméstico",1445,1462,2907,6996,7018,14014,0,0,0,0
"10044",2016-11-01,"sbbh","transporte não regular","voo internacional",2,1,3,8,16,24,0,0,0,0
"10045",2016-11-01,"sbbi","transporte regular","voo doméstico",0,0,0,0,0,0,0,0,0,0
"10046",2016-11-01,"sbbi","transporte regular","voo internacional",0,0,0,0,0,0,0,0,0,0
"10047",2016-11-01,"sbbi","transporte não regular","voo doméstico",725,712,1437,2663,2660,5323,0,0,0,0
"10048",2016-11-01,"sbbi","transporte não regular","voo internacional",1,1,2,0,0,0,0,0,0,0
"10049",2016-11-01,"sbbv","transporte regular","voo doméstico",100,100,200,13443,13039,26482,0,0,0,0
"10050",2016-11-01,"sbbv","transporte regular","voo internacional",0,0,0,0,0,0,0,0,0,0
"10051",2016-11-01,"sbbv","transporte não regular","voo doméstico",78,77,155,103,29,132,0,0,0,0
"10052",2016-11-01,"sbbv","transporte não regular","voo internacional",17,14,31,0,1,1,0,0,0,0
"10053",2016-11-01,"sbcg","transporte regular","voo doméstico",504,505,1009,60308,57889,118197,7228,23049,30277,0
"10054",2016-11-01,"sbcg","transporte regular","voo internacional",0,0,0,0,0,0,0,0,0,0
"10055",2016-11-01,"sbcg","transporte não regular","voo doméstico",199,196,395,498,849,1347,0,0,0,0
"10056",2016-11-01,"sbcg","transporte não regular","voo internacional",10,9,19,0,0,0,0,0,0,0
"10057",2016-11-01,"sbcj","transporte regular","voo doméstico",65,65,130,6070,5962,12032,0,0,0,0
"10058",2016-11-01,"sbcj","transporte regular","voo internacional",0,0,0,0,0,0,0,0,0,0
"10059",2016-11-01,"sbcj","transporte não regular","voo doméstico",138,139,277,365,249,614,0,0,0,0
"10060",2016-11-01,"sbcj","transporte não regular","voo internacional",0,0,0,0,0,0,0,0,0,0
"10061",2016-11-01,"sbcr","transporte regular","voo doméstico",16,16,32,1504,1231,2735,0,0,0,0
"10062",2016-11-01,"sbcr","transporte regular","voo internacional",0,0,0,0,0,0,0,0,0,0
"10063",2016-11-01,"sbcr","transporte não regular","voo doméstico",27,28,55,116,104,220,0,0,0,0
"10064",2016-11-01,"sbcr","transporte não regular","voo internacional",1,2,3,6,3,9,0,0,0,0
"10065",2016-11-01,"sbct","transporte regular","voo doméstico",2525,2500,5025,260680,262280,522960,161809,205992,367801,132512
"10066",2016-11-01,"sbct","transporte regular","voo internacional",52,51,103,1572,1633,3205,0,39273,39273,0
"10067",2016-11-01,"sbct","transporte não regular","voo doméstico",237,265,502,6286,4342,10628,0,0,0,0
"10068",2016-11-01,"sbct","transporte não regular","voo internacional",12,12,24,78,63,141,0,0,0,0
"10069",2016-11-01,"sbcz","transporte regular","voo doméstico",29,30,59,2603,2303,4906,0,0,0,0
"10070",2016-11-01,"sbcz","transporte regular","voo internacional",0,0,0,0,0,0,0,0,0,0
"10071",2016-11-01,"sbcz","transporte não regular","voo doméstico",164,163,327,553,548,1101,0,0,0,0
"10072",2016-11-01,"sbcz","transporte não regular","voo internacional",3,3,6,0,0,0,0,0,0,0
"10073",2016-11-01,"sbeg","transporte regular","voo doméstico",837,836,1673,96078,87380,183458,0,0,0,0
"10074",2016-11-01,"sbeg","transporte regular","voo internacional",107,103,210,4786,5010,9796,0,0,0,0
"10075",2016-11-01,"sbeg","transporte não regular","voo doméstico",511,505,1016,5220,5323,10543,0,236,236,0
"10076",2016-11-01,"sbeg","transporte não regular","voo internacional",74,85,159,452,210,662,0,0,0,0
"10077",2016-11-01,"sbfi","transporte regular","voo doméstico",550,551,1101,69986,67037,137023,0,0,0,0
"10078",2016-11-01,"sbfi","transporte regular","voo internacional",22,21,43,2796,2251,5047,0,0,0,0
"10079",2016-11-01,"sbfi","transporte não regular","voo doméstico",112,114,226,3108,3317,6425,0,0,0,0
"10080",2016-11-01,"sbfi","transporte não regular","voo internacional",29,27,56,43,64,107,0,0,0,0
"10081",2016-11-01,"sbgo","transporte regular","voo doméstico",1089,1090,2179,115209,114077,229286,13334,25458,38792,26509
"10082",2016-11-01,"sbgo","transporte regular","voo internacional",0,0,0,0,0,0,0,0,0,0
"10083",2016-11-01,"sbgo","transporte não regular","voo doméstico",1178,1172,2350,5431,5147,10578,0,0,0,0
"10084",2016-11-01,"sbgo","transporte não regular","voo internacional",3,3,6,0,0,0,0,0,0,0
"10085",2016-11-01,"sbht","transporte regular","voo doméstico",155,154,309,5292,5175,10467,0,0,0,0
"10086",2016-11-01,"sbht","transporte regular","voo internacional",0,0,0,0,0,0,0,0,0,0
"10087",2016-11-01,"sbht","transporte não regular","voo doméstico",65,66,131,185,170,355,0,0,0,0
"10088",2016-11-01,"sbht","transporte não regular","voo internacional",0,0,0,0,0,0,0,0,0,0
"10089",2016-11-01,"sbiz","transporte regular","voo doméstico",124,124,248,10292,10305,20597,0,0,0,0
"10090",2016-11-01,"sbiz","transporte regular","voo internacional",0,0,0,0,0,0,0,0,0,0
"10091",2016-11-01,"sbiz","transporte não regular","voo doméstico",99,98,197,183,240,423,0,0,0,0
"10092",2016-11-01,"sbiz","transporte não regular","voo internacional",0,0,0,0,0,0,0,0,0,0
"10093",2016-11-01,"sbjc","transporte regular","voo doméstico",0,0,0,0,0,0,0,0,0,0
"10094",2016-11-01,"sbjc","transporte regular","voo internacional",0,0,0,0,0,0,0,0,0,0
"10095",2016-11-01,"sbjc","transporte não regular","voo doméstico",309,313,622,504,320,824,0,0,0,0
"10096",2016-11-01,"sbjc","transporte não regular","voo internacional",0,0,0,0,0,0,0,0,0,0
"10097",2016-11-01,"sbjr","transporte regular","voo doméstico",0,0,0,0,0,0,0,0,0,0
"10098",2016-11-01,"sbjr","transporte regular","voo internacional",0,0,0,0,0,0,0,0,0,0
"10099",2016-11-01,"sbjr","transporte não regular","voo doméstico",2221,2222,4443,10360,9137,19497,0,0,0,0
"10100",2016-11-01,"sbjr","transporte não regular","voo internacional",0,0,0,0,0,0,0,0,0,0
"10101",2016-11-01,"sbjv","transporte regular","voo doméstico",235,234,469,22754,21956,44710,0,0,0,0
"10102",2016-11-01,"sbjv","transporte regular","voo internacional",0,0,0,0,0,0,0,0,0,0
"10103",2016-11-01,"sbjv","transporte não regular","voo doméstico",111,111,222,76,78,154,0,0,0,0
"10104",2016-11-01,"sbjv","transporte não regular","voo internacional",0,0,0,0,0,0,0,0,0,0
"10105",2016-11-01,"sblo","transporte regular","voo doméstico",401,402,803,36773,36118,72891,0,0,0,0
"10106",2016-11-01,"sblo","transporte regular","voo internacional",0,0,0,0,0,0,0,0,0,0
"10107",2016-11-01,"sblo","transporte não regular","voo doméstico",596,602,1198,445,535,980,0,0,0,0
"10108",2016-11-01,"sblo","transporte não regular","voo internacional",3,3,6,0,0,0,0,0,0,0
"10109",2016-11-01,"sbma","transporte regular","voo doméstico",142,144,286,12774,12046,24820,0,0,0,0
"10110",2016-11-01,"sbma","transporte regular","voo internacional",0,0,0,0,0,0,0,0,0,0
"10111",2016-11-01,"sbma","transporte não regular","voo doméstico",181,181,362,516,568,1084,0,0,0,0
"10112",2016-11-01,"sbma","transporte não regular","voo internacional",5,5,10,0,0,0,0,0,0,0
"10113",2016-11-01,"sbmk","transporte regular","voo doméstico",166,168,334,11597,11218,22815,0,0,0,0
"10114",2016-11-01,"sbmk","transporte regular","voo internacional",0,0,0,0,0,0,0,0,0,0
"10115",2016-11-01,"sbmk","transporte não regular","voo doméstico",181,182,363,75,121,196,0,0,0,0
"10116",2016-11-01,"sbmk","transporte não regular","voo internacional",0,0,0,0,0,0,0,0,0,0
"10117",2016-11-01,"sbmq","transporte regular","voo doméstico",239,240,479,25962,25270,51232,11910,32918,44828,0
"10118",2016-11-01,"sbmq","transporte regular","voo internacional",0,0,0,0,0,0,0,0,0,0
"10119",2016-11-01,"sbmq","transporte não regular","voo doméstico",167,165,332,181,45,226,0,0,0,0
"10120",2016-11-01,"sbmq","transporte não regular","voo internacional",9,8,17,0,0,0,0,0,0,0
"10121",2016-11-01,"sbmt","transporte regular","voo doméstico",0,0,0,0,0,0,0,0,0,0
"10122",2016-11-01,"sbmt","transporte regular","voo internacional",0,0,0,0,0,0,0,0,0,0
"10123",2016-11-01,"sbmt","transporte não regular","voo doméstico",2667,2676,5343,4699,4604,9303,0,0,0,0
"10124",2016-11-01,"sbmt","transporte não regular","voo internacional",0,0,0,0,0,0,0,0,0,0
"10125",2016-11-01,"sbnf","transporte regular","voo doméstico",508,507,1015,58006,56530,114536,0,0,0,0
"10126",2016-11-01,"sbnf","transporte regular","voo internacional",0,0,0,0,0,0,0,0,0,0
"10127",2016-11-01,"sbnf","transporte não regular","voo doméstico",246,250,496,562,588,1150,0,0,0,0
"10128",2016-11-01,"sbnf","transporte não regular","voo internacional",3,3,6,6,4,10,0,0,0,0
"10129",2016-11-01,"sbpb","transporte regular","voo doméstico",4,4,8,343,368,711,0,0,0,0
"10130",2016-11-01,"sbpb","transporte regular","voo internacional",0,0,0,0,0,0,0,0,0,0
"10131",2016-11-01,"sbpb","transporte não regular","voo doméstico",59,62,121,146,328,474,0,0,0,0
"10132",2016-11-01,"sbpb","transporte não regular","voo internacional",0,0,0,0,0,0,0,0,0,0
"10133",2016-11-01,"sbpj","transporte regular","voo doméstico",238,241,479,23507,22529,46036,0,0,0,0
"10134",2016-11-01,"sbpj","transporte regular","voo internacional",0,0,0,0,0,0,0,0,0,0
"10135",2016-11-01,"sbpj","transporte não regular","voo doméstico",242,240,482,837,982,1819,0,0,0,0
"10136",2016-11-01,"sbpj","transporte não regular","voo internacional",6,4,10,0,0,0,0,0,0,0
"10137",2016-11-01,"sbpk","transporte regular","voo doméstico",24,24,48,1310,1128,2438,0,0,0,0
"10138",2016-11-01,"sbpk","transporte regular","voo internacional",0,0,0,0,0,0,0,0,0,0
"10139",2016-11-01,"sbpk","transporte não regular","voo doméstico",62,61,123,106,123,229,0,0,0,0
"10140",2016-11-01,"sbpk","transporte não regular","voo internacional",1,2,3,9,0,9,0,0,0,0
"10141",2016-11-01,"sbpl","transporte regular","voo doméstico",163,164,327,19287,15910,35197,0,0,0,0
"10142",2016-11-01,"sbpl","transporte regular","voo internacional",1,1,2,0,0,0,0,0,0,0
"10143",2016-11-01,"sbpl","transporte não regular","voo doméstico",77,73,150,105,108,213,0,0,0,0
"10144",2016-11-01,"sbpl","transporte não regular","voo internacional",4,4,8,0,0,0,0,0,0,0
"10145",2016-11-01,"sbpp","transporte regular","voo doméstico",0,0,0,0,0,0,0,0,0,0
"10146",2016-11-01,"sbpp","transporte regular","voo internacional",0,0,0,0,0,0,0,0,0,0
"10147",2016-11-01,"sbpp","transporte não regular","voo doméstico",113,110,223,166,174,340,0,0,0,0
"10148",2016-11-01,"sbpp","transporte não regular","voo internacional",10,10,20,16,14,30,0,0,0,0
"10149",2016-11-01,"sbpr","transporte regular","voo doméstico",0,0,0,0,0,0,0,0,0,0
"10150",2016-11-01,"sbpr","transporte regular","voo internacional",0,0,0,0,0,0,0,0,0,0
"10151",2016-11-01,"sbpr","transporte não regular","voo doméstico",614,605,1219,728,650,1378,0,0,0,0
"10152",2016-11-01,"sbpr","transporte não regular","voo internacional",3,3,6,0,0,0,0,0,0,0
"10153",2016-11-01,"sbpv","transporte regular","voo doméstico",319,319,638,31803,30631,62434,0,0,0,0
"10154",2016-11-01,"sbpv","transporte regular","voo internacional",0,0,0,0,0,0,0,0,0,0
"10155",2016-11-01,"sbpv","transporte não regular","voo doméstico",206,209,415,356,408,764,0,0,0,0
"10156",2016-11-01,"sbpv","transporte não regular","voo internacional",0,0,0,0,0,0,0,0,0,0
"10157",2016-11-01,"sbrb","transporte regular","voo doméstico",128,126,254,12807,12682,25489,0,0,0,0
"10158",2016-11-01,"sbrb","transporte regular","voo internacional",0,0,0,0,0,0,0,0,0,0
"10159",2016-11-01,"sbrb","transporte não regular","voo doméstico",110,111,221,264,313,577,0,0,0,0
"10160",2016-11-01,"sbrb","transporte não regular","voo internacional",2,2,4,0,0,0,0,0,0,0
"10161",2016-11-01,"sbrj","transporte regular","voo doméstico",3671,3700,7371,381743,371833,753576,0,0,0,0
"10162",2016-11-01,"sbrj","transporte regular","voo internacional",0,0,0,0,0,0,0,0,0,0
"10163",2016-11-01,"sbrj","transporte não regular","voo doméstico",578,548,1126,565,2320,2885,0,0,0,0
"10164",2016-11-01,"sbrj","transporte não regular","voo internacional",1,1,2,0,0,0,0,0,0,0
"10165",2016-11-01,"sbsj","transporte regular","voo doméstico",0,0,0,0,0,0,0,0,0,0
"10166",2016-11-01,"sbsj","transporte regular","voo internacional",0,0,0,0,0,0,0,0,0,0
"10167",2016-11-01,"sbsj","transporte não regular","voo doméstico",287,276,563,559,592,1151,0,0,0,0
"10168",2016-11-01,"sbsj","transporte não regular","voo internacional",5,17,22,42,12,54,0,0,0,0
"10169",2016-11-01,"sbsl","transporte regular","voo doméstico",533,556,1089,51231,52711,103942,0,0,0,0
"10170",2016-11-01,"sbsl","transporte regular","voo internacional",0,0,0,0,0,0,0,0,0,0
"10171",2016-11-01,"sbsl","transporte não regular","voo doméstico",254,235,489,3093,7785,10878,58178,188859,247037,0
"10172",2016-11-01,"sbsl","transporte não regular","voo internacional",0,0,0,0,0,0,0,0,0,0
"10173",2016-11-01,"sbsn","transporte regular","voo doméstico",252,254,506,20140,17827,37967,44,0,44,0
"10174",2016-11-01,"sbsn","transporte regular","voo internacional",0,0,0,0,0,0,0,0,0,0
"10175",2016-11-01,"sbsn","transporte não regular","voo doméstico",188,188,376,697,674,1371,0,0,0,0
"10176",2016-11-01,"sbsn","transporte não regular","voo internacional",0,1,1,0,0,0,0,0,0,0
"10177",2016-11-01,"sbsp","transporte regular","voo doméstico",7126,7199,14325,892731,891419,1784150,0,0,0,0
"10178",2016-11-01,"sbsp","transporte regular","voo internacional",0,0,0,0,0,0,0,0,0,0
"10179",2016-11-01,"sbsp","transporte não regular","voo doméstico",1769,1702,3471,8007,7010,15017,0,0,0,0
"10180",2016-11-01,"sbsp","transporte não regular","voo internacional",0,0,0,0,0,0,0,0,0,0
"10181",2016-11-01,"sbte","transporte regular","voo doméstico",435,439,874,41421,41330,82751,31933,63835,95768,225160
"10182",2016-11-01,"sbte","transporte regular","voo internacional",0,0,0,0,0,0,0,0,0,0
"10183",2016-11-01,"sbte","transporte não regular","voo doméstico",209,205,414,1131,1370,2501,0,3426,3426,9424
"10184",2016-11-01,"sbte","transporte não regular","voo internacional",0,0,0,0,0,0,0,0,0,0
"10185",2016-11-01,"sbtf","transporte regular","voo doméstico",37,37,74,1441,1456,2897,0,0,0,0
"10186",2016-11-01,"sbtf","transporte regular","voo internacional",0,0,0,0,0,0,0,0,0,0
"10187",2016-11-01,"sbtf","transporte não regular","voo doméstico",81,80,161,376,382,758,3069,2641,5710,11273
"10188",2016-11-01,"sbtf","transporte não regular","voo internacional",0,0,0,0,0,0,0,0,0,0
"10189",2016-11-01,"sbtt","transporte regular","voo doméstico",31,31,62,2240,2666,4906,0,0,0,0
"10190",2016-11-01,"sbtt","transporte regular","voo internacional",0,0,0,0,0,0,0,0,0,0
"10191",2016-11-01,"sbtt","transporte não regular","voo doméstico",60,60,120,249,255,504,1806,2481,4287,507
"10192",2016-11-01,"sbtt","transporte não regular","voo internacional",1,1,2,0,5,5,0,0,0,0
"10193",2016-11-01,"sbuf","transporte regular","voo doméstico",8,8,16,391,358,749,0,0,0,0
"10194",2016-11-01,"sbuf","transporte regular","voo internacional",0,0,0,0,0,0,0,0,0,0
"10195",2016-11-01,"sbuf","transporte não regular","voo doméstico",35,35,70,127,105,232,0,0,0,0
"10196",2016-11-01,"sbuf","transporte não regular","voo internacional",0,0,0,0,0,0,0,0,0,0
"10197",2016-11-01,"sbug","transporte regular","voo doméstico",21,21,42,1221,1172,2393,0,0,0,0
"10198",2016-11-01,"sbug","transporte regular","voo internacional",0,0,0,0,0,0,0,0,0,0
"10199",2016-11-01,"sbug","transporte não regular","voo doméstico",4,4,8,8,12,20,0,0,0,0
"10200",2016-11-01,"sbug","transporte não regular","voo internacional",0,0,0,0,0,0,0,0,0,0
"10201",2016-11-01,"sbul","transporte regular","voo doméstico",472,472,944,43212,43093,86305,0,0,0,0
"10202",2016-11-01,"sbul","transporte regular","voo internacional",0,0,0,0,0,0,0,0,0,0
"10203",2016-11-01,"sbul","transporte não regular","voo doméstico",483,474,957,1143,1041,2184,0,0,0,0
"10204",2016-11-01,"sbul","transporte não regular","voo internacional",0,0,0,0,0,0,0,0,0,0
"10205",2016-11-01,"sbur","transporte regular","voo doméstico",75,77,152,3719,3747,7466,0,0,0,0
"10206",2016-11-01,"sbur","transporte regular","voo internacional",0,0,0,0,0,0,0,0,0,0
"10207",2016-11-01,"sbur","transporte não regular","voo doméstico",128,127,255,464,453,917,0,0,0,0
"10208",2016-11-01,"sbur","transporte não regular","voo internacional",0,0,0,0,0,0,0,0,0,0
"10209",2016-10-01,"sbbe","transporte regular","voo doméstico",1296,1290,2586,130982,125804,256786,88644,277434,366078,0
"10210",2016-10-01,"sbbe","transporte regular","voo internacional",58,60,118,7050,7198,14248,0,11,11,0
"10211",2016-10-01,"sbbe","transporte não regular","voo doméstico",430,428,858,2674,2783,5457,0,0,0,0
"10212",2016-10-01,"sbbe","transporte não regular","voo internacional",10,13,23,28,55,83,0,0,0,0
"10213",2016-10-01,"sbbg","transporte regular","voo doméstico",0,0,0,0,0,0,0,0,0,0
"10214",2016-10-01,"sbbg","transporte regular","voo internacional",0,0,0,0,0,0,0,0,0,0
"10215",2016-10-01,"sbbg","transporte não regular","voo doméstico",19,17,36,65,77,142,0,0,0,0
"10216",2016-10-01,"sbbg","transporte não regular","voo internacional",0,1,1,3,0,3,0,0,0,0
"10217",2016-10-01,"sbbh","transporte regular","voo doméstico",57,57,114,1786,1901,3687,0,0,0,0
"10218",2016-10-01,"sbbh","transporte regular","voo internacional",0,0,0,0,0,0,0,0,0,0
"10219",2016-10-01,"sbbh","transporte não regular","voo doméstico",1549,1559,3108,7888,7691,15579,0,0,0,0
"10220",2016-10-01,"sbbh","transporte não regular","voo internacional",0,0,0,0,0,0,0,0,0,0
"10221",2016-10-01,"sbbi","transporte regular","voo doméstico",0,0,0,0,0,0,0,0,0,0
"10222",2016-10-01,"sbbi","transporte regular","voo internacional",0,0,0,0,0,0,0,0,0,0
"10223",2016-10-01,"sbbi","transporte não regular","voo doméstico",713,714,1427,4450,4436,8886,0,0,0,0
"10224",2016-10-01,"sbbi","transporte não regular","voo internacional",0,0,0,0,0,0,0,0,0,0
"10225",2016-10-01,"sbbv","transporte regular","voo doméstico",103,103,206,12824,11882,24706,0,0,0,0
"10226",2016-10-01,"sbbv","transporte regular","voo internacional",0,1,1,0,0,0,0,0,0,0
"10227",2016-10-01,"sbbv","transporte não regular","voo doméstico",113,116,229,120,51,171,0,0,0,0
"10228",2016-10-01,"sbbv","transporte não regular","voo internacional",23,20,43,0,0,0,0,0,0,0
"10229",2016-10-01,"sbcg","transporte regular","voo doméstico",580,576,1156,63507,63941,127448,67086,135785,202871,0
"10230",2016-10-01,"sbcg","transporte regular","voo internacional",0,0,0,0,0,0,0,0,0,0
"10231",2016-10-01,"sbcg","transporte não regular","voo doméstico",210,217,427,945,212,1157,0,0,0,0
"10232",2016-10-01,"sbcg","transporte não regular","voo internacional",8,7,15,5,0,5,0,0,0,0
"10233",2016-10-01,"sbcj","transporte regular","voo doméstico",77,77,154,5936,5760,11696,0,0,0,0
"10234",2016-10-01,"sbcj","transporte regular","voo internacional",0,0,0,0,0,0,0,0,0,0
"10235",2016-10-01,"sbcj","transporte não regular","voo doméstico",132,131,263,72,4,76,0,0,0,0
"10236",2016-10-01,"sbcj","transporte não regular","voo internacional",0,0,0,0,0,0,0,0,0,0
"10237",2016-10-01,"sbcr","transporte regular","voo doméstico",18,18,36,1532,1554,3086,0,0,0,0
"10238",2016-10-01,"sbcr","transporte regular","voo internacional",0,0,0,0,0,0,0,0,0,0
"10239",2016-10-01,"sbcr","transporte não regular","voo doméstico",46,45,91,102,153,255,0,0,0,0
"10240",2016-10-01,"sbcr","transporte não regular","voo internacional",3,4,7,5,4,9,0,0,0,0
"10241",2016-10-01,"sbct","transporte regular","voo doméstico",2530,2512,5042,261287,260304,521591,164502,230919,395421,144706
"10242",2016-10-01,"sbct","transporte regular","voo internacional",49,46,95,1880,1850,3730,0,14897,14897,0
"10243",2016-10-01,"sbct","transporte não regular","voo doméstico",255,267,522,6420,5195,11615,0,0,0,0
"10244",2016-10-01,"sbct","transporte não regular","voo internacional",11,13,24,11,19,30,0,0,0,0
"10245",2016-10-01,"sbcz","transporte regular","voo doméstico",32,31,63,2556,2317,4873,0,0,0,0
"10246",2016-10-01,"sbcz","transporte regular","voo internacional",0,0,0,0,0,0,0,0,0,0
"10247",2016-10-01,"sbcz","transporte não regular","voo doméstico",192,188,380,626,743,1369,0,0,0,0
"10248",2016-10-01,"sbcz","transporte não regular","voo internacional",0,1,1,0,0,0,0,0,0,0
"10249",2016-10-01,"sbeg","transporte regular","voo doméstico",874,862,1736,95057,91676,186733,0,0,0,0
"10250",2016-10-01,"sbeg","transporte regular","voo internacional",103,106,209,4602,4083,8685,0,0,0,0
"10251",2016-10-01,"sbeg","transporte não regular","voo doméstico",629,635,1264,4731,4863,9594,0,0,0,0
"10252",2016-10-01,"sbeg","transporte não regular","voo internacional",86,89,175,421,676,1097,0,0,0,0
"10253",2016-10-01,"sbfi","transporte regular","voo doméstico",584,574,1158,73745,73069,146814,0,0,0,0
"10254",2016-10-01,"sbfi","transporte regular","voo internacional",24,24,48,3350,3101,6451,0,0,0,0
"10255",2016-10-01,"sbfi","transporte não regular","voo doméstico",119,131,250,2185,1336,3521,0,0,0,0
"10256",2016-10-01,"sbfi","transporte não regular","voo internacional",51,44,95,53,141,194,0,0,0,0
"10257",2016-10-01,"sbgo","transporte regular","voo doméstico",1160,1161,2321,119459,115969,235428,110425,186806,297231,192614
"10258",2016-10-01,"sbgo","transporte regular","voo internacional",0,0,0,0,0,0,0,0,0,0
"10259",2016-10-01,"sbgo","transporte não regular","voo doméstico",1197,1201,2398,4620,3862,8482,0,17692,17692,11788
"10260",2016-10-01,"sbgo","transporte não regular","voo internacional",5,3,8,0,0,0,0,0,0,0
"10261",2016-10-01,"sbht","transporte regular","voo doméstico",179,179,358,5859,5545,11404,0,0,0,0
"10262",2016-10-01,"sbht","transporte regular","voo internacional",0,0,0,0,0,0,0,0,0,0
"10263",2016-10-01,"sbht","transporte não regular","voo doméstico",62,64,126,140,106,246,0,0,0,0
"10264",2016-10-01,"sbht","transporte não regular","voo internacional",0,0,0,0,0,0,0,0,0,0
"10265",2016-10-01,"sbiz","transporte regular","voo doméstico",128,128,256,9735,9318,19053,0,0,0,0
"10266",2016-10-01,"sbiz","transporte regular","voo internacional",0,0,0,0,0,0,0,0,0,0
"10267",2016-10-01,"sbiz","transporte não regular","voo doméstico",114,117,231,275,290,565,0,0,0,0
"10268",2016-10-01,"sbiz","transporte não regular","voo internacional",0,0,0,0,0,0,0,0,0,0
"10269",2016-10-01,"sbjc","transporte regular","voo doméstico",1,1,2,0,0,0,0,0,0,0
"10270",2016-10-01,"sbjc","transporte regular","voo internacional",0,0,0,0,0,0,0,0,0,0
"10271",2016-10-01,"sbjc","transporte não regular","voo doméstico",327,325,652,649,346,995,0,0,0,0
"10272",2016-10-01,"sbjc","transporte não regular","voo internacional",0,1,1,0,0,0,0,0,0,0
"10273",2016-10-01,"sbjr","transporte regular","voo doméstico",0,0,0,0,0,0,0,0,0,0
"10274",2016-10-01,"sbjr","transporte regular","voo internacional",0,0,0,0,0,0,0,0,0,0
"10275",2016-10-01,"sbjr","transporte não regular","voo doméstico",2318,2329,4647,8715,7291,16006,0,0,0,0
"10276",2016-10-01,"sbjr","transporte não regular","voo internacional",0,0,0,0,0,0,0,0,0,0
"10277",2016-10-01,"sbjv","transporte regular","voo doméstico",231,230,461,22577,22751,45328,0,0,0,0
"10278",2016-10-01,"sbjv","transporte regular","voo internacional",0,0,0,0,0,0,0,0,0,0
"10279",2016-10-01,"sbjv","transporte não regular","voo doméstico",118,120,238,178,304,482,0,0,0,0
"10280",2016-10-01,"sbjv","transporte não regular","voo internacional",0,0,0,0,0,0,0,0,0,0
"10281",2016-10-01,"sblo","transporte regular","voo doméstico",399,401,800,37182,35460,72642,0,0,0,0
"10282",2016-10-01,"sblo","transporte regular","voo internacional",0,0,0,0,0,0,0,0,0,0
"10283",2016-10-01,"sblo","transporte não regular","voo doméstico",571,565,1136,4865,5145,10010,0,0,0,0
"10284",2016-10-01,"sblo","transporte não regular","voo internacional",2,2,4,0,0,0,0,0,0,0
"10285",2016-10-01,"sbma","transporte regular","voo doméstico",145,144,289,12095,11066,23161,0,0,0,0
"10286",2016-10-01,"sbma","transporte regular","voo internacional",0,0,0,0,0,0,0,0,0,0
"10287",2016-10-01,"sbma","transporte não regular","voo doméstico",192,195,387,468,455,923,0,0,0,0
"10288",2016-10-01,"sbma","transporte não regular","voo internacional",0,0,0,0,0,0,0,0,0,0
"10289",2016-10-01,"sbmk","transporte regular","voo doméstico",151,130,281,8995,9974,18969,0,0,0,0
"10290",2016-10-01,"sbmk","transporte regular","voo internacional",0,0,0,0,0,0,0,0,0,0
"10291",2016-10-01,"sbmk","transporte não regular","voo doméstico",206,230,436,2621,1078,3699,0,0,0,0
"10292",2016-10-01,"sbmk","transporte não regular","voo internacional",0,0,0,0,0,0,0,0,0,0
"10293",2016-10-01,"sbmq","transporte regular","voo doméstico",243,239,482,23900,23383,47283,13810,30680,44490,0
"10294",2016-10-01,"sbmq","transporte regular","voo internacional",0,0,0,0,0,0,0,0,0,0
"10295",2016-10-01,"sbmq","transporte não regular","voo doméstico",205,205,410,573,279,852,0,0,0,0
"10296",2016-10-01,"sbmq","transporte não regular","voo internacional",2,2,4,0,0,0,0,0,0,0
"10297",2016-10-01,"sbmt","transporte regular","voo doméstico",0,0,0,0,0,0,0,0,0,0
"10298",2016-10-01,"sbmt","transporte regular","voo internacional",0,0,0,0,0,0,0,0,0,0
"10299",2016-10-01,"sbmt","transporte não regular","voo doméstico",2764,2762,5526,4833,4821,9654,0,0,0,0
"10300",2016-10-01,"sbmt","transporte não regular","voo internacional",0,0,0,0,0,0,0,0,0,0
"10301",2016-10-01,"sbnf","transporte regular","voo doméstico",541,539,1080,58821,61042,119863,0,0,0,0
"10302",2016-10-01,"sbnf","transporte regular","voo internacional",0,0,0,0,0,0,0,0,0,0
"10303",2016-10-01,"sbnf","transporte não regular","voo doméstico",246,248,494,3023,2625,5648,0,0,0,0
"10304",2016-10-01,"sbnf","transporte não regular","voo internacional",0,0,0,0,0,0,0,0,0,0
"10305",2016-10-01,"sbpb","transporte regular","voo doméstico",5,5,10,336,400,736,0,0,0,0
"10306",2016-10-01,"sbpb","transporte regular","voo internacional",0,0,0,0,0,0,0,0,0,0
"10307",2016-10-01,"sbpb","transporte não regular","voo doméstico",57,55,112,146,125,271,0,0,0,0
"10308",2016-10-01,"sbpb","transporte não regular","voo internacional",1,1,2,0,0,0,0,0,0,0
"10309",2016-10-01,"sbpj","transporte regular","voo doméstico",257,256,513,24090,23297,47387,0,0,0,0
"10310",2016-10-01,"sbpj","transporte regular","voo internacional",0,0,0,0,0,0,0,0,0,0
"10311",2016-10-01,"sbpj","transporte não regular","voo doméstico",230,237,467,583,448,1031,0,0,0,0
"10312",2016-10-01,"sbpj","transporte não regular","voo internacional",1,1,2,0,0,0,0,0,0,0
"10313",2016-10-01,"sbpk","transporte regular","voo doméstico",26,26,52,1280,1209,2489,0,0,0,0
"10314",2016-10-01,"sbpk","transporte regular","voo internacional",0,0,0,0,0,0,0,0,0,0
"10315",2016-10-01,"sbpk","transporte não regular","voo doméstico",37,36,73,56,65,121,0,0,0,0
"10316",2016-10-01,"sbpk","transporte não regular","voo internacional",0,1,1,2,0,2,0,0,0,0
"10317",2016-10-01,"sbpl","transporte regular","voo doméstico",170,170,340,18947,16509,35456,0,0,0,0
"10318",2016-10-01,"sbpl","transporte regular","voo internacional",1,1,2,0,0,0,0,0,0,0
"10319",2016-10-01,"sbpl","transporte não regular","voo doméstico",80,81,161,202,136,338,0,0,0,0
"10320",2016-10-01,"sbpl","transporte não regular","voo internacional",4,4,8,0,0,0,0,0,0,0
"10321",2016-10-01,"sbpp","transporte regular","voo doméstico",0,0,0,0,0,0,0,0,0,0
"10322",2016-10-01,"sbpp","transporte regular","voo internacional",0,0,0,0,0,0,0,0,0,0
"10323",2016-10-01,"sbpp","transporte não regular","voo doméstico",88,86,174,139,116,255,0,0,0,0
"10324",2016-10-01,"sbpp","transporte não regular","voo internacional",4,6,10,5,1,6,0,0,0,0
"10325",2016-10-01,"sbpr","transporte regular","voo doméstico",0,0,0,0,0,0,0,0,0,0
"10326",2016-10-01,"sbpr","transporte regular","voo internacional",0,0,0,0,0,0,0,0,0,0
"10327",2016-10-01,"sbpr","transporte não regular","voo doméstico",587,577,1164,643,521,1164,0,0,0,0
"10328",2016-10-01,"sbpr","transporte não regular","voo internacional",0,0,0,0,0,0,0,0,0,0
"10329",2016-10-01,"sbpv","transporte regular","voo doméstico",349,350,699,31551,30617,62168,0,0,0,0
"10330",2016-10-01,"sbpv","transporte regular","voo internacional",0,0,0,0,0,0,0,0,0,0
"10331",2016-10-01,"sbpv","transporte não regular","voo doméstico",200,196,396,0,0,0,0,0,0,0
"10332",2016-10-01,"sbpv","transporte não regular","voo internacional",0,0,0,0,0,0,0,0,0,0
"10333",2016-10-01,"sbrb","transporte regular","voo doméstico",131,129,260,11387,12296,23683,0,0,0,351
"10334",2016-10-01,"sbrb","transporte regular","voo internacional",0,0,0,0,0,0,0,0,0,0
"10335",2016-10-01,"sbrb","transporte não regular","voo doméstico",170,170,340,415,291,706,0,0,0,0
"10336",2016-10-01,"sbrb","transporte não regular","voo internacional",0,0,0,0,0,0,0,0,0,0
"10337",2016-10-01,"sbrj","transporte regular","voo doméstico",3832,3850,7682,385271,385305,770576,0,0,0,0
"10338",2016-10-01,"sbrj","transporte regular","voo internacional",0,0,0,0,0,0,0,0,0,0
"10339",2016-10-01,"sbrj","transporte não regular","voo doméstico",612,594,1206,733,2321,3054,0,0,0,0
"10340",2016-10-01,"sbrj","transporte não regular","voo internacional",2,2,4,0,0,0,0,0,0,0
"10341",2016-10-01,"sbsj","transporte regular","voo doméstico",0,0,0,0,0,0,0,0,0,0
"10342",2016-10-01,"sbsj","transporte regular","voo internacional",0,0,0,0,0,0,0,0,0,0
"10343",2016-10-01,"sbsj","transporte não regular","voo doméstico",413,399,812,1491,1480,2971,0,0,0,0
"10344",2016-10-01,"sbsj","transporte não regular","voo internacional",4,15,19,87,14,101,0,0,0,0
"10345",2016-10-01,"sbsl","transporte regular","voo doméstico",590,586,1176,51904,56661,108565,0,0,0,0
"10346",2016-10-01,"sbsl","transporte regular","voo internacional",0,1,1,1,0,1,0,0,0,0
"10347",2016-10-01,"sbsl","transporte não regular","voo doméstico",219,222,441,920,877,1797,53972,191858,245830,0
"10348",2016-10-01,"sbsl","transporte não regular","voo internacional",0,0,0,0,0,0,0,0,0,0
"10349",2016-10-01,"sbsn","transporte regular","voo doméstico",257,257,514,19989,18731,38720,0,0,0,0
"10350",2016-10-01,"sbsn","transporte regular","voo internacional",0,0,0,0,0,0,0,0,0,0
"10351",2016-10-01,"sbsn","transporte não regular","voo doméstico",171,167,338,585,440,1025,0,0,0,0
"10352",2016-10-01,"sbsn","transporte não regular","voo internacional",0,1,1,0,0,0,0,0,0,0
"10353",2016-10-01,"sbsp","transporte regular","voo doméstico",7307,7350,14657,888489,884628,1773117,0,0,0,0
"10354",2016-10-01,"sbsp","transporte regular","voo internacional",0,0,0,0,0,0,0,0,0,0
"10355",2016-10-01,"sbsp","transporte não regular","voo doméstico",1623,1562,3185,7797,7074,14871,0,0,0,0
"10356",2016-10-01,"sbsp","transporte não regular","voo internacional",0,0,0,0,0,0,0,0,0,0
"10357",2016-10-01,"sbte","transporte regular","voo doméstico",427,427,854,41545,37581,79126,20915,64159,85074,229893
"10358",2016-10-01,"sbte","transporte regular","voo internacional",0,0,0,0,0,0,0,0,0,0
"10359",2016-10-01,"sbte","transporte não regular","voo doméstico",216,215,431,1177,1191,2368,0,0,0,0
"10360",2016-10-01,"sbte","transporte não regular","voo internacional",0,0,0,0,0,0,0,0,0,0
"10361",2016-10-01,"sbtf","transporte regular","voo doméstico",40,40,80,1841,1608,3449,0,0,0,0
"10362",2016-10-01,"sbtf","transporte regular","voo internacional",0,0,0,0,0,0,0,0,0,0
"10363",2016-10-01,"sbtf","transporte não regular","voo doméstico",139,139,278,199,384,583,2660,2139,4799,10728
"10364",2016-10-01,"sbtf","transporte não regular","voo internacional",0,0,0,0,0,0,0,0,0,0
"10365",2016-10-01,"sbtt","transporte regular","voo doméstico",32,32,64,2488,2449,4937,0,0,0,0
"10366",2016-10-01,"sbtt","transporte regular","voo internacional",0,0,0,0,0,0,0,0,0,0
"10367",2016-10-01,"sbtt","transporte não regular","voo doméstico",89,90,179,390,413,803,1238,2435,3673,544
"10368",2016-10-01,"sbtt","transporte não regular","voo internacional",3,3,6,4,6,10,0,0,0,0
"10369",2016-10-01,"sbuf","transporte regular","voo doméstico",9,9,18,456,418,874,0,0,0,0
"10370",2016-10-01,"sbuf","transporte regular","voo internacional",0,0,0,0,0,0,0,0,0,0
"10371",2016-10-01,"sbuf","transporte não regular","voo doméstico",34,34,68,92,63,155,0,0,0,0
"10372",2016-10-01,"sbuf","transporte não regular","voo internacional",0,0,0,0,0,0,0,0,0,0
"10373",2016-10-01,"sbug","transporte regular","voo doméstico",26,26,52,1364,1368,2732,0,0,0,0
"10374",2016-10-01,"sbug","transporte regular","voo internacional",0,0,0,0,0,0,0,0,0,0
"10375",2016-10-01,"sbug","transporte não regular","voo doméstico",10,10,20,18,24,42,0,0,0,0
"10376",2016-10-01,"sbug","transporte não regular","voo internacional",0,0,0,0,0,0,0,0,0,0
"10377",2016-10-01,"sbul","transporte regular","voo doméstico",472,473,945,45691,44175,89866,0,0,0,0
"10378",2016-10-01,"sbul","transporte regular","voo internacional",0,0,0,0,0,0,0,0,0,0
"10379",2016-10-01,"sbul","transporte não regular","voo doméstico",564,568,1132,1323,1232,2555,0,0,0,0
"10380",2016-10-01,"sbul","transporte não regular","voo internacional",1,1,2,15,12,27,0,0,0,0
"10381",2016-10-01,"sbur","transporte regular","voo doméstico",71,73,144,3440,3495,6935,0,0,0,0
"10382",2016-10-01,"sbur","transporte regular","voo internacional",0,0,0,0,0,0,0,0,0,0
"10383",2016-10-01,"sbur","transporte não regular","voo doméstico",147,146,293,545,462,1007,0,0,0,0
"10384",2016-10-01,"sbur","transporte não regular","voo internacional",0,0,0,0,0,0,0,0,0,0
"10385",2016-09-01,"sbbe","transporte regular","voo doméstico",1160,1146,2306,118964,123979,242943,92496,294744,387240,0
"10386",2016-09-01,"sbbe","transporte regular","voo internacional",54,58,112,7280,6159,13439,0,1,1,0
"10387",2016-09-01,"sbbe","transporte não regular","voo doméstico",477,482,959,3598,2813,6411,0,0,0,0
"10388",2016-09-01,"sbbe","transporte não regular","voo internacional",14,16,30,635,462,1097,0,0,0,0
"10389",2016-09-01,"sbbg","transporte regular","voo doméstico",0,0,0,0,0,0,0,0,0,0
"10390",2016-09-01,"sbbg","transporte regular","voo internacional",0,0,0,0,0,0,0,0,0,0
"10391",2016-09-01,"sbbg","transporte não regular","voo doméstico",13,12,25,58,72,130,0,0,0,0
"10392",2016-09-01,"sbbg","transporte não regular","voo internacional",3,4,7,8,8,16,0,0,0,0
"10393",2016-09-01,"sbbh","transporte regular","voo doméstico",52,52,104,1729,1886,3615,0,0,0,0
"10394",2016-09-01,"sbbh","transporte regular","voo internacional",0,0,0,0,0,0,0,0,0,0
"10395",2016-09-01,"sbbh","transporte não regular","voo doméstico",1790,1776,3566,8371,8438,16809,0,0,0,0
"10396",2016-09-01,"sbbh","transporte não regular","voo internacional",4,4,8,24,24,48,0,0,0,0
"10397",2016-09-01,"sbbi","transporte regular","voo doméstico",0,0,0,0,0,0,0,0,0,0
"10398",2016-09-01,"sbbi","transporte regular","voo internacional",0,0,0,0,0,0,0,0,0,0
"10399",2016-09-01,"sbbi","transporte não regular","voo doméstico",918,909,1827,4199,4187,8386,0,0,0,0
"10400",2016-09-01,"sbbi","transporte não regular","voo internacional",0,2,2,0,0,0,0,0,0,0
"10401",2016-09-01,"sbbv","transporte regular","voo doméstico",103,103,206,12087,11934,24021,0,2376,2376,0
"10402",2016-09-01,"sbbv","transporte regular","voo internacional",2,2,4,31,24,55,0,0,0,0
"10403",2016-09-01,"sbbv","transporte não regular","voo doméstico",153,149,302,65,76,141,0,0,0,0
"10404",2016-09-01,"sbbv","transporte não regular","voo internacional",6,6,12,0,0,0,0,0,0,0
"10405",2016-09-01,"sbcg","transporte regular","voo doméstico",569,568,1137,61601,59795,121396,72268,153519,225787,0
"10406",2016-09-01,"sbcg","transporte regular","voo internacional",0,0,0,0,0,0,0,0,0,0
"10407",2016-09-01,"sbcg","transporte não regular","voo doméstico",254,259,513,403,592,995,0,0,0,0
"10408",2016-09-01,"sbcg","transporte não regular","voo internacional",7,7,14,0,0,0,0,0,0,0
"10409",2016-09-01,"sbcj","transporte regular","voo doméstico",77,77,154,6321,6239,12560,0,0,0,0
"10410",2016-09-01,"sbcj","transporte regular","voo internacional",0,0,0,0,0,0,0,0,0,0
"10411",2016-09-01,"sbcj","transporte não regular","voo doméstico",83,83,166,173,0,173,0,0,0,0
"10412",2016-09-01,"sbcj","transporte não regular","voo internacional",0,0,0,0,0,0,0,0,0,0
"10413",2016-09-01,"sbcr","transporte regular","voo doméstico",16,16,32,1394,1392,2786,0,0,0,0
"10414",2016-09-01,"sbcr","transporte regular","voo internacional",0,0,0,0,0,0,0,0,0,0
"10415",2016-09-01,"sbcr","transporte não regular","voo doméstico",45,44,89,101,111,212,0,0,0,0
"10416",2016-09-01,"sbcr","transporte não regular","voo internacional",4,3,7,12,14,26,0,0,0,0
"10417",2016-09-01,"sbct","transporte regular","voo doméstico",2500,2502,5002,261351,259002,520353,160611,29233,189844,350912
"10418",2016-09-01,"sbct","transporte regular","voo internacional",51,49,100,1490,1553,3043,0,27502,27502,0
"10419",2016-09-01,"sbct","transporte não regular","voo doméstico",215,220,435,5083,3984,9067,0,23843,23843,1150
"10420",2016-09-01,"sbct","transporte não regular","voo internacional",20,21,41,418,363,781,0,7363,7363,0
"10421",2016-09-01,"sbcz","transporte regular","voo doméstico",29,29,58,2034,2180,4214,0,0,0,0
"10422",2016-09-01,"sbcz","transporte regular","voo internacional",0,0,0,0,0,0,0,0,0,0
"10423",2016-09-01,"sbcz","transporte não regular","voo doméstico",279,279,558,1166,895,2061,0,0,0,0
"10424",2016-09-01,"sbcz","transporte não regular","voo internacional",0,1,1,0,0,0,0,0,0,0
"10425",2016-09-01,"sbeg","transporte regular","voo doméstico",870,864,1734,96133,93091,189224,0,0,0,0
"10426",2016-09-01,"sbeg","transporte regular","voo internacional",113,117,230,4959,4522,9481,0,0,0,0
"10427",2016-09-01,"sbeg","transporte não regular","voo doméstico",581,571,1152,4447,3017,7464,0,0,0,0
"10428",2016-09-01,"sbeg","transporte não regular","voo internacional",82,88,170,89,106,195,0,0,0,0
"10429",2016-09-01,"sbfi","transporte regular","voo doméstico",573,569,1142,71924,67960,139884,0,0,0,0
"10430",2016-09-01,"sbfi","transporte regular","voo internacional",22,22,44,3019,2743,5762,0,0,0,0
"10431",2016-09-01,"sbfi","transporte não regular","voo doméstico",104,107,211,273,364,637,0,0,0,0
"10432",2016-09-01,"sbfi","transporte não regular","voo internacional",43,45,88,444,276,720,0,0,0,0
"10433",2016-09-01,"sbgo","transporte regular","voo doméstico",1150,1151,2301,119153,116274,235427,116406,196023,312429,197932
"10434",2016-09-01,"sbgo","transporte regular","voo internacional",0,0,0,0,0,0,0,0,0,0
"10435",2016-09-01,"sbgo","transporte não regular","voo doméstico",1478,1469,2947,4681,3960,8641,0,0,0,0
"10436",2016-09-01,"sbgo","transporte não regular","voo internacional",4,5,9,0,0,0,0,0,0,0
"10437",2016-09-01,"sbht","transporte regular","voo doméstico",177,177,354,5885,5738,11623,0,0,0,0
"10438",2016-09-01,"sbht","transporte regular","voo internacional",0,0,0,0,0,0,0,0,0,0
"10439",2016-09-01,"sbht","transporte não regular","voo doméstico",118,118,236,94,125,219,120,100,220,80
"10440",2016-09-01,"sbht","transporte não regular","voo internacional",0,0,0,0,0,0,0,0,0,0
"10441",2016-09-01,"sbiz","transporte regular","voo doméstico",128,128,256,9817,9751,19568,0,0,0,0
"10442",2016-09-01,"sbiz","transporte regular","voo internacional",0,0,0,0,0,0,0,0,0,0
"10443",2016-09-01,"sbiz","transporte não regular","voo doméstico",165,164,329,425,407,832,0,0,0,0
"10444",2016-09-01,"sbiz","transporte não regular","voo internacional",1,1,2,0,0,0,0,0,0,0
"10445",2016-09-01,"sbjc","transporte regular","voo doméstico",0,0,0,0,0,0,0,0,0,0
"10446",2016-09-01,"sbjc","transporte regular","voo internacional",0,0,0,0,0,0,0,0,0,0
"10447",2016-09-01,"sbjc","transporte não regular","voo doméstico",437,431,868,837,555,1392,0,0,0,0
"10448",2016-09-01,"sbjc","transporte não regular","voo internacional",2,1,3,0,0,0,0,0,0,0
"10449",2016-09-01,"sbjr","transporte regular","voo doméstico",0,0,0,0,0,0,0,0,0,0
"10450",2016-09-01,"sbjr","transporte regular","voo internacional",0,0,0,0,0,0,0,0,0,0
"10451",2016-09-01,"sbjr","transporte não regular","voo doméstico",1380,1366,2746,4544,3301,7845,0,0,0,0
"10452",2016-09-01,"sbjr","transporte não regular","voo internacional",0,0,0,0,0,0,0,0,0,0
"10453",2016-09-01,"sbjv","transporte regular","voo doméstico",225,226,451,22229,21824,44053,0,0,0,0
"10454",2016-09-01,"sbjv","transporte regular","voo internacional",0,0,0,0,0,0,0,0,0,0
"10455",2016-09-01,"sbjv","transporte não regular","voo doméstico",169,167,336,275,224,499,0,0,0,0
"10456",2016-09-01,"sbjv","transporte não regular","voo internacional",1,1,2,0,0,0,0,0,0,0
"10457",2016-09-01,"sblo","transporte regular","voo doméstico",406,405,811,35417,34802,70219,0,0,0,0
"10458",2016-09-01,"sblo","transporte regular","voo internacional",0,0,0,0,0,0,0,0,0,0
"10459",2016-09-01,"sblo","transporte não regular","voo doméstico",710,714,1424,4296,4501,8797,0,0,0,0
"10460",2016-09-01,"sblo","transporte não regular","voo internacional",3,3,6,0,0,0,0,0,0,0
"10461",2016-09-01,"sbma","transporte regular","voo doméstico",148,148,296,11802,11354,23156,0,0,0,0
"10462",2016-09-01,"sbma","transporte regular","voo internacional",0,0,0,0,0,0,0,0,0,0
"10463",2016-09-01,"sbma","transporte não regular","voo doméstico",214,208,422,411,481,892,0,0,0,0
"10464",2016-09-01,"sbma","transporte não regular","voo internacional",2,2,4,0,0,0,0,0,0,0
"10465",2016-09-01,"sbmk","transporte regular","voo doméstico",171,171,342,12099,11943,24042,0,0,0,0
"10466",2016-09-01,"sbmk","transporte regular","voo internacional",0,0,0,0,0,0,0,0,0,0
"10467",2016-09-01,"sbmk","transporte não regular","voo doméstico",239,234,473,9,7,16,0,0,0,0
"10468",2016-09-01,"sbmk","transporte não regular","voo internacional",1,1,2,0,0,0,0,0,0,0
"10469",2016-09-01,"sbmq","transporte regular","voo doméstico",225,225,450,22200,21824,44024,11800,30500,42300,0
"10470",2016-09-01,"sbmq","transporte regular","voo internacional",0,0,0,0,0,0,0,0,0,0
"10471",2016-09-01,"sbmq","transporte não regular","voo doméstico",203,202,405,207,125,332,0,0,0,0
"10472",2016-09-01,"sbmq","transporte não regular","voo internacional",8,9,17,0,0,0,0,0,0,0
"10473",2016-09-01,"sbmt","transporte regular","voo doméstico",0,0,0,0,0,0,0,0,0,0
"10474",2016-09-01,"sbmt","transporte regular","voo internacional",0,0,0,0,0,0,0,0,0,0
"10475",2016-09-01,"sbmt","transporte não regular","voo doméstico",2501,2508,5009,4535,4426,8961,0,0,0,0
"10476",2016-09-01,"sbmt","transporte não regular","voo internacional",0,0,0,0,0,0,0,0,0,0
"10477",2016-09-01,"sbnf","transporte regular","voo doméstico",537,538,1075,57454,59838,117292,0,0,0,0
"10478",2016-09-01,"sbnf","transporte regular","voo internacional",0,0,0,0,0,0,0,0,0,0
"10479",2016-09-01,"sbnf","transporte não regular","voo doméstico",217,212,429,366,646,1012,0,0,0,0
"10480",2016-09-01,"sbnf","transporte não regular","voo internacional",1,1,2,0,8,8,0,0,0,0
"10481",2016-09-01,"sbpb","transporte regular","voo doméstico",4,4,8,275,305,580,0,0,0,0
"10482",2016-09-01,"sbpb","transporte regular","voo internacional",0,0,0,0,0,0,0,0,0,0
"10483",2016-09-01,"sbpb","transporte não regular","voo doméstico",54,52,106,109,127,236,0,0,0,0
"10484",2016-09-01,"sbpb","transporte não regular","voo internacional",0,0,0,0,0,0,0,0,0,0
"10485",2016-09-01,"sbpj","transporte regular","voo doméstico",248,249,497,24301,23444,47745,0,0,0,0
"10486",2016-09-01,"sbpj","transporte regular","voo internacional",0,0,0,0,0,0,0,0,0,0
"10487",2016-09-01,"sbpj","transporte não regular","voo doméstico",261,257,518,500,480,980,0,0,0,0
"10488",2016-09-01,"sbpj","transporte não regular","voo internacional",0,1,1,0,0,0,0,0,0,0
"10489",2016-09-01,"sbpk","transporte regular","voo doméstico",25,25,50,1399,1120,2519,0,0,0,0
"10490",2016-09-01,"sbpk","transporte regular","voo internacional",0,0,0,0,0,0,0,0,0,0
"10491",2016-09-01,"sbpk","transporte não regular","voo doméstico",29,31,60,67,71,138,0,0,0,0
"10492",2016-09-01,"sbpk","transporte não regular","voo internacional",2,0,2,0,2,2,0,0,0,0
"10493",2016-09-01,"sbpl","transporte regular","voo doméstico",164,164,328,17623,15536,33159,0,0,0,0
"10494",2016-09-01,"sbpl","transporte regular","voo internacional",3,3,6,0,0,0,0,0,0,0
"10495",2016-09-01,"sbpl","transporte não regular","voo doméstico",92,93,185,121,105,226,0,0,0,0
"10496",2016-09-01,"sbpl","transporte não regular","voo internacional",0,0,0,0,0,0,0,0,0,0
"10497",2016-09-01,"sbpp","transporte regular","voo doméstico",0,0,0,0,0,0,0,0,0,0
"10498",2016-09-01,"sbpp","transporte regular","voo internacional",0,0,0,0,0,0,0,0,0,0
"10499",2016-09-01,"sbpp","transporte não regular","voo doméstico",130,129,259,176,174,350,0,0,0,0
"10500",2016-09-01,"sbpp","transporte não regular","voo internacional",15,17,32,14,14,28,0,0,0,0
"10501",2016-09-01,"sbpr","transporte regular","voo doméstico",0,0,0,0,0,0,0,0,0,0
"10502",2016-09-01,"sbpr","transporte regular","voo internacional",0,0,0,0,0,0,0,0,0,0
"10503",2016-09-01,"sbpr","transporte não regular","voo doméstico",964,978,1942,1152,1049,2201,0,0,0,0
"10504",2016-09-01,"sbpr","transporte não regular","voo internacional",0,0,0,0,0,0,0,0,0,0
"10505",2016-09-01,"sbpv","transporte regular","voo doméstico",351,352,703,32160,31947,64107,0,0,0,0
"10506",2016-09-01,"sbpv","transporte regular","voo internacional",0,0,0,0,0,0,0,0,0,0
"10507",2016-09-01,"sbpv","transporte não regular","voo doméstico",253,255,508,0,0,0,0,0,0,0
"10508",2016-09-01,"sbpv","transporte não regular","voo internacional",0,0,0,0,0,0,0,0,0,0
"10509",2016-09-01,"sbrb","transporte regular","voo doméstico",118,118,236,10528,12749,23277,0,0,0,480
"10510",2016-09-01,"sbrb","transporte regular","voo internacional",0,0,0,0,0,0,0,0,0,0
"10511",2016-09-01,"sbrb","transporte não regular","voo doméstico",137,135,272,241,198,439,0,0,0,0
"10512",2016-09-01,"sbrb","transporte não regular","voo internacional",3,2,5,0,0,0,0,0,0,0
"10513",2016-09-01,"sbrj","transporte regular","voo doméstico",3767,3775,7542,369881,372808,742689,0,0,0,0
"10514",2016-09-01,"sbrj","transporte regular","voo internacional",0,0,0,0,0,0,0,0,0,0
"10515",2016-09-01,"sbrj","transporte não regular","voo doméstico",414,402,816,1505,2207,3712,0,0,0,0
"10516",2016-09-01,"sbrj","transporte não regular","voo internacional",8,8,16,0,0,0,0,0,0,0
"10517",2016-09-01,"sbsj","transporte regular","voo doméstico",0,0,0,0,0,0,0,0,0,0
"10518",2016-09-01,"sbsj","transporte regular","voo internacional",0,0,0,0,0,0,0,0,0,0
"10519",2016-09-01,"sbsj","transporte não regular","voo doméstico",419,401,820,1682,1716,3398,0,0,0,0
"10520",2016-09-01,"sbsj","transporte não regular","voo internacional",5,22,27,88,14,102,0,0,0,0
"10521",2016-09-01,"sbsl","transporte regular","voo doméstico",525,525,1050,50994,58319,109313,0,0,0,0
"10522",2016-09-01,"sbsl","transporte regular","voo internacional",0,0,0,0,0,0,0,0,0,0
"10523",2016-09-01,"sbsl","transporte não regular","voo doméstico",259,263,522,512,397,909,49935,188044,237979,0
"10524",2016-09-01,"sbsl","transporte não regular","voo internacional",2,2,4,0,0,0,0,0,0,0
"10525",2016-09-01,"sbsn","transporte regular","voo doméstico",228,228,456,19200,18455,37655,481,0,481,0
"10526",2016-09-01,"sbsn","transporte regular","voo internacional",0,0,0,0,0,0,0,0,0,0
"10527",2016-09-01,"sbsn","transporte não regular","voo doméstico",262,266,528,546,424,970,0,0,0,0
"10528",2016-09-01,"sbsn","transporte não regular","voo internacional",0,0,0,0,0,0,0,0,0,0
"10529",2016-09-01,"sbsp","transporte regular","voo doméstico",7169,7197,14366,874029,863528,1737557,0,0,0,0
"10530",2016-09-01,"sbsp","transporte regular","voo internacional",0,0,0,0,0,0,0,0,0,0
"10531",2016-09-01,"sbsp","transporte não regular","voo doméstico",1601,1654,3255,7116,5805,12921,0,0,0,0
"10532",2016-09-01,"sbsp","transporte não regular","voo internacional",0,0,0,0,0,0,0,0,0,0
"10533",2016-09-01,"sbte","transporte regular","voo doméstico",411,409,820,36397,40472,76869,19215,77599,96814,215769
"10534",2016-09-01,"sbte","transporte regular","voo internacional",0,0,0,0,0,0,0,0,0,0
"10535",2016-09-01,"sbte","transporte não regular","voo doméstico",257,254,511,1384,1426,2810,0,0,0,0
"10536",2016-09-01,"sbte","transporte não regular","voo internacional",2,2,4,0,0,0,0,0,0,0
"10537",2016-09-01,"sbtf","transporte regular","voo doméstico",40,40,80,1562,2018,3580,0,0,0,0
"10538",2016-09-01,"sbtf","transporte regular","voo internacional",0,0,0,0,0,0,0,0,0,0
"10539",2016-09-01,"sbtf","transporte não regular","voo doméstico",192,192,384,571,259,830,1587,1518,3105,12116
"10540",2016-09-01,"sbtf","transporte não regular","voo internacional",0,0,0,0,0,0,0,0,0,0
"10541",2016-09-01,"sbtt","transporte regular","voo doméstico",34,34,68,2302,3254,5556,0,0,0,0
"10542",2016-09-01,"sbtt","transporte regular","voo internacional",0,0,0,0,0,0,0,0,0,0
"10543",2016-09-01,"sbtt","transporte não regular","voo doméstico",113,110,223,487,500,987,1051,2457,3508,566
"10544",2016-09-01,"sbtt","transporte não regular","voo internacional",3,6,9,6,8,14,0,0,0,0
"10545",2016-09-01,"sbuf","transporte regular","voo doméstico",9,9,18,398,441,839,0,0,0,0
"10546",2016-09-01,"sbuf","transporte regular","voo internacional",0,0,0,0,0,0,0,0,0,0
"10547",2016-09-01,"sbuf","transporte não regular","voo doméstico",28,28,56,112,96,208,0,0,0,0
"10548",2016-09-01,"sbuf","transporte não regular","voo internacional",0,0,0,0,0,0,0,0,0,0
"10549",2016-09-01,"sbug","transporte regular","voo doméstico",23,23,46,1166,1115,2281,0,0,0,0
"10550",2016-09-01,"sbug","transporte regular","voo internacional",0,0,0,0,0,0,0,0,0,0
"10551",2016-09-01,"sbug","transporte não regular","voo doméstico",15,15,30,111,115,226,0,0,0,0
"10552",2016-09-01,"sbug","transporte não regular","voo internacional",1,1,2,0,0,0,0,0,0,0
"10553",2016-09-01,"sbul","transporte regular","voo doméstico",473,471,944,43919,43732,87651,0,0,0,0
"10554",2016-09-01,"sbul","transporte regular","voo internacional",0,0,0,0,0,0,0,0,0,0
"10555",2016-09-01,"sbul","transporte não regular","voo doméstico",545,545,1090,1311,1139,2450,0,0,0,0
"10556",2016-09-01,"sbul","transporte não regular","voo internacional",6,6,12,31,29,60,0,0,0,0
"10557",2016-09-01,"sbur","transporte regular","voo doméstico",74,53,127,2718,3580,6298,0,0,0,0
"10558",2016-09-01,"sbur","transporte regular","voo internacional",0,0,0,0,0,0,0,0,0,0
"10559",2016-09-01,"sbur","transporte não regular","voo doméstico",216,239,455,1575,780,2355,0,0,0,0
"10560",2016-09-01,"sbur","transporte não regular","voo internacional",1,1,2,0,0,0,0,0,0,0
"10561",2017-04-01,"sbbe","transporte regular","voo doméstico",995,1007,2002,115006,113889,228895,77060,236400,313460,0
"10562",2017-04-01,"sbbe","transporte regular","voo internacional",51,49,100,5516,4808,10324,0,0,0,0
"10563",2017-04-01,"sbbe","transporte não regular","voo doméstico",398,385,783,2739,3771,6510,1380,0,1380,0
"10564",2017-04-01,"sbbe","transporte não regular","voo internacional",10,14,24,20,12,32,0,0,0,0
"10565",2017-04-01,"sbbg","transporte regular","voo doméstico",0,0,0,0,0,0,0,0,0,0
"10566",2017-04-01,"sbbg","transporte regular","voo internacional",0,0,0,0,0,0,0,0,0,0
"10567",2017-04-01,"sbbg","transporte não regular","voo doméstico",10,11,21,45,49,94,0,0,0,0
"10568",2017-04-01,"sbbg","transporte não regular","voo internacional",4,3,7,11,11,22,0,0,0,0
"10569",2017-04-01,"sbbh","transporte regular","voo doméstico",46,46,92,1696,1709,3405,0,0,0,0
"10570",2017-04-01,"sbbh","transporte regular","voo internacional",0,0,0,0,0,0,0,0,0,0
"10571",2017-04-01,"sbbh","transporte não regular","voo doméstico",1676,1675,3351,7977,7968,15945,0,0,0,0
"10572",2017-04-01,"sbbh","transporte não regular","voo internacional",3,4,7,24,9,33,0,0,0,0
"10573",2017-04-01,"sbbi","transporte regular","voo doméstico",0,0,0,0,0,0,0,0,0,0
"10574",2017-04-01,"sbbi","transporte regular","voo internacional",0,0,0,0,0,0,0,0,0,0
"10575",2017-04-01,"sbbi","transporte não regular","voo doméstico",839,843,1682,1091,814,1905,0,0,0,0
"10576",2017-04-01,"sbbi","transporte não regular","voo internacional",6,6,12,7,0,7,0,0,0,0
"10577",2017-04-01,"sbbv","transporte regular","voo doméstico",82,82,164,11176,10510,21686,0,0,0,0
"10578",2017-04-01,"sbbv","transporte regular","voo internacional",0,0,0,0,0,0,0,0,0,0
"10579",2017-04-01,"sbbv","transporte não regular","voo doméstico",85,88,173,176,125,301,0,0,0,0
"10580",2017-04-01,"sbbv","transporte não regular","voo internacional",14,11,25,9,5,14,0,0,0,0
"10581",2017-04-01,"sbcg","transporte regular","voo doméstico",499,498,997,60003,59068,119071,0,0,0,0
"10582",2017-04-01,"sbcg","transporte regular","voo internacional",0,0,0,0,0,0,0,0,0,0
"10583",2017-04-01,"sbcg","transporte não regular","voo doméstico",243,244,487,529,267,796,58109,79553,137662,0
"10584",2017-04-01,"sbcg","transporte não regular","voo internacional",11,11,22,1,0,1,0,0,0,0
"10585",2017-04-01,"sbcj","transporte regular","voo doméstico",77,77,154,4865,4765,9630,0,0,0,0
"10586",2017-04-01,"sbcj","transporte regular","voo internacional",0,0,0,0,0,0,0,0,0,0
"10587",2017-04-01,"sbcj","transporte não regular","voo doméstico",78,79,157,370,21,391,0,0,0,0
"10588",2017-04-01,"sbcj","transporte não regular","voo internacional",0,0,0,0,0,0,0,0,0,0
"10589",2017-04-01,"sbcr","transporte regular","voo doméstico",1,1,2,79,95,174,0,0,0,0
"10590",2017-04-01,"sbcr","transporte regular","voo internacional",0,0,0,0,0,0,0,0,0,0
"10591",2017-04-01,"sbcr","transporte não regular","voo doméstico",68,66,134,1173,1171,2344,0,0,0,0
"10592",2017-04-01,"sbcr","transporte não regular","voo internacional",3,3,6,3,4,7,0,0,0,0
"10593",2017-04-01,"sbct","transporte regular","voo doméstico",2470,2470,4940,272678,266439,539117,133774,8862,142636,295457
"10594",2017-04-01,"sbct","transporte regular","voo internacional",54,55,109,2114,1965,4079,0,59654,59654,0
"10595",2017-04-01,"sbct","transporte não regular","voo doméstico",235,233,468,2529,2199,4728,0,0,0,0
"10596",2017-04-01,"sbct","transporte não regular","voo internacional",10,12,22,173,141,314,0,0,0,0
"10597",2017-04-01,"sbcz","transporte regular","voo doméstico",42,42,84,3254,3328,6582,0,0,0,0
"10598",2017-04-01,"sbcz","transporte regular","voo internacional",0,0,0,0,0,0,0,0,0,0
"10599",2017-04-01,"sbcz","transporte não regular","voo doméstico",147,144,291,523,527,1050,0,0,0,0
"10600",2017-04-01,"sbcz","transporte não regular","voo internacional",0,0,0,0,0,0,0,0,0,0
"10601",2017-04-01,"sbeg","transporte regular","voo doméstico",800,794,1594,88590,86339,174929,0,938,938,0
"10602",2017-04-01,"sbeg","transporte regular","voo internacional",98,103,201,3585,3266,6851,0,0,0,0
"10603",2017-04-01,"sbeg","transporte não regular","voo doméstico",397,401,798,4573,3158,7731,0,0,0,0
"10604",2017-04-01,"sbeg","transporte não regular","voo internacional",75,76,151,523,359,882,0,0,0,0
"10605",2017-04-01,"sbfi","transporte regular","voo doméstico",557,555,1112,74155,74146,148301,0,0,0,0
"10606",2017-04-01,"sbfi","transporte regular","voo internacional",22,22,44,2775,2101,4876,0,0,0,0
"10607",2017-04-01,"sbfi","transporte não regular","voo doméstico",192,190,382,2033,1791,3824,0,0,0,0
"10608",2017-04-01,"sbfi","transporte não regular","voo internacional",35,44,79,108,70,178,0,0,0,0
"10609",2017-04-01,"sbgo","transporte regular","voo doméstico",1120,1123,2243,117039,115207,232246,85039,92151,177190,112470
"10610",2017-04-01,"sbgo","transporte regular","voo internacional",0,0,0,0,0,0,0,0,0,0
"10611",2017-04-01,"sbgo","transporte não regular","voo doméstico",1149,1155,2304,5669,5647,11316,0,0,0,0
"10612",2017-04-01,"sbgo","transporte não regular","voo internacional",5,6,11,0,0,0,0,0,0,0
"10613",2017-04-01,"sbht","transporte regular","voo doméstico",122,122,244,4379,4220,8599,0,0,0,0
"10614",2017-04-01,"sbht","transporte regular","voo internacional",0,0,0,0,0,0,0,0,0,0
"10615",2017-04-01,"sbht","transporte não regular","voo doméstico",76,77,153,282,181,463,0,0,0,0
"10616",2017-04-01,"sbht","transporte não regular","voo internacional",0,0,0,0,0,0,0,0,0,0
"10617",2017-04-01,"sbiz","transporte regular","voo doméstico",120,121,241,11577,11431,23008,0,0,0,0
"10618",2017-04-01,"sbiz","transporte regular","voo internacional",0,0,0,0,0,0,0,0,0,0
"10619",2017-04-01,"sbiz","transporte não regular","voo doméstico",85,83,168,184,156,340,0,0,0,0
"10620",2017-04-01,"sbiz","transporte não regular","voo internacional",1,1,2,0,0,0,0,0,0,0
"10621",2017-04-01,"sbjc","transporte regular","voo doméstico",0,0,0,0,0,0,0,0,0,0
"10622",2017-04-01,"sbjc","transporte regular","voo internacional",0,0,0,0,0,0,0,0,0,0
"10623",2017-04-01,"sbjc","transporte não regular","voo doméstico",297,297,594,542,346,888,0,0,0,0
"10624",2017-04-01,"sbjc","transporte não regular","voo internacional",0,0,0,0,0,0,0,0,0,0
"10625",2017-04-01,"sbjr","transporte regular","voo doméstico",0,0,0,0,0,0,0,0,0,0
"10626",2017-04-01,"sbjr","transporte regular","voo internacional",0,0,0,0,0,0,0,0,0,0
"10627",2017-04-01,"sbjr","transporte não regular","voo doméstico",2273,2274,4547,11202,8880,20082,0,0,0,0
"10628",2017-04-01,"sbjr","transporte não regular","voo internacional",11,13,24,0,0,0,0,0,0,0
"10629",2017-04-01,"sbjv","transporte regular","voo doméstico",200,200,400,20203,19595,39798,0,0,0,0
"10630",2017-04-01,"sbjv","transporte regular","voo internacional",0,0,0,0,0,0,0,0,0,0
"10631",2017-04-01,"sbjv","transporte não regular","voo doméstico",100,98,198,101,73,174,0,0,0,0
"10632",2017-04-01,"sbjv","transporte não regular","voo internacional",0,0,0,0,0,0,0,0,0,0
"10633",2017-04-01,"sblo","transporte regular","voo doméstico",366,364,730,35225,34964,70189,0,0,0,0
"10634",2017-04-01,"sblo","transporte regular","voo internacional",0,0,0,0,0,0,0,0,0,0
"10635",2017-04-01,"sblo","transporte não regular","voo doméstico",519,524,1043,766,646,1412,0,0,0,0
"10636",2017-04-01,"sblo","transporte não regular","voo internacional",2,2,4,0,0,0,0,0,0,0
"10637",2017-04-01,"sbma","transporte regular","voo doméstico",130,129,259,11757,10894,22651,0,0,0,0
"10638",2017-04-01,"sbma","transporte regular","voo internacional",0,0,0,0,0,0,0,0,0,0
"10639",2017-04-01,"sbma","transporte não regular","voo doméstico",144,145,289,510,366,876,0,0,0,0
"10640",2017-04-01,"sbma","transporte não regular","voo internacional",0,0,0,0,0,0,0,0,0,0
"10641",2017-04-01,"sbmk","transporte regular","voo doméstico",147,150,297,10978,10841,21819,0,0,0,0
"10642",2017-04-01,"sbmk","transporte regular","voo internacional",0,0,0,0,0,0,0,0,0,0
"10643",2017-04-01,"sbmk","transporte não regular","voo doméstico",213,204,417,409,352,761,0,0,0,0
"10644",2017-04-01,"sbmk","transporte não regular","voo internacional",0,0,0,0,0,0,0,0,0,0
"10645",2017-04-01,"sbmq","transporte regular","voo doméstico",191,189,380,21403,20721,42124,5900,29550,35450,0
"10646",2017-04-01,"sbmq","transporte regular","voo internacional",0,0,0,0,0,0,0,0,0,0
"10647",2017-04-01,"sbmq","transporte não regular","voo doméstico",158,163,321,596,426,1022,0,0,0,0
"10648",2017-04-01,"sbmq","transporte não regular","voo internacional",6,4,10,0,0,0,0,0,0,0
"10649",2017-04-01,"sbmt","transporte regular","voo doméstico",0,0,0,0,0,0,0,0,0,0
"10650",2017-04-01,"sbmt","transporte regular","voo internacional",0,0,0,0,0,0,0,0,0,0
"10651",2017-04-01,"sbmt","transporte não regular","voo doméstico",2574,2596,5170,4453,4361,8814,0,0,0,0
"10652",2017-04-01,"sbmt","transporte não regular","voo internacional",0,0,0,0,0,0,0,0,0,0
"10653",2017-04-01,"sbnf","transporte regular","voo doméstico",479,479,958,56065,56156,112221,0,0,0,0
"10654",2017-04-01,"sbnf","transporte regular","voo internacional",0,0,0,0,0,0,0,0,0,0
"10655",2017-04-01,"sbnf","transporte não regular","voo doméstico",234,227,461,757,925,1682,0,0,0,0
"10656",2017-04-01,"sbnf","transporte não regular","voo internacional",6,7,13,15,15,30,0,0,0,0
"10657",2017-04-01,"sbpb","transporte regular","voo doméstico",5,5,10,371,405,776,0,0,0,0
"10658",2017-04-01,"sbpb","transporte regular","voo internacional",0,0,0,0,0,0,0,0,0,0
"10659",2017-04-01,"sbpb","transporte não regular","voo doméstico",41,40,81,96,102,198,0,0,0,0
"10660",2017-04-01,"sbpb","transporte não regular","voo internacional",0,0,0,0,0,0,0,0,0,0
"10661",2017-04-01,"sbpj","transporte regular","voo doméstico",263,262,525,26079,25362,51441,0,0,0,0
"10662",2017-04-01,"sbpj","transporte regular","voo internacional",0,0,0,0,0,0,0,0,0,0
"10663",2017-04-01,"sbpj","transporte não regular","voo doméstico",221,223,444,836,606,1442,0,0,0,0
"10664",2017-04-01,"sbpj","transporte não regular","voo internacional",1,1,2,0,0,0,0,0,0,0
"10665",2017-04-01,"sbpk","transporte regular","voo doméstico",25,25,50,1184,1372,2556,0,0,0,0
"10666",2017-04-01,"sbpk","transporte regular","voo internacional",0,0,0,0,0,0,0,0,0,0
"10667",2017-04-01,"sbpk","transporte não regular","voo doméstico",30,30,60,40,32,72,0,0,0,0
"10668",2017-04-01,"sbpk","transporte não regular","voo internacional",2,1,3,3,8,11,0,0,0,0
"10669",2017-04-01,"sbpl","transporte regular","voo doméstico",157,156,313,19391,16420,35811,0,0,0,0
"10670",2017-04-01,"sbpl","transporte regular","voo internacional",4,4,8,0,0,0,0,0,0,0
"10671",2017-04-01,"sbpl","transporte não regular","voo doméstico",63,65,128,80,80,160,0,0,0,0
"10672",2017-04-01,"sbpl","transporte não regular","voo internacional",0,0,0,0,0,0,0,0,0,0
"10673",2017-04-01,"sbpp","transporte regular","voo doméstico",0,0,0,0,0,0,0,0,0,0
"10674",2017-04-01,"sbpp","transporte regular","voo internacional",0,0,0,0,0,0,0,0,0,0
"10675",2017-04-01,"sbpp","transporte não regular","voo doméstico",85,86,171,124,112,236,0,0,0,0
"10676",2017-04-01,"sbpp","transporte não regular","voo internacional",5,3,8,3,4,7,0,0,0,0
"10677",2017-04-01,"sbpr","transporte regular","voo doméstico",0,0,0,0,0,0,0,0,0,0
"10678",2017-04-01,"sbpr","transporte regular","voo internacional",0,0,0,0,0,0,0,0,0,0
"10679",2017-04-01,"sbpr","transporte não regular","voo doméstico",954,954,1908,1040,994,2034,0,0,0,0
"10680",2017-04-01,"sbpr","transporte não regular","voo internacional",1,1,2,0,0,0,0,0,0,0
"10681",2017-04-01,"sbpv","transporte regular","voo doméstico",280,280,560,27067,26878,53945,0,0,0,0
"10682",2017-04-01,"sbpv","transporte regular","voo internacional",0,0,0,0,0,0,0,0,0,0
"10683",2017-04-01,"sbpv","transporte não regular","voo doméstico",230,225,455,112,63,175,0,0,0,0
"10684",2017-04-01,"sbpv","transporte não regular","voo internacional",0,0,0,0,0,0,0,0,0,0
"10685",2017-04-01,"sbrb","transporte regular","voo doméstico",114,115,229,11937,11771,23708,0,0,0,1469
"10686",2017-04-01,"sbrb","transporte regular","voo internacional",0,0,0,0,0,0,0,0,0,0
"10687",2017-04-01,"sbrb","transporte não regular","voo doméstico",127,127,254,548,311,859,0,0,0,0
"10688",2017-04-01,"sbrb","transporte não regular","voo internacional",1,1,2,0,0,0,0,0,0,0
"10689",2017-04-01,"sbrj","transporte regular","voo doméstico",3504,3540,7044,366798,363109,729907,0,0,0,0
"10690",2017-04-01,"sbrj","transporte regular","voo internacional",0,0,0,0,0,0,0,0,0,0
"10691",2017-04-01,"sbrj","transporte não regular","voo doméstico",608,572,1180,2894,2384,5278,0,0,0,0
"10692",2017-04-01,"sbrj","transporte não regular","voo internacional",1,1,2,1,0,1,0,0,0,0
"10693",2017-04-01,"sbsj","transporte regular","voo doméstico",0,0,0,0,0,0,0,0,0,0
"10694",2017-04-01,"sbsj","transporte regular","voo internacional",0,0,0,0,0,0,0,0,0,0
"10695",2017-04-01,"sbsj","transporte não regular","voo doméstico",422,414,836,606,554,1160,0,0,0,0
"10696",2017-04-01,"sbsj","transporte não regular","voo internacional",4,16,20,59,20,79,0,0,0,0
"10697",2017-04-01,"sbsl","transporte regular","voo doméstico",555,553,1108,54219,57773,111992,0,0,0,0
"10698",2017-04-01,"sbsl","transporte regular","voo internacional",0,0,0,0,0,0,0,0,0,0
"10699",2017-04-01,"sbsl","transporte não regular","voo doméstico",186,185,371,905,919,1824,45022,159415,204437,0
"10700",2017-04-01,"sbsl","transporte não regular","voo internacional",0,1,1,0,0,0,0,0,0,0
"10701",2017-04-01,"sbsn","transporte regular","voo doméstico",188,188,376,15858,15114,30972,0,0,0,0
"10702",2017-04-01,"sbsn","transporte regular","voo internacional",0,0,0,0,0,0,0,0,0,0
"10703",2017-04-01,"sbsn","transporte não regular","voo doméstico",207,208,415,399,311,710,4540,6230,10770,0
"10704",2017-04-01,"sbsn","transporte não regular","voo internacional",1,1,2,0,0,0,0,0,0,0
"10705",2017-04-01,"sbsp","transporte regular","voo doméstico",6852,6915,13767,860302,856342,1716644,0,0,0,0
"10706",2017-04-01,"sbsp","transporte regular","voo internacional",0,0,0,0,0,0,0,0,0,0
"10707",2017-04-01,"sbsp","transporte não regular","voo doméstico",1841,1794,3635,7929,6739,14668,0,0,0,0
"10708",2017-04-01,"sbsp","transporte não regular","voo internacional",15,15,30,34,37,71,0,0,0,0
"10709",2017-04-01,"sbte","transporte regular","voo doméstico",393,387,780,40824,42327,83151,20128,64041,84169,187904
"10710",2017-04-01,"sbte","transporte regular","voo internacional",0,0,0,0,0,0,0,0,0,0
"10711",2017-04-01,"sbte","transporte não regular","voo doméstico",181,186,367,2621,1920,4541,0,0,0,0
"10712",2017-04-01,"sbte","transporte não regular","voo internacional",0,0,0,0,0,0,0,0,0,0
"10713",2017-04-01,"sbtf","transporte regular","voo doméstico",34,34,68,1431,1452,2883,0,0,0,0
"10714",2017-04-01,"sbtf","transporte regular","voo internacional",0,0,0,0,0,0,0,0,0,0
"10715",2017-04-01,"sbtf","transporte não regular","voo doméstico",160,157,317,783,762,1545,1485,2086,3571,12718
"10716",2017-04-01,"sbtf","transporte não regular","voo internacional",0,0,0,0,0,0,0,0,0,0
"10717",2017-04-01,"sbtt","transporte regular","voo doméstico",30,30,60,1907,2244,4151,0,1850,1850,0
"10718",2017-04-01,"sbtt","transporte regular","voo internacional",0,0,0,0,0,0,0,0,0,0
"10719",2017-04-01,"sbtt","transporte não regular","voo doméstico",86,85,171,397,410,807,835,2536,3371,442
"10720",2017-04-01,"sbtt","transporte não regular","voo internacional",0,0,0,0,0,0,0,0,0,0
"10721",2017-04-01,"sbuf","transporte regular","voo doméstico",7,7,14,376,418,794,0,0,0,0
"10722",2017-04-01,"sbuf","transporte regular","voo internacional",0,0,0,0,0,0,0,0,0,0
"10723",2017-04-01,"sbuf","transporte não regular","voo doméstico",24,23,47,104,134,238,0,0,0,0
"10724",2017-04-01,"sbuf","transporte não regular","voo internacional",0,0,0,0,0,0,0,0,0,0
"10725",2017-04-01,"sbug","transporte regular","voo doméstico",19,19,38,1007,1056,2063,0,0,0,0
"10726",2017-04-01,"sbug","transporte regular","voo internacional",0,0,0,0,0,0,0,0,0,0
"10727",2017-04-01,"sbug","transporte não regular","voo doméstico",12,12,24,207,146,353,0,0,0,0
"10728",2017-04-01,"sbug","transporte não regular","voo internacional",0,0,0,0,0,0,0,0,0,0
"10729",2017-04-01,"sbul","transporte regular","voo doméstico",437,438,875,42514,42725,85239,0,0,0,0
"10730",2017-04-01,"sbul","transporte regular","voo internacional",0,0,0,0,0,0,0,0,0,0
"10731",2017-04-01,"sbul","transporte não regular","voo doméstico",556,562,1118,1555,1324,2879,0,0,0,0
"10732",2017-04-01,"sbul","transporte não regular","voo internacional",1,1,2,5,5,10,0,0,0,0
"10733",2017-04-01,"sbur","transporte regular","voo doméstico",60,62,122,3106,3029,6135,0,0,0,0
"10734",2017-04-01,"sbur","transporte regular","voo internacional",0,0,0,0,0,0,0,0,0,0
"10735",2017-04-01,"sbur","transporte não regular","voo doméstico",212,184,396,635,806,1441,0,0,0,0
"10736",2017-04-01,"sbur","transporte não regular","voo internacional",1,0,1,0,0,0,0,0,0,0
"10737",2017-08-01,"sbbe","transporte regular","voo doméstico",1045,1053,2098,127679,125573,253252,89685,349661,439346,0
"10738",2017-08-01,"sbbe","transporte regular","voo internacional",43,43,86,5861,5059,10920,2,0,2,0
"10739",2017-08-01,"sbbe","transporte não regular","voo doméstico",436,424,860,1944,2850,4794,0,32498,32498,0
"10740",2017-08-01,"sbbe","transporte não regular","voo internacional",14,17,31,963,1063,2026,0,0,0,0
"10741",2017-08-01,"sbbg","transporte regular","voo doméstico",0,0,0,0,0,0,0,0,0,0
"10742",2017-08-01,"sbbg","transporte regular","voo internacional",0,0,0,0,0,0,0,0,0,0
"10743",2017-08-01,"sbbg","transporte não regular","voo doméstico",13,12,25,41,43,84,0,0,0,0
"10744",2017-08-01,"sbbg","transporte não regular","voo internacional",3,3,6,12,11,23,0,0,0,0
"10745",2017-08-01,"sbbh","transporte regular","voo doméstico",54,54,108,2273,2155,4428,0,0,0,0
"10746",2017-08-01,"sbbh","transporte regular","voo internacional",0,0,0,0,0,0,0,0,0,0
"10747",2017-08-01,"sbbh","transporte não regular","voo doméstico",1797,1802,3599,8122,8166,16288,0,0,0,0
"10748",2017-08-01,"sbbh","transporte não regular","voo internacional",9,9,18,52,52,104,0,0,0,0
"10749",2017-08-01,"sbbi","transporte regular","voo doméstico",0,0,0,0,0,0,0,0,0,0
"10750",2017-08-01,"sbbi","transporte regular","voo internacional",0,0,0,0,0,0,0,0,0,0
"10751",2017-08-01,"sbbi","transporte não regular","voo doméstico",1157,1170,2327,3392,3431,6823,0,0,0,0
"10752",2017-08-01,"sbbi","transporte não regular","voo internacional",15,16,31,0,0,0,0,0,0,0
"10753",2017-08-01,"sbbv","transporte regular","voo doméstico",87,87,174,10300,9773,20073,0,0,0,0
"10754",2017-08-01,"sbbv","transporte regular","voo internacional",0,0,0,0,0,0,0,0,0,0
"10755",2017-08-01,"sbbv","transporte não regular","voo doméstico",96,100,196,536,349,885,0,0,0,0
"10756",2017-08-01,"sbbv","transporte não regular","voo internacional",23,17,40,0,1,1,0,0,0,0
"10757",2017-08-01,"sbcg","transporte regular","voo doméstico",557,564,1121,66687,63905,130592,0,4127,4127,0
"10758",2017-08-01,"sbcg","transporte regular","voo internacional",0,0,0,0,0,0,0,0,0,0
"10759",2017-08-01,"sbcg","transporte não regular","voo doméstico",295,285,580,1170,1774,2944,85113,95051,180164,0
"10760",2017-08-01,"sbcg","transporte não regular","voo internacional",10,6,16,0,0,0,0,0,0,0
"10761",2017-08-01,"sbcj","transporte regular","voo doméstico",86,86,172,5094,5167,10261,0,86,86,0
"10762",2017-08-01,"sbcj","transporte regular","voo internacional",0,0,0,0,0,0,0,0,0,0
"10763",2017-08-01,"sbcj","transporte não regular","voo doméstico",98,99,197,679,4,683,0,0,0,0
"10764",2017-08-01,"sbcj","transporte não regular","voo internacional",0,0,0,0,0,0,0,0,0,0
"10765",2017-08-01,"sbcr","transporte regular","voo doméstico",17,17,34,1135,1206,2341,0,0,0,0
"10766",2017-08-01,"sbcr","transporte regular","voo internacional",0,0,0,0,0,0,0,0,0,0
"10767",2017-08-01,"sbcr","transporte não regular","voo doméstico",43,43,86,90,73,163,0,0,0,0
"10768",2017-08-01,"sbcr","transporte não regular","voo internacional",9,9,18,21,21,42,0,0,0,0
"10769",2017-08-01,"sbct","transporte regular","voo doméstico",2184,2181,4365,247277,243701,490978,106896,64655,171551,328289
"10770",2017-08-01,"sbct","transporte regular","voo internacional",66,65,131,2685,2556,5241,0,107550,107550,0
"10771",2017-08-01,"sbct","transporte não regular","voo doméstico",585,591,1176,30836,31858,62694,0,0,0,0
"10772",2017-08-01,"sbct","transporte não regular","voo internacional",11,10,21,181,179,360,0,0,0,0
"10773",2017-08-01,"sbcz","transporte regular","voo doméstico",45,45,90,4134,4029,8163,0,0,0,0
"10774",2017-08-01,"sbcz","transporte regular","voo internacional",0,0,0,0,0,0,0,0,0,0
"10775",2017-08-01,"sbcz","transporte não regular","voo doméstico",253,254,507,1057,1000,2057,0,0,0,0
"10776",2017-08-01,"sbcz","transporte não regular","voo internacional",3,2,5,0,0,0,0,0,0,0
"10777",2017-08-01,"sbeg","transporte regular","voo doméstico",862,850,1712,99333,94248,193581,0,0,0,0
"10778",2017-08-01,"sbeg","transporte regular","voo internacional",92,99,191,4689,3656,8345,0,0,0,0
"10779",2017-08-01,"sbeg","transporte não regular","voo doméstico",538,551,1089,9238,5895,15133,0,0,0,0
"10780",2017-08-01,"sbeg","transporte não regular","voo internacional",79,74,153,679,907,1586,0,0,0,0
"10781",2017-08-01,"sbfi","transporte regular","voo doméstico",552,542,1094,77084,78194,155278,0,0,0,0
"10782",2017-08-01,"sbfi","transporte regular","voo internacional",22,22,44,2878,2582,5460,0,0,0,0
"10783",2017-08-01,"sbfi","transporte não regular","voo doméstico",232,240,472,9819,8983,18802,0,0,0,0
"10784",2017-08-01,"sbfi","transporte não regular","voo internacional",68,65,133,203,163,366,0,0,0,0
"10785",2017-08-01,"sbgo","transporte regular","voo doméstico",1173,1185,2358,123782,121783,245565,160261,202329,362590,124591
"10786",2017-08-01,"sbgo","transporte regular","voo internacional",0,0,0,0,0,0,0,0,0,0
"10787",2017-08-01,"sbgo","transporte não regular","voo doméstico",1595,1585,3180,8055,8378,16433,0,0,0,0
"10788",2017-08-01,"sbgo","transporte não regular","voo internacional",6,5,11,0,0,0,0,0,0,0
"10789",2017-08-01,"sbht","transporte regular","voo doméstico",123,124,247,4526,4132,8658,0,0,0,0
"10790",2017-08-01,"sbht","transporte regular","voo internacional",0,0,0,0,0,0,0,0,0,0
"10791",2017-08-01,"sbht","transporte não regular","voo doméstico",66,65,131,349,230,579,0,0,0,0
"10792",2017-08-01,"sbht","transporte não regular","voo internacional",0,0,0,0,0,0,0,0,0,0
"10793",2017-08-01,"sbiz","transporte regular","voo doméstico",108,108,216,13075,12600,25675,0,0,0,0
"10794",2017-08-01,"sbiz","transporte regular","voo internacional",0,0,0,0,0,0,0,0,0,0
"10795",2017-08-01,"sbiz","transporte não regular","voo doméstico",155,156,311,427,402,829,0,0,0,0
"10796",2017-08-01,"sbiz","transporte não regular","voo internacional",0,0,0,0,0,0,0,0,0,0
"10797",2017-08-01,"sbjc","transporte regular","voo doméstico",0,0,0,0,0,0,0,0,0,0
"10798",2017-08-01,"sbjc","transporte regular","voo internacional",0,0,0,0,0,0,0,0,0,0
"10799",2017-08-01,"sbjc","transporte não regular","voo doméstico",333,331,664,558,437,995,0,0,0,0
"10800",2017-08-01,"sbjc","transporte não regular","voo internacional",0,0,0,0,0,0,0,0,0,0
"10801",2017-08-01,"sbjr","transporte regular","voo doméstico",0,0,0,0,0,0,0,0,0,0
"10802",2017-08-01,"sbjr","transporte regular","voo internacional",0,0,0,0,0,0,0,0,0,0
"10803",2017-08-01,"sbjr","transporte não regular","voo doméstico",2320,2325,4645,11244,7337,18581,0,0,0,0
"10804",2017-08-01,"sbjr","transporte não regular","voo internacional",11,11,22,9,0,9,0,0,0,0
"10805",2017-08-01,"sbjv","transporte regular","voo doméstico",210,209,419,19928,19262,39190,0,0,0,0
"10806",2017-08-01,"sbjv","transporte regular","voo internacional",0,0,0,0,0,0,0,0,0,0
"10807",2017-08-01,"sbjv","transporte não regular","voo doméstico",130,128,258,1138,1188,2326,0,0,0,0
"10808",2017-08-01,"sbjv","transporte não regular","voo internacional",0,0,0,0,0,0,0,0,0,0
"10809",2017-08-01,"sblo","transporte regular","voo doméstico",276,274,550,30530,29046,59576,0,0,0,0
"10810",2017-08-01,"sblo","transporte regular","voo internacional",0,0,0,0,0,0,0,0,0,0
"10811",2017-08-01,"sblo","transporte não regular","voo doméstico",668,678,1346,7311,6621,13932,0,0,0,0
"10812",2017-08-01,"sblo","transporte não regular","voo internacional",3,2,5,4,0,4,0,0,0,0
"10813",2017-08-01,"sbma","transporte regular","voo doméstico",130,130,260,10929,10478,21407,0,0,0,0
"10814",2017-08-01,"sbma","transporte regular","voo internacional",0,0,0,0,0,0,0,0,0,0
"10815",2017-08-01,"sbma","transporte não regular","voo doméstico",164,164,328,407,372,779,0,0,0,0
"10816",2017-08-01,"sbma","transporte não regular","voo internacional",0,0,0,0,0,0,0,0,0,0
"10817",2017-08-01,"sbmk","transporte regular","voo doméstico",113,125,238,10363,9322,19685,0,0,0,0
"10818",2017-08-01,"sbmk","transporte regular","voo internacional",0,0,0,0,0,0,0,0,0,0
"10819",2017-08-01,"sbmk","transporte não regular","voo doméstico",226,217,443,1084,1428,2512,0,0,0,0
"10820",2017-08-01,"sbmk","transporte não regular","voo internacional",0,0,0,0,0,0,0,0,0,0
"10821",2017-08-01,"sbmq","transporte regular","voo doméstico",239,240,479,24001,25968,49969,14900,42980,57880,0
"10822",2017-08-01,"sbmq","transporte regular","voo internacional",0,0,0,0,0,0,0,0,0,0
"10823",2017-08-01,"sbmq","transporte não regular","voo doméstico",137,142,279,200,148,348,0,0,0,0
"10824",2017-08-01,"sbmq","transporte não regular","voo internacional",3,2,5,0,0,0,0,0,0,0
"10825",2017-08-01,"sbmt","transporte regular","voo doméstico",0,0,0,0,0,0,0,0,0,0
"10826",2017-08-01,"sbmt","transporte regular","voo internacional",0,0,0,0,0,0,0,0,0,0
"10827",2017-08-01,"sbmt","transporte não regular","voo doméstico",2637,2637,5274,4493,4554,9047,0,0,0,0
"10828",2017-08-01,"sbmt","transporte não regular","voo internacional",0,0,0,0,0,0,0,0,0,0
"10829",2017-08-01,"sbnf","transporte regular","voo doméstico",600,604,1204,64997,64560,129557,0,0,0,0
"10830",2017-08-01,"sbnf","transporte regular","voo internacional",0,0,0,0,0,0,0,0,0,0
"10831",2017-08-01,"sbnf","transporte não regular","voo doméstico",270,269,539,1544,1642,3186,0,0,0,0
"10832",2017-08-01,"sbnf","transporte não regular","voo internacional",4,1,5,0,8,8,0,0,0,0
"10833",2017-08-01,"sbpb","transporte regular","voo doméstico",4,4,8,354,426,780,0,0,0,0
"10834",2017-08-01,"sbpb","transporte regular","voo internacional",0,0,0,0,0,0,0,0,0,0
"10835",2017-08-01,"sbpb","transporte não regular","voo doméstico",78,78,156,177,202,379,0,0,0,0
"10836",2017-08-01,"sbpb","transporte não regular","voo internacional",0,0,0,0,0,0,0,0,0,0
"10837",2017-08-01,"sbpj","transporte regular","voo doméstico",300,303,603,29100,26991,56091,0,0,0,0
"10838",2017-08-01,"sbpj","transporte regular","voo internacional",0,0,0,0,0,0,0,0,0,0
"10839",2017-08-01,"sbpj","transporte não regular","voo doméstico",302,303,605,1011,1043,2054,0,0,0,0
"10840",2017-08-01,"sbpj","transporte não regular","voo internacional",1,1,2,0,0,0,0,0,0,0
"10841",2017-08-01,"sbpk","transporte regular","voo doméstico",18,18,36,982,945,1927,0,0,0,0
"10842",2017-08-01,"sbpk","transporte regular","voo internacional",0,0,0,0,0,0,0,0,0,0
"10843",2017-08-01,"sbpk","transporte não regular","voo doméstico",26,25,51,56,61,117,0,0,0,0
"10844",2017-08-01,"sbpk","transporte não regular","voo internacional",0,1,1,5,0,5,0,0,0,0
"10845",2017-08-01,"sbpl","transporte regular","voo doméstico",170,170,340,21763,18895,40658,0,0,0,0
"10846",2017-08-01,"sbpl","transporte regular","voo internacional",5,5,10,0,0,0,0,0,0,0
"10847",2017-08-01,"sbpl","transporte não regular","voo doméstico",68,64,132,178,185,363,0,0,0,0
"10848",2017-08-01,"sbpl","transporte não regular","voo internacional",0,0,0,0,0,0,0,0,0,0
"10849",2017-08-01,"sbpp","transporte regular","voo doméstico",0,0,0,0,0,0,0,0,0,0
"10850",2017-08-01,"sbpp","transporte regular","voo internacional",0,0,0,0,0,0,0,0,0,0
"10851",2017-08-01,"sbpp","transporte não regular","voo doméstico",118,115,233,190,178,368,0,0,0,0
"10852",2017-08-01,"sbpp","transporte não regular","voo internacional",11,12,23,19,17,36,0,0,0,0
"10853",2017-08-01,"sbpr","transporte regular","voo doméstico",0,0,0,0,0,0,0,0,0,0
"10854",2017-08-01,"sbpr","transporte regular","voo internacional",0,0,0,0,0,0,0,0,0,0
"10855",2017-08-01,"sbpr","transporte não regular","voo doméstico",1049,1057,2106,1221,1106,2327,0,0,0,0
"10856",2017-08-01,"sbpr","transporte não regular","voo internacional",7,7,14,0,0,0,0,0,0,0
"10857",2017-08-01,"sbpv","transporte regular","voo doméstico",320,320,640,32231,31503,63734,0,0,0,0
"10858",2017-08-01,"sbpv","transporte regular","voo internacional",0,0,0,0,0,0,0,0,0,0
"10859",2017-08-01,"sbpv","transporte não regular","voo doméstico",241,242,483,217,110,327,0,0,0,0
"10860",2017-08-01,"sbpv","transporte não regular","voo internacional",1,1,2,0,0,0,0,0,0,0
"10861",2017-08-01,"sbrb","transporte regular","voo doméstico",120,120,240,12975,13803,26778,0,0,0,0
"10862",2017-08-01,"sbrb","transporte regular","voo internacional",0,0,0,0,0,0,0,0,0,0
"10863",2017-08-01,"sbrb","transporte não regular","voo doméstico",191,190,381,546,308,854,0,0,0,0
"10864",2017-08-01,"sbrb","transporte não regular","voo internacional",0,0,0,0,0,0,0,0,0,0
"10865",2017-08-01,"sbrj","transporte regular","voo doméstico",3731,3714,7445,366499,369065,735564,0,0,0,0
"10866",2017-08-01,"sbrj","transporte regular","voo internacional",0,0,0,0,0,0,0,0,0,0
"10867",2017-08-01,"sbrj","transporte não regular","voo doméstico",592,614,1206,11007,7718,18725,0,0,0,0
"10868",2017-08-01,"sbrj","transporte não regular","voo internacional",5,5,10,5,0,5,0,0,0,0
"10869",2017-08-01,"sbsj","transporte regular","voo doméstico",0,0,0,0,0,0,0,0,0,0
"10870",2017-08-01,"sbsj","transporte regular","voo internacional",0,0,0,0,0,0,0,0,0,0
"10871",2017-08-01,"sbsj","transporte não regular","voo doméstico",443,437,880,1514,1418,2932,0,0,0,0
"10872",2017-08-01,"sbsj","transporte não regular","voo internacional",4,16,20,91,16,107,0,0,0,0
"10873",2017-08-01,"sbsl","transporte regular","voo doméstico",505,505,1010,61056,63159,124215,3244,1191,4435,0
"10874",2017-08-01,"sbsl","transporte regular","voo internacional",0,0,0,0,0,0,0,0,0,0
"10875",2017-08-01,"sbsl","transporte não regular","voo doméstico",294,293,587,5114,5212,10326,62757,174693,237450,0
"10876",2017-08-01,"sbsl","transporte não regular","voo internacional",1,1,2,0,0,0,0,0,0,0
"10877",2017-08-01,"sbsn","transporte regular","voo doméstico",184,184,368,18501,17895,36396,0,0,0,0
"10878",2017-08-01,"sbsn","transporte regular","voo internacional",0,0,0,0,0,0,0,0,0,0
"10879",2017-08-01,"sbsn","transporte não regular","voo doméstico",196,194,390,507,157,664,0,0,0,0
"10880",2017-08-01,"sbsn","transporte não regular","voo internacional",1,1,2,0,0,0,0,0,0,0
"10881",2017-08-01,"sbsp","transporte regular","voo doméstico",7442,7496,14938,908836,907879,1816715,0,0,0,0
"10882",2017-08-01,"sbsp","transporte regular","voo internacional",0,0,0,0,0,0,0,0,0,0
"10883",2017-08-01,"sbsp","transporte não regular","voo doméstico",2074,2027,4101,8634,8148,16782,0,0,0,0
"10884",2017-08-01,"sbsp","transporte não regular","voo internacional",52,52,104,104,107,211,0,0,0,0
"10885",2017-08-01,"sbte","transporte regular","voo doméstico",412,410,822,45048,42115,87163,19308,72408,91716,231274
"10886",2017-08-01,"sbte","transporte regular","voo internacional",0,0,0,0,0,0,0,0,0,0
"10887",2017-08-01,"sbte","transporte não regular","voo doméstico",215,214,429,1327,1314,2641,0,0,0,0
"10888",2017-08-01,"sbte","transporte não regular","voo internacional",0,0,0,0,0,0,0,0,0,0
"10889",2017-08-01,"sbtf","transporte regular","voo doméstico",29,29,58,1350,1398,2748,0,0,0,0
"10890",2017-08-01,"sbtf","transporte regular","voo internacional",0,0,0,0,0,0,0,0,0,0
"10891",2017-08-01,"sbtf","transporte não regular","voo doméstico",167,169,336,484,454,938,1668,2751,4419,15680
"10892",2017-08-01,"sbtf","transporte não regular","voo internacional",0,0,0,0,0,0,0,0,0,0
"10893",2017-08-01,"sbtt","transporte regular","voo doméstico",33,33,66,2741,3099,5840,0,986,986,0
"10894",2017-08-01,"sbtt","transporte regular","voo internacional",0,0,0,0,0,0,0,0,0,0
"10895",2017-08-01,"sbtt","transporte não regular","voo doméstico",79,79,158,301,321,622,1119,2650,3769,647
"10896",2017-08-01,"sbtt","transporte não regular","voo internacional",0,0,0,0,0,0,0,0,0,0
"10897",2017-08-01,"sbuf","transporte regular","voo doméstico",8,8,16,465,434,899,0,0,0,0
"10898",2017-08-01,"sbuf","transporte regular","voo internacional",0,0,0,0,0,0,0,0,0,0
"10899",2017-08-01,"sbuf","transporte não regular","voo doméstico",30,30,60,39,37,76,0,0,0,0
"10900",2017-08-01,"sbuf","transporte não regular","voo internacional",0,0,0,0,0,0,0,0,0,0
"10901",2017-08-01,"sbug","transporte regular","voo doméstico",1,1,2,55,60,115,0,0,0,0
"10902",2017-08-01,"sbug","transporte regular","voo internacional",0,0,0,0,0,0,0,0,0,0
"10903",2017-08-01,"sbug","transporte não regular","voo doméstico",18,18,36,671,701,1372,0,0,0,0
"10904",2017-08-01,"sbug","transporte não regular","voo internacional",1,0,1,0,0,0,0,0,0,0
"10905",2017-08-01,"sbul","transporte regular","voo doméstico",449,441,890,45094,44247,89341,0,0,0,0
"10906",2017-08-01,"sbul","transporte regular","voo internacional",0,0,0,0,0,0,0,0,0,0
"10907",2017-08-01,"sbul","transporte não regular","voo doméstico",688,697,1385,6403,5154,11557,0,0,0,0
"10908",2017-08-01,"sbul","transporte não regular","voo internacional",2,2,4,10,10,20,0,0,0,0
"10909",2017-08-01,"sbur","transporte regular","voo doméstico",31,47,78,2398,1619,4017,0,0,0,0
"10910",2017-08-01,"sbur","transporte regular","voo internacional",0,0,0,0,0,0,0,0,0,0
"10911",2017-08-01,"sbur","transporte não regular","voo doméstico",244,224,468,959,1629,2588,0,0,0,0
"10912",2017-08-01,"sbur","transporte não regular","voo internacional",3,3,6,0,0,0,0,0,0,0
"10913",2017-12-01,"sbbe","transporte regular","voo doméstico",1152,1135,2287,141628,142202,283830,84020,322559,406579,3
"10914",2017-12-01,"sbbe","transporte regular","voo internacional",53,54,107,7144,6941,14085,2,2,4,0
"10915",2017-12-01,"sbbe","transporte não regular","voo doméstico",433,442,875,5552,4570,10122,1150,0,1150,0
"10916",2017-12-01,"sbbe","transporte não regular","voo internacional",6,8,14,26,117,143,0,0,0,0
"10917",2017-12-01,"sbbg","transporte regular","voo doméstico",0,0,0,0,0,0,0,0,0,0
"10918",2017-12-01,"sbbg","transporte regular","voo internacional",0,0,0,0,0,0,0,0,0,0
"10919",2017-12-01,"sbbg","transporte não regular","voo doméstico",11,10,21,37,57,94,0,0,0,0
"10920",2017-12-01,"sbbg","transporte não regular","voo internacional",0,1,1,3,0,3,0,0,0,0
"10921",2017-12-01,"sbbh","transporte regular","voo doméstico",83,87,170,3121,2749,5870,0,0,0,0
"10922",2017-12-01,"sbbh","transporte regular","voo internacional",0,0,0,0,0,0,0,0,0,0
"10923",2017-12-01,"sbbh","transporte não regular","voo doméstico",1434,1449,2883,7504,7501,15005,0,0,0,0
"10924",2017-12-01,"sbbh","transporte não regular","voo internacional",2,2,4,5,5,10,0,0,0,0
"10925",2017-12-01,"sbbi","transporte regular","voo doméstico",0,0,0,0,0,0,0,0,0,0
"10926",2017-12-01,"sbbi","transporte regular","voo internacional",0,0,0,0,0,0,0,0,0,0
"10927",2017-12-01,"sbbi","transporte não regular","voo doméstico",952,980,1932,3647,3744,7391,0,0,0,0
"10928",2017-12-01,"sbbi","transporte não regular","voo internacional",2,1,3,0,0,0,0,0,0,0
"10929",2017-12-01,"sbbv","transporte regular","voo doméstico",89,90,179,13244,10495,23739,0,0,0,0
"10930",2017-12-01,"sbbv","transporte regular","voo internacional",0,0,0,0,0,0,0,0,0,0
"10931",2017-12-01,"sbbv","transporte não regular","voo doméstico",155,156,311,391,200,591,0,0,0,0
"10932",2017-12-01,"sbbv","transporte não regular","voo internacional",26,27,53,0,1,1,0,0,0,0
"10933",2017-12-01,"sbcg","transporte regular","voo doméstico",577,572,1149,76319,69211,145530,1,17715,17716,0
"10934",2017-12-01,"sbcg","transporte regular","voo internacional",5,5,10,43,29,72,0,0,0,0
"10935",2017-12-01,"sbcg","transporte não regular","voo doméstico",180,186,366,917,663,1580,61953,71486,133439,0
"10936",2017-12-01,"sbcg","transporte não regular","voo internacional",10,10,20,42,0,42,0,0,0,0
"10937",2017-12-01,"sbcj","transporte regular","voo doméstico",78,78,156,5348,4403,9751,0,0,0,0
"10938",2017-12-01,"sbcj","transporte regular","voo internacional",0,0,0,0,0,0,0,0,0,0
"10939",2017-12-01,"sbcj","transporte não regular","voo doméstico",72,72,144,1076,410,1486,0,0,0,0
"10940",2017-12-01,"sbcj","transporte não regular","voo internacional",1,1,2,0,0,0,0,0,0,0
"10941",2017-12-01,"sbcr","transporte regular","voo doméstico",11,11,22,630,710,1340,0,0,0,0
"10942",2017-12-01,"sbcr","transporte regular","voo internacional",0,0,0,0,0,0,0,0,0,0
"10943",2017-12-01,"sbcr","transporte não regular","voo doméstico",39,43,82,949,604,1553,0,0,0,0
"10944",2017-12-01,"sbcr","transporte não regular","voo internacional",4,4,8,13,14,27,0,0,0,0
"10945",2017-12-01,"sbct","transporte regular","voo doméstico",2283,2313,4596,275694,262992,538686,158536,63845,222381,321955
"10946",2017-12-01,"sbct","transporte regular","voo internacional",59,57,116,1831,2035,3866,0,50205,50205,0
"10947",2017-12-01,"sbct","transporte não regular","voo doméstico",373,348,721,13300,14365,27665,0,0,0,0
"10948",2017-12-01,"sbct","transporte não regular","voo internacional",21,19,40,923,1010,1933,0,0,0,0
"10949",2017-12-01,"sbcz","transporte regular","voo doméstico",40,41,81,3125,3522,6647,0,0,0,0
"10950",2017-12-01,"sbcz","transporte regular","voo internacional",0,0,0,0,0,0,0,0,0,0
"10951",2017-12-01,"sbcz","transporte não regular","voo doméstico",192,191,383,647,610,1257,0,0,0,0
"10952",2017-12-01,"sbcz","transporte não regular","voo internacional",0,0,0,0,0,0,0,0,0,0
"10953",2017-12-01,"sbeg","transporte regular","voo doméstico",912,903,1815,120672,100413,221085,0,0,0,0
"10954",2017-12-01,"sbeg","transporte regular","voo internacional",105,118,223,6897,5161,12058,0,0,0,0
"10955",2017-12-01,"sbeg","transporte não regular","voo doméstico",585,590,1175,6381,3718,10099,0,0,0,0
"10956",2017-12-01,"sbeg","transporte não regular","voo internacional",78,76,154,174,9,183,0,0,0,0
"10957",2017-12-01,"sbfi","transporte regular","voo doméstico",671,678,1349,96759,86699,183458,0,0,0,0
"10958",2017-12-01,"sbfi","transporte regular","voo internacional",23,23,46,3193,1972,5165,0,0,0,0
"10959",2017-12-01,"sbfi","transporte não regular","voo doméstico",227,216,443,7680,6941,14621,0,0,0,0
"10960",2017-12-01,"sbfi","transporte não regular","voo internacional",47,54,101,132,262,394,0,0,0,0
"10961",2017-12-01,"sbgo","transporte regular","voo doméstico",1202,1208,2410,136286,102936,239222,112448,151142,263590,116192
"10962",2017-12-01,"sbgo","transporte regular","voo internacional",0,0,0,0,0,0,0,0,0,0
"10963",2017-12-01,"sbgo","transporte não regular","voo doméstico",1308,1287,2595,11864,8114,19978,0,0,0,0
"10964",2017-12-01,"sbgo","transporte não regular","voo internacional",3,2,5,0,0,0,0,0,0,0
"10965",2017-12-01,"sbht","transporte regular","voo doméstico",94,94,188,4635,4216,8851,0,0,0,0
"10966",2017-12-01,"sbht","transporte regular","voo internacional",0,0,0,0,0,0,0,0,0,0
"10967",2017-12-01,"sbht","transporte não regular","voo doméstico",66,66,132,427,219,646,0,0,0,0
"10968",2017-12-01,"sbht","transporte não regular","voo internacional",0,0,0,0,0,0,0,0,0,0
"10969",2017-12-01,"sbiz","transporte regular","voo doméstico",104,104,208,13396,13034,26430,0,0,0,0
"10970",2017-12-01,"sbiz","transporte regular","voo internacional",0,0,0,0,0,0,0,0,0,0
"10971",2017-12-01,"sbiz","transporte não regular","voo doméstico",148,144,292,418,373,791,0,0,0,0
"10972",2017-12-01,"sbiz","transporte não regular","voo internacional",0,0,0,0,0,0,0,0,0,0
"10973",2017-12-01,"sbjc","transporte regular","voo doméstico",0,0,0,0,0,0,0,0,0,0
"10974",2017-12-01,"sbjc","transporte regular","voo internacional",0,0,0,0,0,0,0,0,0,0
"10975",2017-12-01,"sbjc","transporte não regular","voo doméstico",399,398,797,793,525,1318,0,0,0,0
"10976",2017-12-01,"sbjc","transporte não regular","voo internacional",0,0,0,0,0,0,0,0,0,0
"10977",2017-12-01,"sbjr","transporte regular","voo doméstico",0,0,0,0,0,0,0,0,0,0
"10978",2017-12-01,"sbjr","transporte regular","voo internacional",0,0,0,0,0,0,0,0,0,0
"10979",2017-12-01,"sbjr","transporte não regular","voo doméstico",2553,2555,5108,9775,5623,15398,0,0,0,0
"10980",2017-12-01,"sbjr","transporte não regular","voo internacional",0,0,0,0,0,0,0,0,0,0
"10981",2017-12-01,"sbjv","transporte regular","voo doméstico",211,211,422,20861,21783,42644,0,0,0,0
"10982",2017-12-01,"sbjv","transporte regular","voo internacional",0,0,0,0,0,0,0,0,0,0
"10983",2017-12-01,"sbjv","transporte não regular","voo doméstico",121,122,243,276,199,475,0,0,0,0
"10984",2017-12-01,"sbjv","transporte não regular","voo internacional",0,0,0,0,0,0,0,0,0,0
"10985",2017-12-01,"sblo","transporte regular","voo doméstico",361,356,717,35602,35309,70911,0,0,0,0
"10986",2017-12-01,"sblo","transporte regular","voo internacional",0,0,0,0,0,0,0,0,0,0
"10987",2017-12-01,"sblo","transporte não regular","voo doméstico",488,494,982,2574,2008,4582,0,0,0,0
"10988",2017-12-01,"sblo","transporte não regular","voo internacional",2,2,4,0,0,0,0,0,0,0
"10989",2017-12-01,"sbma","transporte regular","voo doméstico",127,127,254,11975,11224,23199,0,0,0,0
"10990",2017-12-01,"sbma","transporte regular","voo internacional",0,0,0,0,0,0,0,0,0,0
"10991",2017-12-01,"sbma","transporte não regular","voo doméstico",139,139,278,377,428,805,0,0,0,0
"10992",2017-12-01,"sbma","transporte não regular","voo internacional",0,0,0,0,0,0,0,0,0,0
"10993",2017-12-01,"sbmk","transporte regular","voo doméstico",117,121,238,9366,9579,18945,0,0,0,0
"10994",2017-12-01,"sbmk","transporte regular","voo internacional",0,0,0,0,0,0,0,0,0,0
"10995",2017-12-01,"sbmk","transporte não regular","voo doméstico",145,147,292,1246,1179,2425,0,0,0,0
"10996",2017-12-01,"sbmk","transporte não regular","voo internacional",0,0,0,0,0,0,0,0,0,0
"10997",2017-12-01,"sbmq","transporte regular","voo doméstico",214,213,427,25056,22230,47286,14610,42970,57580,0
"10998",2017-12-01,"sbmq","transporte regular","voo internacional",0,0,0,0,0,0,0,0,0,0
"10999",2017-12-01,"sbmq","transporte não regular","voo doméstico",164,163,327,645,300,945,0,0,0,0
"11000",2017-12-01,"sbmq","transporte não regular","voo internacional",4,3,7,0,0,0,0,0,0,0
"11001",2017-12-01,"sbmt","transporte regular","voo doméstico",0,0,0,0,0,0,0,0,0,0
"11002",2017-12-01,"sbmt","transporte regular","voo internacional",0,0,0,0,0,0,0,0,0,0
"11003",2017-12-01,"sbmt","transporte não regular","voo doméstico",2952,2985,5937,5269,5151,10420,0,0,0,0
"11004",2017-12-01,"sbmt","transporte não regular","voo internacional",2,2,4,0,0,0,0,0,0,0
"11005",2017-12-01,"sbnf","transporte regular","voo doméstico",701,696,1397,73179,82878,156057,0,0,0,0
"11006",2017-12-01,"sbnf","transporte regular","voo internacional",19,20,39,3039,2148,5187,0,0,0,0
"11007",2017-12-01,"sbnf","transporte não regular","voo doméstico",317,310,627,2384,2654,5038,0,0,0,0
"11008",2017-12-01,"sbnf","transporte não regular","voo internacional",4,4,8,1,13,14,0,0,0,0
"11009",2017-12-01,"sbpb","transporte regular","voo doméstico",5,5,10,303,438,741,0,0,0,0
"11010",2017-12-01,"sbpb","transporte regular","voo internacional",0,0,0,0,0,0,0,0,0,0
"11011",2017-12-01,"sbpb","transporte não regular","voo doméstico",94,89,183,167,185,352,0,0,0,0
"11012",2017-12-01,"sbpb","transporte não regular","voo internacional",0,0,0,0,0,0,0,0,0,0
"11013",2017-12-01,"sbpj","transporte regular","voo doméstico",285,288,573,30515,28104,58619,0,0,0,0
"11014",2017-12-01,"sbpj","transporte regular","voo internacional",0,0,0,0,0,0,0,0,0,0
"11015",2017-12-01,"sbpj","transporte não regular","voo doméstico",214,218,432,522,385,907,0,0,0,0
"11016",2017-12-01,"sbpj","transporte não regular","voo internacional",1,1,2,0,0,0,0,0,0,0
"11017",2017-12-01,"sbpk","transporte regular","voo doméstico",26,26,52,1259,1271,2530,0,0,0,0
"11018",2017-12-01,"sbpk","transporte regular","voo internacional",0,0,0,0,0,0,0,0,0,0
"11019",2017-12-01,"sbpk","transporte não regular","voo doméstico",39,39,78,57,54,111,0,0,0,0
"11020",2017-12-01,"sbpk","transporte não regular","voo internacional",6,5,11,0,10,10,0,0,0,0
"11021",2017-12-01,"sbpl","transporte regular","voo doméstico",149,147,296,19381,20095,39476,0,0,0,0
"11022",2017-12-01,"sbpl","transporte regular","voo internacional",4,4,8,0,0,0,0,0,0,0
"11023",2017-12-01,"sbpl","transporte não regular","voo doméstico",99,102,201,2094,1993,4087,0,0,0,0
"11024",2017-12-01,"sbpl","transporte não regular","voo internacional",2,2,4,0,0,0,0,0,0,0
"11025",2017-12-01,"sbpp","transporte regular","voo doméstico",0,0,0,0,0,0,0,0,0,0
"11026",2017-12-01,"sbpp","transporte regular","voo internacional",0,0,0,0,0,0,0,0,0,0
"11027",2017-12-01,"sbpp","transporte não regular","voo doméstico",94,96,190,172,174,346,0,0,0,0
"11028",2017-12-01,"sbpp","transporte não regular","voo internacional",5,5,10,5,5,10,0,0,0,0
"11029",2017-12-01,"sbpr","transporte regular","voo doméstico",0,0,0,0,0,0,0,0,0,0
"11030",2017-12-01,"sbpr","transporte regular","voo internacional",0,0,0,0,0,0,0,0,0,0
"11031",2017-12-01,"sbpr","transporte não regular","voo doméstico",671,681,1352,824,739,1563,0,0,0,0
"11032",2017-12-01,"sbpr","transporte não regular","voo internacional",5,6,11,0,0,0,0,0,0,0
"11033",2017-12-01,"sbpv","transporte regular","voo doméstico",314,313,627,39752,34770,74522,0,0,0,0
"11034",2017-12-01,"sbpv","transporte regular","voo internacional",0,0,0,0,0,0,0,0,0,0
"11035",2017-12-01,"sbpv","transporte não regular","voo doméstico",229,230,459,81,0,81,0,0,0,0
"11036",2017-12-01,"sbpv","transporte não regular","voo internacional",0,0,0,0,0,0,0,0,0,0
"11037",2017-12-01,"sbrb","transporte regular","voo doméstico",116,114,230,14611,12626,27237,0,0,0,0
"11038",2017-12-01,"sbrb","transporte regular","voo internacional",0,0,0,0,0,0,0,0,0,0
"11039",2017-12-01,"sbrb","transporte não regular","voo doméstico",169,166,335,363,120,483,0,0,0,0
"11040",2017-12-01,"sbrb","transporte não regular","voo internacional",2,2,4,0,0,0,0,0,0,0
"11041",2017-12-01,"sbrj","transporte regular","voo doméstico",3673,3699,7372,387282,421931,809213,0,0,0,0
"11042",2017-12-01,"sbrj","transporte regular","voo internacional",0,0,0,0,0,0,0,0,0,0
"11043",2017-12-01,"sbrj","transporte não regular","voo doméstico",739,711,1450,11434,12825,24259,0,0,0,0
"11044",2017-12-01,"sbrj","transporte não regular","voo internacional",0,0,0,0,0,0,0,0,0,0
"11045",2017-12-01,"sbsj","transporte regular","voo doméstico",0,0,0,0,0,0,0,0,0,0
"11046",2017-12-01,"sbsj","transporte regular","voo internacional",0,0,0,0,0,0,0,0,0,0
"11047",2017-12-01,"sbsj","transporte não regular","voo doméstico",416,415,831,1696,1455,3151,0,0,0,0
"11048",2017-12-01,"sbsj","transporte não regular","voo internacional",9,25,34,80,15,95,0,0,0,0
"11049",2017-12-01,"sbsl","transporte regular","voo doméstico",636,632,1268,70901,80637,151538,0,0,0,0
"11050",2017-12-01,"sbsl","transporte regular","voo internacional",0,0,0,0,0,0,0,0,0,0
"11051",2017-12-01,"sbsl","transporte não regular","voo doméstico",288,279,567,1952,2067,4019,49053,175107,224160,0
"11052",2017-12-01,"sbsl","transporte não regular","voo internacional",0,0,0,0,0,0,0,0,0,0
"11053",2017-12-01,"sbsn","transporte regular","voo doméstico",241,241,482,19517,20047,39564,0,26,26,2362
"11054",2017-12-01,"sbsn","transporte regular","voo internacional",0,0,0,0,0,0,0,0,0,0
"11055",2017-12-01,"sbsn","transporte não regular","voo doméstico",221,226,447,658,495,1153,6750,7880,14630,0
"11056",2017-12-01,"sbsn","transporte não regular","voo internacional",0,0,0,0,0,0,0,0,0,0
"11057",2017-12-01,"sbsp","transporte regular","voo doméstico",7344,7396,14740,1011883,944265,1956148,0,0,0,0
"11058",2017-12-01,"sbsp","transporte regular","voo internacional",0,0,0,0,0,0,0,0,0,0
"11059",2017-12-01,"sbsp","transporte não regular","voo doméstico",2263,2235,4498,22563,21530,44093,0,0,0,0
"11060",2017-12-01,"sbsp","transporte não regular","voo internacional",8,8,16,16,14,30,0,0,0,0
"11061",2017-12-01,"sbte","transporte regular","voo doméstico",428,428,856,45763,53967,99730,21014,81763,102777,201624
"11062",2017-12-01,"sbte","transporte regular","voo internacional",0,0,0,0,0,0,0,0,0,0
"11063",2017-12-01,"sbte","transporte não regular","voo doméstico",212,219,431,2817,2873,5690,0,0,0,0
"11064",2017-12-01,"sbte","transporte não regular","voo internacional",0,0,0,0,0,0,0,0,0,0
"11065",2017-12-01,"sbtf","transporte regular","voo doméstico",31,31,62,1470,1505,2975,0,0,0,0
"11066",2017-12-01,"sbtf","transporte regular","voo internacional",0,0,0,0,0,0,0,0,0,0
"11067",2017-12-01,"sbtf","transporte não regular","voo doméstico",134,135,269,346,335,681,1120,1802,2922,8478
"11068",2017-12-01,"sbtf","transporte não regular","voo internacional",0,0,0,0,0,0,0,0,0,0
"11069",2017-12-01,"sbtt","transporte regular","voo doméstico",33,33,66,2466,3301,5767,0,0,0,0
"11070",2017-12-01,"sbtt","transporte regular","voo internacional",0,0,0,0,0,0,0,0,0,0
"11071",2017-12-01,"sbtt","transporte não regular","voo doméstico",85,83,168,358,368,726,519,1794,2313,426
"11072",2017-12-01,"sbtt","transporte não regular","voo internacional",0,2,2,11,0,11,0,0,0,0
"11073",2017-12-01,"sbuf","transporte regular","voo doméstico",11,11,22,602,618,1220,0,0,0,0
"11074",2017-12-01,"sbuf","transporte regular","voo internacional",0,0,0,0,0,0,0,0,0,0
"11075",2017-12-01,"sbuf","transporte não regular","voo doméstico",22,22,44,47,37,84,0,0,0,0
"11076",2017-12-01,"sbuf","transporte não regular","voo internacional",0,0,0,0,0,0,0,0,0,0
"11077",2017-12-01,"sbug","transporte regular","voo doméstico",20,20,40,1085,1054,2139,0,0,0,0
"11078",2017-12-01,"sbug","transporte regular","voo internacional",0,0,0,0,0,0,0,0,0,0
"11079",2017-12-01,"sbug","transporte não regular","voo doméstico",8,8,16,91,52,143,0,0,0,0
"11080",2017-12-01,"sbug","transporte não regular","voo internacional",1,1,2,0,0,0,0,0,0,0
"11081",2017-12-01,"sbul","transporte regular","voo doméstico",463,463,926,44717,43492,88209,0,0,0,0
"11082",2017-12-01,"sbul","transporte regular","voo internacional",0,0,0,0,0,0,0,0,0,0
"11083",2017-12-01,"sbul","transporte não regular","voo doméstico",536,538,1074,3839,3075,6914,0,0,0,0
"11084",2017-12-01,"sbul","transporte não regular","voo internacional",0,0,0,0,0,0,0,0,0,0
"11085",2017-12-01,"sbur","transporte regular","voo doméstico",50,51,101,2159,2016,4175,0,0,0,0
"11086",2017-12-01,"sbur","transporte regular","voo internacional",0,0,0,0,0,0,0,0,0,0
"11087",2017-12-01,"sbur","transporte não regular","voo doméstico",187,186,373,691,624,1315,0,0,0,0
"11088",2017-12-01,"sbur","transporte não regular","voo internacional",0,0,0,0,0,0,0,0,0,0
"11089",2017-02-01,"sbbe","transporte regular","voo doméstico",1125,1138,2263,129132,120328,249460,71285,221337,292622,3
"11090",2017-02-01,"sbbe","transporte regular","voo internacional",42,40,82,4176,4528,8704,0,11,11,0
"11091",2017-02-01,"sbbe","transporte não regular","voo doméstico",336,331,667,2472,2769,5241,0,0,0,0
"11092",2017-02-01,"sbbe","transporte não regular","voo internacional",11,12,23,32,16,48,0,0,0,0
"11093",2017-02-01,"sbbg","transporte regular","voo doméstico",0,0,0,0,0,0,0,0,0,0
"11094",2017-02-01,"sbbg","transporte regular","voo internacional",0,0,0,0,0,0,0,0,0,0
"11095",2017-02-01,"sbbg","transporte não regular","voo doméstico",5,6,11,20,18,38,0,0,0,0
"11096",2017-02-01,"sbbg","transporte não regular","voo internacional",2,1,3,8,10,18,0,0,0,0
"11097",2017-02-01,"sbbh","transporte regular","voo doméstico",45,45,90,1488,1504,2992,0,0,0,0
"11098",2017-02-01,"sbbh","transporte regular","voo internacional",0,0,0,0,0,0,0,0,0,0
"11099",2017-02-01,"sbbh","transporte não regular","voo doméstico",1399,1403,2802,6940,6909,13849,0,0,0,0
"11100",2017-02-01,"sbbh","transporte não regular","voo internacional",1,1,2,5,5,10,0,0,0,0
"11101",2017-02-01,"sbbi","transporte regular","voo doméstico",0,0,0,0,0,0,0,0,0,0
"11102",2017-02-01,"sbbi","transporte regular","voo internacional",0,0,0,0,0,0,0,0,0,0
"11103",2017-02-01,"sbbi","transporte não regular","voo doméstico",1017,1017,2034,3622,3292,6914,0,0,0,0
"11104",2017-02-01,"sbbi","transporte não regular","voo internacional",0,0,0,0,0,0,0,0,0,0
"11105",2017-02-01,"sbbv","transporte regular","voo doméstico",79,80,159,11181,11680,22861,0,0,0,0
"11106",2017-02-01,"sbbv","transporte regular","voo internacional",0,0,0,0,0,0,0,0,0,0
"11107",2017-02-01,"sbbv","transporte não regular","voo doméstico",69,68,137,222,53,275,0,0,0,0
"11108",2017-02-01,"sbbv","transporte não regular","voo internacional",16,17,33,0,3,3,0,0,0,0
"11109",2017-02-01,"sbcg","transporte regular","voo doméstico",464,462,926,50711,52848,103559,0,0,0,0
"11110",2017-02-01,"sbcg","transporte regular","voo internacional",0,0,0,0,0,0,0,0,0,0
"11111",2017-02-01,"sbcg","transporte não regular","voo doméstico",193,194,387,1315,1359,2674,57526,87393,144919,0
"11112",2017-02-01,"sbcg","transporte não regular","voo internacional",1,1,2,0,0,0,0,0,0,0
"11113",2017-02-01,"sbcj","transporte regular","voo doméstico",58,60,118,5313,4269,9582,0,0,0,0
"11114",2017-02-01,"sbcj","transporte regular","voo internacional",0,0,0,0,0,0,0,0,0,0
"11115",2017-02-01,"sbcj","transporte não regular","voo doméstico",76,74,150,483,305,788,0,0,0,0
"11116",2017-02-01,"sbcj","transporte não regular","voo internacional",1,1,2,0,0,0,0,0,0,0
"11117",2017-02-01,"sbcr","transporte regular","voo doméstico",7,7,14,482,553,1035,0,0,0,0
"11118",2017-02-01,"sbcr","transporte regular","voo internacional",0,0,0,0,0,0,0,0,0,0
"11119",2017-02-01,"sbcr","transporte não regular","voo doméstico",55,52,107,655,741,1396,0,0,0,0
"11120",2017-02-01,"sbcr","transporte não regular","voo internacional",3,6,9,13,1,14,0,0,0,0
"11121",2017-02-01,"sbct","transporte regular","voo doméstico",2325,2358,4683,227938,236869,464807,136478,23405,159883,309344
"11122",2017-02-01,"sbct","transporte regular","voo internacional",51,51,102,1846,1673,3519,0,49650,49650,0
"11123",2017-02-01,"sbct","transporte não regular","voo doméstico",263,239,502,5866,7978,13844,0,0,0,0
"11124",2017-02-01,"sbct","transporte não regular","voo internacional",13,13,26,117,116,233,0,0,0,0
"11125",2017-02-01,"sbcz","transporte regular","voo doméstico",25,26,51,2929,2643,5572,0,0,0,0
"11126",2017-02-01,"sbcz","transporte regular","voo internacional",0,0,0,0,0,0,0,0,0,0
"11127",2017-02-01,"sbcz","transporte não regular","voo doméstico",130,128,258,512,544,1056,0,0,0,0
"11128",2017-02-01,"sbcz","transporte não regular","voo internacional",1,1,2,0,0,0,0,0,0,0
"11129",2017-02-01,"sbeg","transporte regular","voo doméstico",779,779,1558,90269,92118,182387,0,0,0,0
"11130",2017-02-01,"sbeg","transporte regular","voo internacional",92,90,182,3581,3809,7390,0,0,0,0
"11131",2017-02-01,"sbeg","transporte não regular","voo doméstico",414,416,830,5356,4883,10239,0,0,0,0
"11132",2017-02-01,"sbeg","transporte não regular","voo internacional",80,84,164,764,780,1544,0,0,0,0
"11133",2017-02-01,"sbfi","transporte regular","voo doméstico",537,546,1083,70185,77195,147380,0,0,0,0
"11134",2017-02-01,"sbfi","transporte regular","voo internacional",20,20,40,2496,2625,5121,0,0,0,0
"11135",2017-02-01,"sbfi","transporte não regular","voo doméstico",159,146,305,5253,6735,11988,0,0,0,0
"11136",2017-02-01,"sbfi","transporte não regular","voo internacional",36,37,73,121,88,209,0,0,0,0
"11137",2017-02-01,"sbgo","transporte regular","voo doméstico",1088,1094,2182,103767,100358,204125,81129,84075,165204,115908
"11138",2017-02-01,"sbgo","transporte regular","voo internacional",0,0,0,0,0,0,0,0,0,0
"11139",2017-02-01,"sbgo","transporte não regular","voo doméstico",1004,1021,2025,4334,4507,8841,0,0,0,0
"11140",2017-02-01,"sbgo","transporte não regular","voo internacional",2,2,4,0,0,0,0,0,0,0
"11141",2017-02-01,"sbht","transporte regular","voo doméstico",113,113,226,4540,3840,8380,0,0,0,0
"11142",2017-02-01,"sbht","transporte regular","voo internacional",0,0,0,0,0,0,0,0,0,0
"11143",2017-02-01,"sbht","transporte não regular","voo doméstico",51,52,103,253,233,486,0,0,0,0
"11144",2017-02-01,"sbht","transporte não regular","voo internacional",0,0,0,0,0,0,0,0,0,0
"11145",2017-02-01,"sbiz","transporte regular","voo doméstico",115,115,230,10385,9164,19549,0,0,0,0
"11146",2017-02-01,"sbiz","transporte regular","voo internacional",0,0,0,0,0,0,0,0,0,0
"11147",2017-02-01,"sbiz","transporte não regular","voo doméstico",68,68,136,204,201,405,0,0,0,0
"11148",2017-02-01,"sbiz","transporte não regular","voo internacional",0,0,0,0,0,0,0,0,0,0
"11149",2017-02-01,"sbjc","transporte regular","voo doméstico",0,0,0,0,0,0,0,0,0,0
"11150",2017-02-01,"sbjc","transporte regular","voo internacional",0,0,0,0,0,0,0,0,0,0
"11151",2017-02-01,"sbjc","transporte não regular","voo doméstico",237,243,480,369,225,594,0,0,0,0
"11152",2017-02-01,"sbjc","transporte não regular","voo internacional",1,0,1,0,0,0,0,0,0,0
"11153",2017-02-01,"sbjr","transporte regular","voo doméstico",0,0,0,0,0,0,0,0,0,0
"11154",2017-02-01,"sbjr","transporte regular","voo internacional",0,0,0,0,0,0,0,0,0,0
"11155",2017-02-01,"sbjr","transporte não regular","voo doméstico",2665,2668,5333,10938,8366,19304,0,0,0,0
"11156",2017-02-01,"sbjr","transporte não regular","voo internacional",0,1,1,1,0,1,0,0,0,0
"11157",2017-02-01,"sbjv","transporte regular","voo doméstico",195,193,388,15019,17076,32095,0,0,0,0
"11158",2017-02-01,"sbjv","transporte regular","voo internacional",0,0,0,0,0,0,0,0,0,0
"11159",2017-02-01,"sbjv","transporte não regular","voo doméstico",86,91,177,252,78,330,0,0,0,0
"11160",2017-02-01,"sbjv","transporte não regular","voo internacional",0,0,0,0,0,0,0,0,0,0
"11161",2017-02-01,"sblo","transporte regular","voo doméstico",367,365,732,31903,31354,63257,0,0,0,0
"11162",2017-02-01,"sblo","transporte regular","voo internacional",0,0,0,0,0,0,0,0,0,0
"11163",2017-02-01,"sblo","transporte não regular","voo doméstico",500,506,1006,1168,1119,2287,0,0,0,0
"11164",2017-02-01,"sblo","transporte não regular","voo internacional",2,2,4,0,0,0,0,0,0,0
"11165",2017-02-01,"sbma","transporte regular","voo doméstico",133,132,265,10726,10053,20779,0,0,0,0
"11166",2017-02-01,"sbma","transporte regular","voo internacional",0,0,0,0,0,0,0,0,0,0
"11167",2017-02-01,"sbma","transporte não regular","voo doméstico",150,149,299,552,558,1110,0,0,0,0
"11168",2017-02-01,"sbma","transporte não regular","voo internacional",1,1,2,0,0,0,0,0,0,0
"11169",2017-02-01,"sbmk","transporte regular","voo doméstico",141,142,283,10160,9978,20138,0,0,0,0
"11170",2017-02-01,"sbmk","transporte regular","voo internacional",0,0,0,0,0,0,0,0,0,0
"11171",2017-02-01,"sbmk","transporte não regular","voo doméstico",167,168,335,1167,842,2009,0,0,0,0
"11172",2017-02-01,"sbmk","transporte não regular","voo internacional",0,0,0,0,0,0,0,0,0,0
"11173",2017-02-01,"sbmq","transporte regular","voo doméstico",219,218,437,24174,23806,47980,9598,32340,41938,0
"11174",2017-02-01,"sbmq","transporte regular","voo internacional",0,0,0,0,0,0,0,0,0,0
"11175",2017-02-01,"sbmq","transporte não regular","voo doméstico",156,153,309,342,306,648,0,1800,1800,0
"11176",2017-02-01,"sbmq","transporte não regular","voo internacional",1,1,2,7,0,7,0,0,0,0
"11177",2017-02-01,"sbmt","transporte regular","voo doméstico",0,0,0,0,0,0,0,0,0,0
"11178",2017-02-01,"sbmt","transporte regular","voo internacional",0,0,0,0,0,0,0,0,0,0
"11179",2017-02-01,"sbmt","transporte não regular","voo doméstico",2919,2937,5856,5185,5048,10233,0,0,0,0
"11180",2017-02-01,"sbmt","transporte não regular","voo internacional",0,0,0,0,0,0,0,0,0,0
"11181",2017-02-01,"sbnf","transporte regular","voo doméstico",422,425,847,44463,47075,91538,0,0,0,0
"11182",2017-02-01,"sbnf","transporte regular","voo internacional",0,0,0,0,0,0,0,0,0,0
"11183",2017-02-01,"sbnf","transporte não regular","voo doméstico",278,262,540,2031,2661,4692,0,0,0,0
"11184",2017-02-01,"sbnf","transporte não regular","voo internacional",4,4,8,11,4,15,0,0,0,0
"11185",2017-02-01,"sbpb","transporte regular","voo doméstico",2,4,6,335,186,521,0,0,0,0
"11186",2017-02-01,"sbpb","transporte regular","voo internacional",0,0,0,0,0,0,0,0,0,0
"11187",2017-02-01,"sbpb","transporte não regular","voo doméstico",72,59,131,179,423,602,0,0,0,0
"11188",2017-02-01,"sbpb","transporte não regular","voo internacional",1,1,2,0,0,0,0,0,0,0
"11189",2017-02-01,"sbpj","transporte regular","voo doméstico",229,228,457,21255,20646,41901,0,0,0,0
"11190",2017-02-01,"sbpj","transporte regular","voo internacional",0,0,0,0,0,0,0,0,0,0
"11191",2017-02-01,"sbpj","transporte não regular","voo doméstico",180,184,364,601,398,999,0,0,0,0
"11192",2017-02-01,"sbpj","transporte não regular","voo internacional",3,2,5,0,0,0,0,0,0,0
"11193",2017-02-01,"sbpk","transporte regular","voo doméstico",23,23,46,1083,1279,2362,0,0,0,0
"11194",2017-02-01,"sbpk","transporte regular","voo internacional",0,0,0,0,0,0,0,0,0,0
"11195",2017-02-01,"sbpk","transporte não regular","voo doméstico",26,23,49,40,53,93,0,0,0,0
"11196",2017-02-01,"sbpk","transporte não regular","voo internacional",0,3,3,0,0,0,0,0,0,0
"11197",2017-02-01,"sbpl","transporte regular","voo doméstico",182,182,364,21871,16989,38860,0,0,0,0
"11198",2017-02-01,"sbpl","transporte regular","voo internacional",4,4,8,0,0,0,0,0,0,0
"11199",2017-02-01,"sbpl","transporte não regular","voo doméstico",45,45,90,38,33,71,0,0,0,0
"11200",2017-02-01,"sbpl","transporte não regular","voo internacional",0,0,0,0,0,0,0,0,0,0
"11201",2017-02-01,"sbpp","transporte regular","voo doméstico",0,0,0,0,0,0,0,0,0,0
"11202",2017-02-01,"sbpp","transporte regular","voo internacional",0,0,0,0,0,0,0,0,0,0
"11203",2017-02-01,"sbpp","transporte não regular","voo doméstico",109,109,218,160,142,302,0,0,0,0
"11204",2017-02-01,"sbpp","transporte não regular","voo internacional",4,4,8,2,1,3,0,0,0,0
"11205",2017-02-01,"sbpr","transporte regular","voo doméstico",0,0,0,0,0,0,0,0,0,0
"11206",2017-02-01,"sbpr","transporte regular","voo internacional",0,0,0,0,0,0,0,0,0,0
"11207",2017-02-01,"sbpr","transporte não regular","voo doméstico",741,752,1493,811,780,1591,0,0,0,0
"11208",2017-02-01,"sbpr","transporte não regular","voo internacional",1,1,2,0,0,0,0,0,0,0
"11209",2017-02-01,"sbpv","transporte regular","voo doméstico",343,342,685,31744,35132,66876,0,0,0,0
"11210",2017-02-01,"sbpv","transporte regular","voo internacional",0,0,0,0,0,0,0,0,0,0
"11211",2017-02-01,"sbpv","transporte não regular","voo doméstico",173,176,349,412,7,419,0,0,0,0
"11212",2017-02-01,"sbpv","transporte não regular","voo internacional",0,0,0,0,0,0,0,0,0,0
"11213",2017-02-01,"sbrb","transporte regular","voo doméstico",140,143,283,15284,15948,31232,0,1,1,0
"11214",2017-02-01,"sbrb","transporte regular","voo internacional",0,0,0,0,0,0,0,0,0,0
"11215",2017-02-01,"sbrb","transporte não regular","voo doméstico",128,127,255,509,689,1198,0,0,0,0
"11216",2017-02-01,"sbrb","transporte não regular","voo internacional",0,0,0,0,0,0,0,0,0,0
"11217",2017-02-01,"sbrj","transporte regular","voo doméstico",3332,3351,6683,328154,331688,659842,0,0,0,0
"11218",2017-02-01,"sbrj","transporte regular","voo internacional",0,0,0,0,0,0,0,0,0,0
"11219",2017-02-01,"sbrj","transporte não regular","voo doméstico",559,550,1109,7259,6357,13616,0,0,0,0
"11220",2017-02-01,"sbrj","transporte não regular","voo internacional",4,4,8,3,0,3,0,0,0,0
"11221",2017-02-01,"sbsj","transporte regular","voo doméstico",0,0,0,0,0,0,0,0,0,0
"11222",2017-02-01,"sbsj","transporte regular","voo internacional",0,0,0,0,0,0,0,0,0,0
"11223",2017-02-01,"sbsj","transporte não regular","voo doméstico",429,419,848,585,673,1258,0,0,0,0
"11224",2017-02-01,"sbsj","transporte não regular","voo internacional",2,11,13,45,6,51,0,0,0,0
"11225",2017-02-01,"sbsl","transporte regular","voo doméstico",562,565,1127,55726,56565,112291,0,0,0,0
"11226",2017-02-01,"sbsl","transporte regular","voo internacional",0,0,0,0,0,0,0,0,0,0
"11227",2017-02-01,"sbsl","transporte não regular","voo doméstico",173,170,343,2360,2490,4850,41003,164574,205577,0
"11228",2017-02-01,"sbsl","transporte não regular","voo internacional",0,0,0,0,0,0,0,0,0,0
"11229",2017-02-01,"sbsn","transporte regular","voo doméstico",244,245,489,17919,16489,34408,0,0,0,0
"11230",2017-02-01,"sbsn","transporte regular","voo internacional",0,0,0,0,0,0,0,0,0,0
"11231",2017-02-01,"sbsn","transporte não regular","voo doméstico",158,159,317,566,384,950,1400,2000,3400,0
"11232",2017-02-01,"sbsn","transporte não regular","voo internacional",0,0,0,0,0,0,0,0,0,0
"11233",2017-02-01,"sbsp","transporte regular","voo doméstico",6486,6548,13034,773586,759760,1533346,0,0,0,0
"11234",2017-02-01,"sbsp","transporte regular","voo internacional",0,0,0,0,0,0,0,0,0,0
"11235",2017-02-01,"sbsp","transporte não regular","voo doméstico",1538,1508,3046,9129,6357,15486,0,0,0,0
"11236",2017-02-01,"sbsp","transporte não regular","voo internacional",8,7,15,14,16,30,0,0,0,0
"11237",2017-02-01,"sbte","transporte regular","voo doméstico",419,420,839,40931,36177,77108,17679,64070,81749,202460
"11238",2017-02-01,"sbte","transporte regular","voo internacional",0,0,0,0,0,0,0,0,0,0
"11239",2017-02-01,"sbte","transporte não regular","voo doméstico",129,131,260,805,773,1578,0,0,0,0
"11240",2017-02-01,"sbte","transporte não regular","voo internacional",0,0,0,0,0,0,0,0,0,0
"11241",2017-02-01,"sbtf","transporte regular","voo doméstico",32,32,64,1209,1498,2707,0,0,0,0
"11242",2017-02-01,"sbtf","transporte regular","voo internacional",0,0,0,0,0,0,0,0,0,0
"11243",2017-02-01,"sbtf","transporte não regular","voo doméstico",128,130,258,619,558,1177,2742,2804,5546,7116
"11244",2017-02-01,"sbtf","transporte não regular","voo internacional",0,0,0,0,0,0,0,0,0,0
"11245",2017-02-01,"sbtt","transporte regular","voo doméstico",29,29,58,2369,2661,5030,0,290,290,0
"11246",2017-02-01,"sbtt","transporte regular","voo internacional",0,0,0,0,0,0,0,0,0,0
"11247",2017-02-01,"sbtt","transporte não regular","voo doméstico",62,62,124,254,229,483,519,1327,1846,299
"11248",2017-02-01,"sbtt","transporte não regular","voo internacional",0,0,0,0,0,0,0,0,0,0
"11249",2017-02-01,"sbuf","transporte regular","voo doméstico",7,6,13,179,308,487,0,0,0,0
"11250",2017-02-01,"sbuf","transporte regular","voo internacional",0,0,0,0,0,0,0,0,0,0
"11251",2017-02-01,"sbuf","transporte não regular","voo doméstico",20,22,42,110,103,213,0,0,0,0
"11252",2017-02-01,"sbuf","transporte não regular","voo internacional",0,0,0,0,0,0,0,0,0,0
"11253",2017-02-01,"sbug","transporte regular","voo doméstico",14,14,28,845,778,1623,0,0,0,0
"11254",2017-02-01,"sbug","transporte regular","voo internacional",0,0,0,0,0,0,0,0,0,0
"11255",2017-02-01,"sbug","transporte não regular","voo doméstico",7,7,14,107,91,198,0,0,0,0
"11256",2017-02-01,"sbug","transporte não regular","voo internacional",0,0,0,0,0,0,0,0,0,0
"11257",2017-02-01,"sbul","transporte regular","voo doméstico",401,417,818,37436,36832,74268,0,0,0,0
"11258",2017-02-01,"sbul","transporte regular","voo internacional",0,0,0,0,0,0,0,0,0,0
"11259",2017-02-01,"sbul","transporte não regular","voo doméstico",528,509,1037,3229,3534,6763,0,0,0,0
"11260",2017-02-01,"sbul","transporte não regular","voo internacional",1,1,2,3,3,6,0,0,0,0
"11261",2017-02-01,"sbur","transporte regular","voo doméstico",74,76,150,3186,3061,6247,0,0,0,0
"11262",2017-02-01,"sbur","transporte regular","voo internacional",0,0,0,0,0,0,0,0,0,0
"11263",2017-02-01,"sbur","transporte não regular","voo doméstico",151,152,303,465,571,1036,0,0,0,0
"11264",2017-02-01,"sbur","transporte não regular","voo internacional",0,0,0,0,0,0,0,0,0,0
"11265",2017-01-01,"sbbe","transporte regular","voo doméstico",1338,1338,2676,157574,155480,313054,80910,190630,271540,0
"11266",2017-01-01,"sbbe","transporte regular","voo internacional",52,51,103,6455,5706,12161,0,29,29,0
"11267",2017-01-01,"sbbe","transporte não regular","voo doméstico",441,437,878,8163,8620,16783,0,0,0,0
"11268",2017-01-01,"sbbe","transporte não regular","voo internacional",6,9,15,133,77,210,0,0,0,0
"11269",2017-01-01,"sbbg","transporte regular","voo doméstico",0,0,0,0,0,0,0,0,0,0
"11270",2017-01-01,"sbbg","transporte regular","voo internacional",0,0,0,0,0,0,0,0,0,0
"11271",2017-01-01,"sbbg","transporte não regular","voo doméstico",6,6,12,33,21,54,0,0,0,0
"11272",2017-01-01,"sbbg","transporte não regular","voo internacional",3,3,6,2,12,14,0,0,0,0
"11273",2017-01-01,"sbbh","transporte regular","voo doméstico",49,49,98,1605,1592,3197,0,0,0,0
"11274",2017-01-01,"sbbh","transporte regular","voo internacional",0,0,0,0,0,0,0,0,0,0
"11275",2017-01-01,"sbbh","transporte não regular","voo doméstico",1358,1335,2693,6294,6397,12691,0,0,0,0
"11276",2017-01-01,"sbbh","transporte não regular","voo internacional",0,0,0,0,0,0,0,0,0,0
"11277",2017-01-01,"sbbi","transporte regular","voo doméstico",0,0,0,0,0,0,0,0,0,0
"11278",2017-01-01,"sbbi","transporte regular","voo internacional",0,0,0,0,0,0,0,0,0,0
"11279",2017-01-01,"sbbi","transporte não regular","voo doméstico",714,710,1424,4307,4032,8339,0,0,0,0
"11280",2017-01-01,"sbbi","transporte não regular","voo internacional",0,0,0,0,0,0,0,0,0,0
"11281",2017-01-01,"sbbv","transporte regular","voo doméstico",102,102,204,13106,13359,26465,0,0,0,0
"11282",2017-01-01,"sbbv","transporte regular","voo internacional",0,0,0,0,0,0,0,0,0,0
"11283",2017-01-01,"sbbv","transporte não regular","voo doméstico",79,79,158,767,1147,1914,0,0,0,0
"11284",2017-01-01,"sbbv","transporte não regular","voo internacional",11,9,20,1,0,1,0,0,0,0
"11285",2017-01-01,"sbcg","transporte regular","voo doméstico",504,501,1005,61308,63765,125073,8640,11518,20158,0
"11286",2017-01-01,"sbcg","transporte regular","voo internacional",0,0,0,0,0,0,0,0,0,0
"11287",2017-01-01,"sbcg","transporte não regular","voo doméstico",152,153,305,1023,1023,2046,53350,101698,155048,0
"11288",2017-01-01,"sbcg","transporte não regular","voo internacional",3,3,6,0,6,6,0,0,0,0
"11289",2017-01-01,"sbcj","transporte regular","voo doméstico",62,62,124,5282,6406,11688,0,0,0,0
"11290",2017-01-01,"sbcj","transporte regular","voo internacional",0,0,0,0,0,0,0,0,0,0
"11291",2017-01-01,"sbcj","transporte não regular","voo doméstico",70,70,140,266,133,399,0,0,0,0
"11292",2017-01-01,"sbcj","transporte não regular","voo internacional",0,0,0,0,0,0,0,0,0,0
"11293",2017-01-01,"sbcr","transporte regular","voo doméstico",13,14,27,1365,1266,2631,0,0,0,0
"11294",2017-01-01,"sbcr","transporte regular","voo internacional",0,0,0,0,0,0,0,0,0,0
"11295",2017-01-01,"sbcr","transporte não regular","voo doméstico",21,18,39,51,154,205,0,0,0,0
"11296",2017-01-01,"sbcr","transporte não regular","voo internacional",3,3,6,5,5,10,0,0,0,0
"11297",2017-01-01,"sbct","transporte regular","voo doméstico",2446,2478,4924,271001,267701,538702,147800,32681,180481,316466
"11298",2017-01-01,"sbct","transporte regular","voo internacional",46,46,92,1743,1922,3665,0,4649,4649,0
"11299",2017-01-01,"sbct","transporte não regular","voo doméstico",313,269,582,13569,17303,30872,0,0,0,0
"11300",2017-01-01,"sbct","transporte não regular","voo internacional",14,14,28,18,18,36,0,0,0,0
"11301",2017-01-01,"sbcz","transporte regular","voo doméstico",30,30,60,3722,3086,6808,0,0,0,0
"11302",2017-01-01,"sbcz","transporte regular","voo internacional",0,0,0,0,0,0,0,0,0,0
"11303",2017-01-01,"sbcz","transporte não regular","voo doméstico",111,113,224,358,328,686,0,0,0,0
"11304",2017-01-01,"sbcz","transporte não regular","voo internacional",0,0,0,0,0,0,0,0,0,0
"11305",2017-01-01,"sbeg","transporte regular","voo doméstico",923,925,1848,109681,111224,220905,0,53631,53631,0
"11306",2017-01-01,"sbeg","transporte regular","voo internacional",106,110,216,6223,6800,13023,0,0,0,0
"11307",2017-01-01,"sbeg","transporte não regular","voo doméstico",470,456,926,7023,6680,13703,0,0,0,0
"11308",2017-01-01,"sbeg","transporte não regular","voo internacional",67,72,139,797,601,1398,0,0,0,0
"11309",2017-01-01,"sbfi","transporte regular","voo doméstico",664,665,1329,93434,84105,177539,0,0,0,0
"11310",2017-01-01,"sbfi","transporte regular","voo internacional",22,22,44,2940,2987,5927,0,0,0,0
"11311",2017-01-01,"sbfi","transporte não regular","voo doméstico",287,287,574,24492,21162,45654,0,0,0,0
"11312",2017-01-01,"sbfi","transporte não regular","voo internacional",30,29,59,64,209,273,0,0,0,0
"11313",2017-01-01,"sbgo","transporte regular","voo doméstico",1154,1131,2285,114672,122265,236937,100683,208142,308825,165025
"11314",2017-01-01,"sbgo","transporte regular","voo internacional",0,0,0,0,0,0,0,0,0,0
"11315",2017-01-01,"sbgo","transporte não regular","voo doméstico",1161,1148,2309,17938,16269,34207,0,0,0,0
"11316",2017-01-01,"sbgo","transporte não regular","voo internacional",1,1,2,0,0,0,0,0,0,0
"11317",2017-01-01,"sbht","transporte regular","voo doméstico",138,142,280,5230,5703,10933,0,0,0,0
"11318",2017-01-01,"sbht","transporte regular","voo internacional",0,0,0,0,0,0,0,0,0,0
"11319",2017-01-01,"sbht","transporte não regular","voo doméstico",69,65,134,201,586,787,0,0,0,0
"11320",2017-01-01,"sbht","transporte não regular","voo internacional",0,0,0,0,0,0,0,0,0,0
"11321",2017-01-01,"sbiz","transporte regular","voo doméstico",134,133,267,12113,12081,24194,0,0,0,0
"11322",2017-01-01,"sbiz","transporte regular","voo internacional",0,0,0,0,0,0,0,0,0,0
"11323",2017-01-01,"sbiz","transporte não regular","voo doméstico",108,110,218,326,274,600,0,0,0,0
"11324",2017-01-01,"sbiz","transporte não regular","voo internacional",0,0,0,0,0,0,0,0,0,0
"11325",2017-01-01,"sbjc","transporte regular","voo doméstico",1,2,3,3,3,6,0,0,0,0
"11326",2017-01-01,"sbjc","transporte regular","voo internacional",0,0,0,0,0,0,0,0,0,0
"11327",2017-01-01,"sbjc","transporte não regular","voo doméstico",331,328,659,542,393,935,0,0,0,0
"11328",2017-01-01,"sbjc","transporte não regular","voo internacional",0,0,0,0,0,0,0,0,0,0
"11329",2017-01-01,"sbjr","transporte regular","voo doméstico",0,0,0,0,0,0,0,0,0,0
"11330",2017-01-01,"sbjr","transporte regular","voo internacional",0,0,0,0,0,0,0,0,0,0
"11331",2017-01-01,"sbjr","transporte não regular","voo doméstico",2786,2779,5565,11648,9014,20662,0,0,0,0
"11332",2017-01-01,"sbjr","transporte não regular","voo internacional",2,2,4,3,0,3,0,0,0,0
"11333",2017-01-01,"sbjv","transporte regular","voo doméstico",222,200,422,18660,18792,37452,0,0,0,0
"11334",2017-01-01,"sbjv","transporte regular","voo internacional",0,0,0,0,0,0,0,0,0,0
"11335",2017-01-01,"sbjv","transporte não regular","voo doméstico",93,115,208,1705,111,1816,0,0,0,0
"11336",2017-01-01,"sbjv","transporte não regular","voo internacional",0,0,0,0,0,0,0,0,0,0
"11337",2017-01-01,"sblo","transporte regular","voo doméstico",391,386,777,35524,35251,70775,0,0,0,0
"11338",2017-01-01,"sblo","transporte regular","voo internacional",0,0,0,0,0,0,0,0,0,0
"11339",2017-01-01,"sblo","transporte não regular","voo doméstico",476,483,959,2782,2155,4937,0,0,0,0
"11340",2017-01-01,"sblo","transporte não regular","voo internacional",0,0,0,0,0,0,0,0,0,0
"11341",2017-01-01,"sbma","transporte regular","voo doméstico",142,142,284,12003,12770,24773,0,0,0,0
"11342",2017-01-01,"sbma","transporte regular","voo internacional",0,0,0,0,0,0,0,0,0,0
"11343",2017-01-01,"sbma","transporte não regular","voo doméstico",161,160,321,1607,1610,3217,0,0,0,0
"11344",2017-01-01,"sbma","transporte não regular","voo internacional",1,1,2,0,0,0,0,0,0,0
"11345",2017-01-01,"sbmk","transporte regular","voo doméstico",147,139,286,12819,12224,25043,0,0,0,0
"11346",2017-01-01,"sbmk","transporte regular","voo internacional",0,0,0,0,0,0,0,0,0,0
"11347",2017-01-01,"sbmk","transporte não regular","voo doméstico",173,180,353,1274,299,1573,0,0,0,0
"11348",2017-01-01,"sbmk","transporte não regular","voo internacional",0,0,0,0,0,0,0,0,0,0
"11349",2017-01-01,"sbmq","transporte regular","voo doméstico",249,249,498,28593,28988,57581,10200,34210,44410,0
"11350",2017-01-01,"sbmq","transporte regular","voo internacional",0,0,0,0,0,0,0,0,0,0
"11351",2017-01-01,"sbmq","transporte não regular","voo doméstico",149,149,298,514,262,776,0,0,0,0
"11352",2017-01-01,"sbmq","transporte não regular","voo internacional",2,5,7,0,0,0,0,0,0,0
"11353",2017-01-01,"sbmt","transporte regular","voo doméstico",0,0,0,0,0,0,0,0,0,0
"11354",2017-01-01,"sbmt","transporte regular","voo internacional",0,0,0,0,0,0,0,0,0,0
"11355",2017-01-01,"sbmt","transporte não regular","voo doméstico",2296,2269,4565,4061,4157,8218,0,0,0,0
"11356",2017-01-01,"sbmt","transporte não regular","voo internacional",0,0,0,0,0,0,0,0,0,0
"11357",2017-01-01,"sbnf","transporte regular","voo doméstico",559,563,1122,67072,61164,128236,0,0,0,0
"11358",2017-01-01,"sbnf","transporte regular","voo internacional",0,0,0,0,0,0,0,0,0,0
"11359",2017-01-01,"sbnf","transporte não regular","voo doméstico",277,284,561,2980,3036,6016,0,0,0,0
"11360",2017-01-01,"sbnf","transporte não regular","voo internacional",15,15,30,44,28,72,0,0,0,0
"11361",2017-01-01,"sbpb","transporte regular","voo doméstico",3,3,6,322,302,624,0,0,0,0
"11362",2017-01-01,"sbpb","transporte regular","voo internacional",0,0,0,0,0,0,0,0,0,0
"11363",2017-01-01,"sbpb","transporte não regular","voo doméstico",54,64,118,284,241,525,0,0,0,0
"11364",2017-01-01,"sbpb","transporte não regular","voo internacional",0,0,0,0,0,0,0,0,0,0
"11365",2017-01-01,"sbpj","transporte regular","voo doméstico",259,257,516,24473,26007,50480,0,0,0,0
"11366",2017-01-01,"sbpj","transporte regular","voo internacional",0,0,0,0,0,0,0,0,0,0
"11367",2017-01-01,"sbpj","transporte não regular","voo doméstico",204,203,407,1450,1352,2802,0,0,0,0
"11368",2017-01-01,"sbpj","transporte não regular","voo internacional",1,1,2,0,0,0,0,0,0,0
"11369",2017-01-01,"sbpk","transporte regular","voo doméstico",18,18,36,1098,1147,2245,0,0,0,0
"11370",2017-01-01,"sbpk","transporte regular","voo internacional",0,0,0,0,0,0,0,0,0,0
"11371",2017-01-01,"sbpk","transporte não regular","voo doméstico",42,43,85,104,113,217,0,0,0,0
"11372",2017-01-01,"sbpk","transporte não regular","voo internacional",8,8,16,9,19,28,0,0,0,0
"11373",2017-01-01,"sbpl","transporte regular","voo doméstico",204,203,407,26100,22720,48820,0,0,0,0
"11374",2017-01-01,"sbpl","transporte regular","voo internacional",0,0,0,0,0,0,0,0,0,0
"11375",2017-01-01,"sbpl","transporte não regular","voo doméstico",72,71,143,359,281,640,0,0,0,0
"11376",2017-01-01,"sbpl","transporte não regular","voo internacional",4,4,8,0,0,0,0,0,0,0
"11377",2017-01-01,"sbpp","transporte regular","voo doméstico",0,0,0,0,0,0,0,0,0,0
"11378",2017-01-01,"sbpp","transporte regular","voo internacional",0,0,0,0,0,0,0,0,0,0
"11379",2017-01-01,"sbpp","transporte não regular","voo doméstico",79,77,156,154,148,302,0,0,0,0
"11380",2017-01-01,"sbpp","transporte não regular","voo internacional",4,7,11,8,3,11,0,0,0,0
"11381",2017-01-01,"sbpr","transporte regular","voo doméstico",0,0,0,0,0,0,0,0,0,0
"11382",2017-01-01,"sbpr","transporte regular","voo internacional",0,0,0,0,0,0,0,0,0,0
"11383",2017-01-01,"sbpr","transporte não regular","voo doméstico",745,730,1475,811,854,1665,0,0,0,0
"11384",2017-01-01,"sbpr","transporte não regular","voo internacional",4,5,9,0,0,0,0,0,0,0
"11385",2017-01-01,"sbpv","transporte regular","voo doméstico",428,430,858,44567,44452,89019,0,0,0,0
"11386",2017-01-01,"sbpv","transporte regular","voo internacional",0,0,0,0,0,0,0,0,0,0
"11387",2017-01-01,"sbpv","transporte não regular","voo doméstico",167,164,331,294,275,569,0,0,0,0
"11388",2017-01-01,"sbpv","transporte não regular","voo internacional",1,1,2,0,0,0,0,0,0,0
"11389",2017-01-01,"sbrb","transporte regular","voo doméstico",168,166,334,17916,18323,36239,0,0,0,210
"11390",2017-01-01,"sbrb","transporte regular","voo internacional",0,0,0,0,0,0,0,0,0,0
"11391",2017-01-01,"sbrb","transporte não regular","voo doméstico",115,115,230,834,636,1470,0,0,0,0
"11392",2017-01-01,"sbrb","transporte não regular","voo internacional",2,0,2,0,0,0,0,0,0,0
"11393",2017-01-01,"sbrj","transporte regular","voo doméstico",3615,3636,7251,414142,375292,789434,0,0,0,0
"11394",2017-01-01,"sbrj","transporte regular","voo internacional",0,0,0,0,0,0,0,0,0,0
"11395",2017-01-01,"sbrj","transporte não regular","voo doméstico",630,609,1239,18702,19910,38612,0,0,0,0
"11396",2017-01-01,"sbrj","transporte não regular","voo internacional",0,0,0,0,0,0,0,0,0,0
"11397",2017-01-01,"sbsj","transporte regular","voo doméstico",0,0,0,0,0,0,0,0,0,0
"11398",2017-01-01,"sbsj","transporte regular","voo internacional",0,0,0,0,0,0,0,0,0,0
"11399",2017-01-01,"sbsj","transporte não regular","voo doméstico",289,274,563,483,544,1027,0,0,0,0
"11400",2017-01-01,"sbsj","transporte não regular","voo internacional",2,9,11,21,4,25,0,0,0,0
"11401",2017-01-01,"sbsl","transporte regular","voo doméstico",629,658,1287,71408,69212,140620,0,0,0,0
"11402",2017-01-01,"sbsl","transporte regular","voo internacional",0,0,0,0,0,0,0,0,0,0
"11403",2017-01-01,"sbsl","transporte não regular","voo doméstico",314,283,597,8857,13144,22001,57940,153081,211021,0
"11404",2017-01-01,"sbsl","transporte não regular","voo internacional",4,3,7,0,0,0,0,0,0,0
"11405",2017-01-01,"sbsn","transporte regular","voo doméstico",279,280,559,25519,20315,45834,0,0,0,0
"11406",2017-01-01,"sbsn","transporte regular","voo internacional",0,0,0,0,0,0,0,0,0,0
"11407",2017-01-01,"sbsn","transporte não regular","voo doméstico",172,172,344,365,371,736,960,1100,2060,0
"11408",2017-01-01,"sbsn","transporte não regular","voo internacional",0,0,0,0,0,0,0,0,0,0
"11409",2017-01-01,"sbsp","transporte regular","voo doméstico",7241,7302,14543,905489,955763,1861252,0,0,0,0
"11410",2017-01-01,"sbsp","transporte regular","voo internacional",0,0,0,0,0,0,0,0,0,0
"11411",2017-01-01,"sbsp","transporte não regular","voo doméstico",1604,1513,3117,30919,35115,66034,0,0,0,0
"11412",2017-01-01,"sbsp","transporte não regular","voo internacional",4,4,8,16,8,24,0,0,0,0
"11413",2017-01-01,"sbte","transporte regular","voo doméstico",528,525,1053,54219,49180,103399,20273,62348,82621,203672
"11414",2017-01-01,"sbte","transporte regular","voo internacional",0,0,0,0,0,0,0,0,0,0
"11415",2017-01-01,"sbte","transporte não regular","voo doméstico",203,199,402,2265,2397,4662,0,0,0,0
"11416",2017-01-01,"sbte","transporte não regular","voo internacional",0,0,0,0,0,0,0,0,0,0
"11417",2017-01-01,"sbtf","transporte regular","voo doméstico",35,35,70,1458,1479,2937,0,0,0,0
"11418",2017-01-01,"sbtf","transporte regular","voo internacional",0,0,0,0,0,0,0,0,0,0
"11419",2017-01-01,"sbtf","transporte não regular","voo doméstico",146,145,291,924,786,1710,1627,1698,3325,11935
"11420",2017-01-01,"sbtf","transporte não regular","voo internacional",0,0,0,0,0,0,0,0,0,0
"11421",2017-01-01,"sbtt","transporte regular","voo doméstico",31,31,62,2746,3058,5804,0,0,0,0
"11422",2017-01-01,"sbtt","transporte regular","voo internacional",0,0,0,0,0,0,0,0,0,0
"11423",2017-01-01,"sbtt","transporte não regular","voo doméstico",61,61,122,196,235,431,1147,1631,2778,371
"11424",2017-01-01,"sbtt","transporte não regular","voo internacional",0,0,0,0,0,0,0,0,0,0
"11425",2017-01-01,"sbuf","transporte regular","voo doméstico",9,9,18,585,558,1143,0,0,0,0
"11426",2017-01-01,"sbuf","transporte regular","voo internacional",0,0,0,0,0,0,0,0,0,0
"11427",2017-01-01,"sbuf","transporte não regular","voo doméstico",33,34,67,97,98,195,0,0,0,0
"11428",2017-01-01,"sbuf","transporte não regular","voo internacional",0,0,0,0,0,0,0,0,0,0
"11429",2017-01-01,"sbug","transporte regular","voo doméstico",9,9,18,581,512,1093,0,0,0,0
"11430",2017-01-01,"sbug","transporte regular","voo internacional",0,0,0,0,0,0,0,0,0,0
"11431",2017-01-01,"sbug","transporte não regular","voo doméstico",20,20,40,582,555,1137,0,0,0,0
"11432",2017-01-01,"sbug","transporte não regular","voo internacional",0,0,0,0,0,0,0,0,0,0
"11433",2017-01-01,"sbul","transporte regular","voo doméstico",416,407,823,40276,40364,80640,0,0,0,0
"11434",2017-01-01,"sbul","transporte regular","voo internacional",0,0,0,0,0,0,0,0,0,0
"11435",2017-01-01,"sbul","transporte não regular","voo doméstico",397,412,809,3852,3484,7336,0,0,0,0
"11436",2017-01-01,"sbul","transporte não regular","voo internacional",0,0,0,0,0,0,0,0,0,0
"11437",2017-01-01,"sbur","transporte regular","voo doméstico",56,54,110,2703,2962,5665,0,0,0,0
"11438",2017-01-01,"sbur","transporte regular","voo internacional",0,0,0,0,0,0,0,0,0,0
"11439",2017-01-01,"sbur","transporte não regular","voo doméstico",85,91,176,415,277,692,0,0,0,0
"11440",2017-01-01,"sbur","transporte não regular","voo internacional",0,0,0,0,0,0,0,0,0,0
"11441",2017-07-01,"sbbe","transporte regular","voo doméstico",1111,1111,2222,142540,140153,282693,87693,317605,405298,0
"11442",2017-07-01,"sbbe","transporte regular","voo internacional",47,47,94,5904,6293,12197,6,0,6,0
"11443",2017-07-01,"sbbe","transporte não regular","voo doméstico",494,501,995,6119,5874,11993,0,0,0,0
"11444",2017-07-01,"sbbe","transporte não regular","voo internacional",14,11,25,657,779,1436,0,0,0,0
"11445",2017-07-01,"sbbg","transporte regular","voo doméstico",0,0,0,0,0,0,0,0,0,0
"11446",2017-07-01,"sbbg","transporte regular","voo internacional",0,0,0,0,0,0,0,0,0,0
"11447",2017-07-01,"sbbg","transporte não regular","voo doméstico",9,9,18,32,37,69,0,0,0,0
"11448",2017-07-01,"sbbg","transporte não regular","voo internacional",3,3,6,17,15,32,0,0,0,0
"11449",2017-07-01,"sbbh","transporte regular","voo doméstico",52,52,104,2197,2111,4308,0,0,0,0
"11450",2017-07-01,"sbbh","transporte regular","voo internacional",0,0,0,0,0,0,0,0,0,0
"11451",2017-07-01,"sbbh","transporte não regular","voo doméstico",1702,1692,3394,7386,7424,14810,0,0,0,0
"11452",2017-07-01,"sbbh","transporte não regular","voo internacional",4,4,8,23,23,46,0,0,0,0
"11453",2017-07-01,"sbbi","transporte regular","voo doméstico",0,0,0,0,0,0,0,0,0,0
"11454",2017-07-01,"sbbi","transporte regular","voo internacional",0,0,0,0,0,0,0,0,0,0
"11455",2017-07-01,"sbbi","transporte não regular","voo doméstico",1175,1176,2351,2799,2780,5579,0,0,0,0
"11456",2017-07-01,"sbbi","transporte não regular","voo internacional",1,0,1,0,0,0,0,0,0,0
"11457",2017-07-01,"sbbv","transporte regular","voo doméstico",92,92,184,12733,12207,24940,0,0,0,0
"11458",2017-07-01,"sbbv","transporte regular","voo internacional",0,0,0,0,0,0,0,0,0,0
"11459",2017-07-01,"sbbv","transporte não regular","voo doméstico",105,102,207,281,218,499,0,0,0,0
"11460",2017-07-01,"sbbv","transporte não regular","voo internacional",17,20,37,24,14,38,0,0,0,0
"11461",2017-07-01,"sbcg","transporte regular","voo doméstico",533,537,1070,67713,64990,132703,0,0,0,0
"11462",2017-07-01,"sbcg","transporte regular","voo internacional",0,0,0,0,0,0,0,0,0,0
"11463",2017-07-01,"sbcg","transporte não regular","voo doméstico",338,338,676,1621,1790,3411,82244,104592,186836,0
"11464",2017-07-01,"sbcg","transporte não regular","voo internacional",10,9,19,0,0,0,0,0,0,0
"11465",2017-07-01,"sbcj","transporte regular","voo doméstico",81,81,162,5765,5734,11499,0,0,0,0
"11466",2017-07-01,"sbcj","transporte regular","voo internacional",0,0,0,0,0,0,0,0,0,0
"11467",2017-07-01,"sbcj","transporte não regular","voo doméstico",79,78,157,272,96,368,0,0,0,0
"11468",2017-07-01,"sbcj","transporte não regular","voo internacional",0,0,0,0,0,0,0,0,0,0
"11469",2017-07-01,"sbcr","transporte regular","voo doméstico",18,17,35,1067,1126,2193,0,0,0,0
"11470",2017-07-01,"sbcr","transporte regular","voo internacional",0,0,0,0,0,0,0,0,0,0
"11471",2017-07-01,"sbcr","transporte não regular","voo doméstico",43,46,89,89,76,165,0,0,0,0
"11472",2017-07-01,"sbcr","transporte não regular","voo internacional",3,3,6,8,7,15,0,0,0,0
"11473",2017-07-01,"sbct","transporte regular","voo doméstico",2239,2238,4477,279476,272328,551804,88813,42220,131033,207545
"11474",2017-07-01,"sbct","transporte regular","voo internacional",62,62,124,2736,2700,5436,0,60575,60575,0
"11475",2017-07-01,"sbct","transporte não regular","voo doméstico",544,547,1091,31867,32154,64021,0,0,0,0
"11476",2017-07-01,"sbct","transporte não regular","voo internacional",12,12,24,119,43,162,0,0,0,0
"11477",2017-07-01,"sbcz","transporte regular","voo doméstico",43,43,86,3772,3820,7592,0,0,0,0
"11478",2017-07-01,"sbcz","transporte regular","voo internacional",0,0,0,0,0,0,0,0,0,0
"11479",2017-07-01,"sbcz","transporte não regular","voo doméstico",213,212,425,892,868,1760,0,0,0,0
"11480",2017-07-01,"sbcz","transporte não regular","voo internacional",0,0,0,0,0,0,0,0,0,0
"11481",2017-07-01,"sbeg","transporte regular","voo doméstico",904,892,1796,111212,108831,220043,0,601,601,0
"11482",2017-07-01,"sbeg","transporte regular","voo internacional",100,110,210,5155,4957,10112,0,0,0,0
"11483",2017-07-01,"sbeg","transporte não regular","voo doméstico",596,587,1183,8037,7946,15983,0,821,821,0
"11484",2017-07-01,"sbeg","transporte não regular","voo internacional",68,77,145,1050,1027,2077,0,0,0,0
"11485",2017-07-01,"sbfi","transporte regular","voo doméstico",583,583,1166,85347,81681,167028,0,0,0,0
"11486",2017-07-01,"sbfi","transporte regular","voo internacional",22,22,44,2907,2487,5394,0,0,0,0
"11487",2017-07-01,"sbfi","transporte não regular","voo doméstico",325,329,654,14914,15509,30423,0,0,0,0
"11488",2017-07-01,"sbfi","transporte não regular","voo internacional",40,39,79,108,93,201,0,0,0,0
"11489",2017-07-01,"sbgo","transporte regular","voo doméstico",1219,1208,2427,138500,135115,273615,111339,157288,268627,141367
"11490",2017-07-01,"sbgo","transporte regular","voo internacional",0,0,0,0,0,0,0,0,0,0
"11491",2017-07-01,"sbgo","transporte não regular","voo doméstico",1449,1456,2905,13012,11277,24289,0,0,0,0
"11492",2017-07-01,"sbgo","transporte não regular","voo internacional",0,0,0,0,0,0,0,0,0,0
"11493",2017-07-01,"sbht","transporte regular","voo doméstico",128,128,256,4634,4651,9285,0,0,0,0
"11494",2017-07-01,"sbht","transporte regular","voo internacional",0,0,0,0,0,0,0,0,0,0
"11495",2017-07-01,"sbht","transporte não regular","voo doméstico",60,61,121,99,89,188,0,0,0,0
"11496",2017-07-01,"sbht","transporte não regular","voo internacional",0,0,0,0,0,0,0,0,0,0
"11497",2017-07-01,"sbiz","transporte regular","voo doméstico",102,102,204,13853,13826,27679,0,0,0,0
"11498",2017-07-01,"sbiz","transporte regular","voo internacional",0,0,0,0,0,0,0,0,0,0
"11499",2017-07-01,"sbiz","transporte não regular","voo doméstico",134,132,266,374,280,654,0,0,0,0
"11500",2017-07-01,"sbiz","transporte não regular","voo internacional",0,1,1,0,0,0,0,0,0,0
"11501",2017-07-01,"sbjc","transporte regular","voo doméstico",0,0,0,0,0,0,0,0,0,0
"11502",2017-07-01,"sbjc","transporte regular","voo internacional",0,0,0,0,0,0,0,0,0,0
"11503",2017-07-01,"sbjc","transporte não regular","voo doméstico",342,343,685,633,385,1018,0,0,0,0
"11504",2017-07-01,"sbjc","transporte não regular","voo internacional",9,7,16,0,0,0,0,0,0,0
"11505",2017-07-01,"sbjr","transporte regular","voo doméstico",0,0,0,0,0,0,0,0,0,0
"11506",2017-07-01,"sbjr","transporte regular","voo internacional",0,0,0,0,0,0,0,0,0,0
"11507",2017-07-01,"sbjr","transporte não regular","voo doméstico",2385,2381,4766,9906,6644,16550,0,0,0,0
"11508",2017-07-01,"sbjr","transporte não regular","voo internacional",0,0,0,0,0,0,0,0,0,0
"11509",2017-07-01,"sbjv","transporte regular","voo doméstico",199,202,401,19247,18968,38215,0,0,0,0
"11510",2017-07-01,"sbjv","transporte regular","voo internacional",0,0,0,0,0,0,0,0,0,0
"11511",2017-07-01,"sbjv","transporte não regular","voo doméstico",131,127,258,804,920,1724,0,0,0,0
"11512",2017-07-01,"sbjv","transporte não regular","voo internacional",0,0,0,0,0,0,0,0,0,0
"11513",2017-07-01,"sblo","transporte regular","voo doméstico",238,237,475,27826,27612,55438,0,0,0,0
"11514",2017-07-01,"sblo","transporte regular","voo internacional",0,0,0,0,0,0,0,0,0,0
"11515",2017-07-01,"sblo","transporte não regular","voo doméstico",742,729,1471,7825,7526,15351,0,0,0,0
"11516",2017-07-01,"sblo","transporte não regular","voo internacional",2,2,4,0,0,0,0,0,0,0
"11517",2017-07-01,"sbma","transporte regular","voo doméstico",130,130,260,11768,11539,23307,0,0,0,0
"11518",2017-07-01,"sbma","transporte regular","voo internacional",0,0,0,0,0,0,0,0,0,0
"11519",2017-07-01,"sbma","transporte não regular","voo doméstico",225,223,448,771,765,1536,0,0,0,0
"11520",2017-07-01,"sbma","transporte não regular","voo internacional",1,1,2,0,0,0,0,0,0,0
"11521",2017-07-01,"sbmk","transporte regular","voo doméstico",122,123,245,9689,9592,19281,0,0,0,0
"11522",2017-07-01,"sbmk","transporte regular","voo internacional",0,0,0,0,0,0,0,0,0,0
"11523",2017-07-01,"sbmk","transporte não regular","voo doméstico",315,317,632,3677,3187,6864,0,0,0,0
"11524",2017-07-01,"sbmk","transporte não regular","voo internacional",0,0,0,0,0,0,0,0,0,0
"11525",2017-07-01,"sbmq","transporte regular","voo doméstico",246,246,492,27805,26519,54324,17500,37245,54745,0
"11526",2017-07-01,"sbmq","transporte regular","voo internacional",0,0,0,0,0,0,0,0,0,0
"11527",2017-07-01,"sbmq","transporte não regular","voo doméstico",157,157,314,301,200,501,0,0,0,0
"11528",2017-07-01,"sbmq","transporte não regular","voo internacional",4,3,7,0,0,0,0,0,0,0
"11529",2017-07-01,"sbmt","transporte regular","voo doméstico",0,0,0,0,0,0,0,0,0,0
"11530",2017-07-01,"sbmt","transporte regular","voo internacional",0,0,0,0,0,0,0,0,0,0
"11531",2017-07-01,"sbmt","transporte não regular","voo doméstico",3116,3099,6215,5088,5090,10178,0,0,0,0
"11532",2017-07-01,"sbmt","transporte não regular","voo internacional",0,0,0,0,0,0,0,0,0,0
"11533",2017-07-01,"sbnf","transporte regular","voo doméstico",596,597,1193,71265,71071,142336,0,1608,1608,0
"11534",2017-07-01,"sbnf","transporte regular","voo internacional",0,0,0,0,0,0,0,0,0,0
"11535",2017-07-01,"sbnf","transporte não regular","voo doméstico",293,291,584,1406,1570,2976,0,0,0,0
"11536",2017-07-01,"sbnf","transporte não regular","voo internacional",1,1,2,0,0,0,0,0,0,0
"11537",2017-07-01,"sbpb","transporte regular","voo doméstico",5,5,10,552,532,1084,0,0,0,0
"11538",2017-07-01,"sbpb","transporte regular","voo internacional",0,0,0,0,0,0,0,0,0,0
"11539",2017-07-01,"sbpb","transporte não regular","voo doméstico",85,89,174,212,211,423,0,0,0,0
"11540",2017-07-01,"sbpb","transporte não regular","voo internacional",0,0,0,0,0,0,0,0,0,0
"11541",2017-07-01,"sbpj","transporte regular","voo doméstico",292,294,586,31181,31761,62942,0,0,0,0
"11542",2017-07-01,"sbpj","transporte regular","voo internacional",0,0,0,0,0,0,0,0,0,0
"11543",2017-07-01,"sbpj","transporte não regular","voo doméstico",285,283,568,475,499,974,0,0,0,0
"11544",2017-07-01,"sbpj","transporte não regular","voo internacional",3,3,6,0,0,0,0,0,0,0
"11545",2017-07-01,"sbpk","transporte regular","voo doméstico",26,26,52,1254,1281,2535,0,0,0,0
"11546",2017-07-01,"sbpk","transporte regular","voo internacional",0,0,0,0,0,0,0,0,0,0
"11547",2017-07-01,"sbpk","transporte não regular","voo doméstico",34,36,70,68,66,134,0,0,0,0
"11548",2017-07-01,"sbpk","transporte não regular","voo internacional",2,0,2,0,6,6,0,0,0,0
"11549",2017-07-01,"sbpl","transporte regular","voo doméstico",170,172,342,22486,20057,42543,0,0,0,0
"11550",2017-07-01,"sbpl","transporte regular","voo internacional",4,4,8,0,0,0,0,0,0,0
"11551",2017-07-01,"sbpl","transporte não regular","voo doméstico",103,103,206,1115,1298,2413,0,0,0,0
"11552",2017-07-01,"sbpl","transporte não regular","voo internacional",0,0,0,0,0,0,0,0,0,0
"11553",2017-07-01,"sbpp","transporte regular","voo doméstico",0,0,0,0,0,0,0,0,0,0
"11554",2017-07-01,"sbpp","transporte regular","voo internacional",0,0,0,0,0,0,0,0,0,0
"11555",2017-07-01,"sbpp","transporte não regular","voo doméstico",138,140,278,228,214,442,0,0,0,0
"11556",2017-07-01,"sbpp","transporte não regular","voo internacional",10,12,22,18,15,33,0,0,0,0
"11557",2017-07-01,"sbpr","transporte regular","voo doméstico",1,1,2,0,0,0,0,0,0,0
"11558",2017-07-01,"sbpr","transporte regular","voo internacional",0,0,0,0,0,0,0,0,0,0
"11559",2017-07-01,"sbpr","transporte não regular","voo doméstico",1176,1176,2352,1348,1278,2626,0,0,0,0
"11560",2017-07-01,"sbpr","transporte não regular","voo internacional",6,6,12,0,0,0,0,0,0,0
"11561",2017-07-01,"sbpv","transporte regular","voo doméstico",359,360,719,36002,36018,72020,0,0,0,0
"11562",2017-07-01,"sbpv","transporte regular","voo internacional",0,0,0,0,0,0,0,0,0,0
"11563",2017-07-01,"sbpv","transporte não regular","voo doméstico",235,235,470,102,0,102,0,0,0,0
"11564",2017-07-01,"sbpv","transporte não regular","voo internacional",1,1,2,0,0,0,0,0,0,0
"11565",2017-07-01,"sbrb","transporte regular","voo doméstico",127,128,255,15317,14595,29912,0,252,252,863
"11566",2017-07-01,"sbrb","transporte regular","voo internacional",0,0,0,0,0,0,0,0,0,0
"11567",2017-07-01,"sbrb","transporte não regular","voo doméstico",172,171,343,633,555,1188,0,0,0,0
"11568",2017-07-01,"sbrb","transporte não regular","voo internacional",1,1,2,0,0,0,0,0,0,0
"11569",2017-07-01,"sbrj","transporte regular","voo doméstico",3660,3681,7341,396417,387713,784130,0,0,0,0
"11570",2017-07-01,"sbrj","transporte regular","voo internacional",0,0,0,0,0,0,0,0,0,0
"11571",2017-07-01,"sbrj","transporte não regular","voo doméstico",594,575,1169,14284,14604,28888,0,0,0,0
"11572",2017-07-01,"sbrj","transporte não regular","voo internacional",0,0,0,0,0,0,0,0,0,0
"11573",2017-07-01,"sbsj","transporte regular","voo doméstico",0,0,0,0,0,0,0,0,0,0
"11574",2017-07-01,"sbsj","transporte regular","voo internacional",0,0,0,0,0,0,0,0,0,0
"11575",2017-07-01,"sbsj","transporte não regular","voo doméstico",494,481,975,1752,1635,3387,0,0,0,0
"11576",2017-07-01,"sbsj","transporte não regular","voo internacional",0,11,11,28,0,28,0,0,0,0
"11577",2017-07-01,"sbsl","transporte regular","voo doméstico",645,668,1313,71315,77545,148860,0,0,0,0
"11578",2017-07-01,"sbsl","transporte regular","voo internacional",0,0,0,0,0,0,0,0,0,0
"11579",2017-07-01,"sbsl","transporte não regular","voo doméstico",301,277,578,4762,6912,11674,56298,150794,207092,0
"11580",2017-07-01,"sbsl","transporte não regular","voo internacional",2,4,6,1,4,5,0,0,0,0
"11581",2017-07-01,"sbsn","transporte regular","voo doméstico",210,210,420,21032,20035,41067,0,0,0,0
"11582",2017-07-01,"sbsn","transporte regular","voo internacional",0,0,0,0,0,0,0,0,0,0
"11583",2017-07-01,"sbsn","transporte não regular","voo doméstico",208,207,415,331,173,504,0,0,0,0
"11584",2017-07-01,"sbsn","transporte não regular","voo internacional",1,1,2,0,0,0,0,0,0,0
"11585",2017-07-01,"sbsp","transporte regular","voo doméstico",7297,7331,14628,945948,952952,1898900,0,0,0,0
"11586",2017-07-01,"sbsp","transporte regular","voo internacional",0,0,0,0,0,0,0,0,0,0
"11587",2017-07-01,"sbsp","transporte não regular","voo doméstico",1856,1796,3652,43396,42450,85846,0,0,0,0
"11588",2017-07-01,"sbsp","transporte não regular","voo internacional",2,2,4,4,4,8,0,0,0,0
"11589",2017-07-01,"sbte","transporte regular","voo doméstico",498,500,998,53063,54152,107215,25560,70749,96309,199124
"11590",2017-07-01,"sbte","transporte regular","voo internacional",0,0,0,0,0,0,0,0,0,0
"11591",2017-07-01,"sbte","transporte não regular","voo doméstico",250,242,492,2092,2435,4527,0,0,0,0
"11592",2017-07-01,"sbte","transporte não regular","voo internacional",0,0,0,0,0,0,0,0,0,0
"11593",2017-07-01,"sbtf","transporte regular","voo doméstico",31,31,62,1466,1594,3060,0,0,0,0
"11594",2017-07-01,"sbtf","transporte regular","voo internacional",0,0,0,0,0,0,0,0,0,0
"11595",2017-07-01,"sbtf","transporte não regular","voo doméstico",160,158,318,384,408,792,2103,2901,5004,17596
"11596",2017-07-01,"sbtf","transporte não regular","voo internacional",0,0,0,0,0,0,0,0,0,0
"11597",2017-07-01,"sbtt","transporte regular","voo doméstico",31,31,62,2449,3119,5568,0,170,170,0
"11598",2017-07-01,"sbtt","transporte regular","voo internacional",0,0,0,0,0,0,0,0,0,0
"11599",2017-07-01,"sbtt","transporte não regular","voo doméstico",88,87,175,396,380,776,1061,2184,3245,613
"11600",2017-07-01,"sbtt","transporte não regular","voo internacional",0,0,0,0,0,0,0,0,0,0
"11601",2017-07-01,"sbuf","transporte regular","voo doméstico",9,9,18,537,461,998,0,0,0,0
"11602",2017-07-01,"sbuf","transporte regular","voo internacional",0,0,0,0,0,0,0,0,0,0
"11603",2017-07-01,"sbuf","transporte não regular","voo doméstico",27,27,54,53,78,131,0,0,0,0
"11604",2017-07-01,"sbuf","transporte não regular","voo internacional",0,0,0,0,0,0,0,0,0,0
"11605",2017-07-01,"sbug","transporte regular","voo doméstico",14,14,28,732,718,1450,0,0,0,0
"11606",2017-07-01,"sbug","transporte regular","voo internacional",0,0,0,0,0,0,0,0,0,0
"11607",2017-07-01,"sbug","transporte não regular","voo doméstico",8,9,17,18,16,34,0,0,0,0
"11608",2017-07-01,"sbug","transporte não regular","voo internacional",0,0,0,0,0,0,0,0,0,0
"11609",2017-07-01,"sbul","transporte regular","voo doméstico",406,393,799,41794,41873,83667,0,0,0,0
"11610",2017-07-01,"sbul","transporte regular","voo internacional",0,0,0,0,0,0,0,0,0,0
"11611",2017-07-01,"sbul","transporte não regular","voo doméstico",675,694,1369,5263,3794,9057,0,0,0,0
"11612",2017-07-01,"sbul","transporte não regular","voo internacional",7,7,14,28,27,55,0,0,0,0
"11613",2017-07-01,"sbur","transporte regular","voo doméstico",35,35,70,1955,1764,3719,0,0,0,0
"11614",2017-07-01,"sbur","transporte regular","voo internacional",0,0,0,0,0,0,0,0,0,0
"11615",2017-07-01,"sbur","transporte não regular","voo doméstico",200,204,404,1173,1215,2388,0,0,0,0
"11616",2017-07-01,"sbur","transporte não regular","voo internacional",0,0,0,0,0,0,0,0,0,0
"11617",2017-06-01,"sbbe","transporte regular","voo doméstico",1026,1023,2049,118512,116790,235302,91643,263261,354904,0
"11618",2017-06-01,"sbbe","transporte regular","voo internacional",36,39,75,4853,4527,9380,0,0,0,0
"11619",2017-06-01,"sbbe","transporte não regular","voo doméstico",415,407,822,2110,2521,4631,0,18032,18032,0
"11620",2017-06-01,"sbbe","transporte não regular","voo internacional",8,9,17,12,6,18,0,0,0,0
"11621",2017-06-01,"sbbg","transporte regular","voo doméstico",0,0,0,0,0,0,0,0,0,0
"11622",2017-06-01,"sbbg","transporte regular","voo internacional",0,0,0,0,0,0,0,0,0,0
"11623",2017-06-01,"sbbg","transporte não regular","voo doméstico",18,19,37,89,72,161,0,0,0,0
"11624",2017-06-01,"sbbg","transporte não regular","voo internacional",4,3,7,12,12,24,0,0,0,0
"11625",2017-06-01,"sbbh","transporte regular","voo doméstico",49,49,98,1837,1831,3668,0,0,0,0
"11626",2017-06-01,"sbbh","transporte regular","voo internacional",0,0,0,0,0,0,0,0,0,0
"11627",2017-06-01,"sbbh","transporte não regular","voo doméstico",1602,1596,3198,7446,7543,14989,0,0,0,0
"11628",2017-06-01,"sbbh","transporte não regular","voo internacional",2,2,4,8,8,16,0,0,0,0
"11629",2017-06-01,"sbbi","transporte regular","voo doméstico",0,0,0,0,0,0,0,0,0,0
"11630",2017-06-01,"sbbi","transporte regular","voo internacional",0,0,0,0,0,0,0,0,0,0
"11631",2017-06-01,"sbbi","transporte não regular","voo doméstico",1041,1030,2071,481,5,486,0,0,0,0
"11632",2017-06-01,"sbbi","transporte não regular","voo internacional",1,1,2,0,0,0,0,0,0,0
"11633",2017-06-01,"sbbv","transporte regular","voo doméstico",85,85,170,11946,10517,22463,0,0,0,0
"11634",2017-06-01,"sbbv","transporte regular","voo internacional",0,0,0,0,0,0,0,0,0,0
"11635",2017-06-01,"sbbv","transporte não regular","voo doméstico",79,80,159,309,227,536,0,0,0,0
"11636",2017-06-01,"sbbv","transporte não regular","voo internacional",9,7,16,0,2,2,0,0,0,0
"11637",2017-06-01,"sbcg","transporte regular","voo doméstico",530,532,1062,59322,57145,116467,0,1164,1164,0
"11638",2017-06-01,"sbcg","transporte regular","voo internacional",0,0,0,0,0,0,0,0,0,0
"11639",2017-06-01,"sbcg","transporte não regular","voo doméstico",273,266,539,833,1207,2040,74683,88557,163240,0
"11640",2017-06-01,"sbcg","transporte não regular","voo internacional",11,12,23,3,2,5,0,0,0,0
"11641",2017-06-01,"sbcj","transporte regular","voo doméstico",80,80,160,5403,5016,10419,0,0,0,0
"11642",2017-06-01,"sbcj","transporte regular","voo internacional",0,0,0,0,0,0,0,0,0,0
"11643",2017-06-01,"sbcj","transporte não regular","voo doméstico",71,73,144,298,183,481,0,0,0,0
"11644",2017-06-01,"sbcj","transporte não regular","voo internacional",0,0,0,0,0,0,0,0,0,0
"11645",2017-06-01,"sbcr","transporte regular","voo doméstico",17,17,34,1079,1024,2103,0,0,0,0
"11646",2017-06-01,"sbcr","transporte regular","voo internacional",0,0,0,0,0,0,0,0,0,0
"11647",2017-06-01,"sbcr","transporte não regular","voo doméstico",41,41,82,106,91,197,0,0,0,0
"11648",2017-06-01,"sbcr","transporte não regular","voo internacional",3,2,5,3,4,7,0,0,0,0
"11649",2017-06-01,"sbct","transporte regular","voo doméstico",2142,2158,4300,246798,242878,489676,122217,46726,168943,288984
"11650",2017-06-01,"sbct","transporte regular","voo internacional",59,57,116,2098,1932,4030,0,75605,75605,0
"11651",2017-06-01,"sbct","transporte não regular","voo doméstico",400,387,787,12062,11358,23420,0,0,0,0
"11652",2017-06-01,"sbct","transporte não regular","voo internacional",15,18,33,65,56,121,0,0,0,0
"11653",2017-06-01,"sbcz","transporte regular","voo doméstico",41,41,82,3381,3337,6718,0,0,0,0
"11654",2017-06-01,"sbcz","transporte regular","voo internacional",0,0,0,0,0,0,0,0,0,0
"11655",2017-06-01,"sbcz","transporte não regular","voo doméstico",175,176,351,649,599,1248,0,0,0,0
"11656",2017-06-01,"sbcz","transporte não regular","voo internacional",0,0,0,0,0,0,0,0,0,0
"11657",2017-06-01,"sbeg","transporte regular","voo doméstico",816,800,1616,95599,89567,185166,0,0,0,0
"11658",2017-06-01,"sbeg","transporte regular","voo internacional",97,100,197,5289,3589,8878,0,0,0,0
"11659",2017-06-01,"sbeg","transporte não regular","voo doméstico",458,462,920,8898,5707,14605,0,0,0,0
"11660",2017-06-01,"sbeg","transporte não regular","voo internacional",81,82,163,578,776,1354,0,0,0,0
"11661",2017-06-01,"sbfi","transporte regular","voo doméstico",510,508,1018,66332,65636,131968,0,0,0,0
"11662",2017-06-01,"sbfi","transporte regular","voo internacional",22,22,44,2618,2265,4883,0,0,0,0
"11663",2017-06-01,"sbfi","transporte não regular","voo doméstico",292,297,589,8858,9674,18532,0,0,0,0
"11664",2017-06-01,"sbfi","transporte não regular","voo internacional",42,39,81,75,40,115,0,0,0,0
"11665",2017-06-01,"sbgo","transporte regular","voo doméstico",1203,1203,2406,123586,123220,246806,121827,124909,246736,138367
"11666",2017-06-01,"sbgo","transporte regular","voo internacional",0,0,0,0,0,0,0,0,0,0
"11667",2017-06-01,"sbgo","transporte não regular","voo doméstico",1353,1365,2718,5391,4537,9928,0,0,0,0
"11668",2017-06-01,"sbgo","transporte não regular","voo internacional",4,7,11,0,0,0,0,0,0,0
"11669",2017-06-01,"sbht","transporte regular","voo doméstico",118,118,236,4353,4149,8502,0,0,0,0
"11670",2017-06-01,"sbht","transporte regular","voo internacional",0,0,0,0,0,0,0,0,0,0
"11671",2017-06-01,"sbht","transporte não regular","voo doméstico",56,55,111,78,95,173,60,130,190,20
"11672",2017-06-01,"sbht","transporte não regular","voo internacional",0,0,0,0,0,0,0,0,0,0
"11673",2017-06-01,"sbiz","transporte regular","voo doméstico",126,126,252,13746,13908,27654,0,0,0,0
"11674",2017-06-01,"sbiz","transporte regular","voo internacional",0,0,0,0,0,0,0,0,0,0
"11675",2017-06-01,"sbiz","transporte não regular","voo doméstico",163,162,325,478,476,954,0,0,0,0
"11676",2017-06-01,"sbiz","transporte não regular","voo internacional",0,0,0,0,0,0,0,0,0,0
"11677",2017-06-01,"sbjc","transporte regular","voo doméstico",0,0,0,0,0,0,0,0,0,0
"11678",2017-06-01,"sbjc","transporte regular","voo internacional",0,0,0,0,0,0,0,0,0,0
"11679",2017-06-01,"sbjc","transporte não regular","voo doméstico",316,317,633,577,429,1006,0,0,0,0
"11680",2017-06-01,"sbjc","transporte não regular","voo internacional",0,0,0,0,0,0,0,0,0,0
"11681",2017-06-01,"sbjr","transporte regular","voo doméstico",0,0,0,0,0,0,0,0,0,0
"11682",2017-06-01,"sbjr","transporte regular","voo internacional",0,0,0,0,0,0,0,0,0,0
"11683",2017-06-01,"sbjr","transporte não regular","voo doméstico",2315,2319,4634,9792,6182,15974,0,0,0,0
"11684",2017-06-01,"sbjr","transporte não regular","voo internacional",0,0,0,0,0,0,0,0,0,0
"11685",2017-06-01,"sbjv","transporte regular","voo doméstico",194,194,388,18034,17484,35518,0,826,826,0
"11686",2017-06-01,"sbjv","transporte regular","voo internacional",0,0,0,0,0,0,0,0,0,0
"11687",2017-06-01,"sbjv","transporte não regular","voo doméstico",129,130,259,127,66,193,0,0,0,0
"11688",2017-06-01,"sbjv","transporte não regular","voo internacional",0,0,0,0,0,0,0,0,0,0
"11689",2017-06-01,"sblo","transporte regular","voo doméstico",243,242,485,27504,26816,54320,0,0,0,0
"11690",2017-06-01,"sblo","transporte regular","voo internacional",0,0,0,0,0,0,0,0,0,0
"11691",2017-06-01,"sblo","transporte não regular","voo doméstico",706,711,1417,7341,7116,14457,0,0,0,0
"11692",2017-06-01,"sblo","transporte não regular","voo internacional",2,2,4,0,0,0,0,0,0,0
"11693",2017-06-01,"sbma","transporte regular","voo doméstico",130,130,260,11202,10600,21802,0,0,0,0
"11694",2017-06-01,"sbma","transporte regular","voo internacional",0,0,0,0,0,0,0,0,0,0
"11695",2017-06-01,"sbma","transporte não regular","voo doméstico",165,165,330,429,406,835,0,0,0,0
"11696",2017-06-01,"sbma","transporte não regular","voo internacional",1,1,2,0,0,0,0,0,0,0
"11697",2017-06-01,"sbmk","transporte regular","voo doméstico",150,149,299,11888,12351,24239,0,0,0,0
"11698",2017-06-01,"sbmk","transporte regular","voo internacional",0,0,0,0,0,0,0,0,0,0
"11699",2017-06-01,"sbmk","transporte não regular","voo doméstico",252,252,504,675,345,1020,0,0,0,0
"11700",2017-06-01,"sbmk","transporte não regular","voo internacional",1,1,2,0,0,0,0,0,0,0
"11701",2017-06-01,"sbmq","transporte regular","voo doméstico",202,203,405,23226,20684,43910,13860,35170,49030,0
"11702",2017-06-01,"sbmq","transporte regular","voo internacional",0,0,0,0,0,0,0,0,0,0
"11703",2017-06-01,"sbmq","transporte não regular","voo doméstico",183,180,363,167,42,209,0,4200,4200,0
"11704",2017-06-01,"sbmq","transporte não regular","voo internacional",2,4,6,0,0,0,0,0,0,0
"11705",2017-06-01,"sbmt","transporte regular","voo doméstico",0,0,0,0,0,0,0,0,0,0
"11706",2017-06-01,"sbmt","transporte regular","voo internacional",0,0,0,0,0,0,0,0,0,0
"11707",2017-06-01,"sbmt","transporte não regular","voo doméstico",3067,3075,6142,5215,5144,10359,0,0,0,0
"11708",2017-06-01,"sbmt","transporte não regular","voo internacional",0,0,0,0,0,0,0,0,0,0
"11709",2017-06-01,"sbnf","transporte regular","voo doméstico",548,547,1095,57293,58930,116223,0,0,0,0
"11710",2017-06-01,"sbnf","transporte regular","voo internacional",0,0,0,0,0,0,0,0,0,0
"11711",2017-06-01,"sbnf","transporte não regular","voo doméstico",236,237,473,1454,2132,3586,0,0,0,0
"11712",2017-06-01,"sbnf","transporte não regular","voo internacional",2,2,4,4,0,4,0,0,0,0
"11713",2017-06-01,"sbpb","transporte regular","voo doméstico",4,4,8,320,414,734,0,0,0,0
"11714",2017-06-01,"sbpb","transporte regular","voo internacional",0,0,0,0,0,0,0,0,0,0
"11715",2017-06-01,"sbpb","transporte não regular","voo doméstico",56,52,108,142,139,281,0,0,0,0
"11716",2017-06-01,"sbpb","transporte não regular","voo internacional",0,0,0,0,0,0,0,0,0,0
"11717",2017-06-01,"sbpj","transporte regular","voo doméstico",272,272,544,27106,26053,53159,0,0,0,0
"11718",2017-06-01,"sbpj","transporte regular","voo internacional",0,0,0,0,0,0,0,0,0,0
"11719",2017-06-01,"sbpj","transporte não regular","voo doméstico",252,250,502,509,317,826,0,0,0,0
"11720",2017-06-01,"sbpj","transporte não regular","voo internacional",2,2,4,3,0,3,0,0,0,0
"11721",2017-06-01,"sbpk","transporte regular","voo doméstico",25,25,50,1275,1196,2471,0,0,0,0
"11722",2017-06-01,"sbpk","transporte regular","voo internacional",0,0,0,0,0,0,0,0,0,0
"11723",2017-06-01,"sbpk","transporte não regular","voo doméstico",41,42,83,78,76,154,0,0,0,0
"11724",2017-06-01,"sbpk","transporte não regular","voo internacional",6,7,13,9,0,9,0,0,0,0
"11725",2017-06-01,"sbpl","transporte regular","voo doméstico",161,161,322,19272,16951,36223,0,0,0,0
"11726",2017-06-01,"sbpl","transporte regular","voo internacional",4,4,8,0,0,0,0,0,0,0
"11727",2017-06-01,"sbpl","transporte não regular","voo doméstico",106,107,213,359,401,760,0,0,0,0
"11728",2017-06-01,"sbpl","transporte não regular","voo internacional",1,1,2,0,0,0,0,0,0,0
"11729",2017-06-01,"sbpp","transporte regular","voo doméstico",0,0,0,0,0,0,0,0,0,0
"11730",2017-06-01,"sbpp","transporte regular","voo internacional",0,0,0,0,0,0,0,0,0,0
"11731",2017-06-01,"sbpp","transporte não regular","voo doméstico",134,140,274,207,183,390,0,0,0,0
"11732",2017-06-01,"sbpp","transporte não regular","voo internacional",10,8,18,8,8,16,0,0,0,0
"11733",2017-06-01,"sbpr","transporte regular","voo doméstico",0,0,0,0,0,0,0,0,0,0
"11734",2017-06-01,"sbpr","transporte regular","voo internacional",0,0,0,0,0,0,0,0,0,0
"11735",2017-06-01,"sbpr","transporte não regular","voo doméstico",1107,1097,2204,1253,1166,2419,0,0,0,0
"11736",2017-06-01,"sbpr","transporte não regular","voo internacional",9,8,17,0,0,0,0,0,0,0
"11737",2017-06-01,"sbpv","transporte regular","voo doméstico",300,299,599,29092,28300,57392,0,0,0,0
"11738",2017-06-01,"sbpv","transporte regular","voo internacional",0,0,0,0,0,0,0,0,0,0
"11739",2017-06-01,"sbpv","transporte não regular","voo doméstico",258,260,518,104,0,104,0,0,0,0
"11740",2017-06-01,"sbpv","transporte não regular","voo internacional",0,0,0,0,0,0,0,0,0,0
"11741",2017-06-01,"sbrb","transporte regular","voo doméstico",115,116,231,12963,13464,26427,0,0,0,0
"11742",2017-06-01,"sbrb","transporte regular","voo internacional",0,0,0,0,0,0,0,0,0,0
"11743",2017-06-01,"sbrb","transporte não regular","voo doméstico",165,163,328,389,453,842,0,0,0,0
"11744",2017-06-01,"sbrb","transporte não regular","voo internacional",5,5,10,26,0,26,0,0,0,0
"11745",2017-06-01,"sbrj","transporte regular","voo doméstico",3485,3515,7000,351210,354412,705622,0,0,0,0
"11746",2017-06-01,"sbrj","transporte regular","voo internacional",0,0,0,0,0,0,0,0,0,0
"11747",2017-06-01,"sbrj","transporte não regular","voo doméstico",541,505,1046,1222,1274,2496,0,0,0,0
"11748",2017-06-01,"sbrj","transporte não regular","voo internacional",0,0,0,0,0,0,0,0,0,0
"11749",2017-06-01,"sbsj","transporte regular","voo doméstico",0,0,0,0,0,0,0,0,0,0
"11750",2017-06-01,"sbsj","transporte regular","voo internacional",0,0,0,0,0,0,0,0,0,0
"11751",2017-06-01,"sbsj","transporte não regular","voo doméstico",436,429,865,1175,1086,2261,0,0,0,0
"11752",2017-06-01,"sbsj","transporte não regular","voo internacional",1,21,22,20,0,20,0,0,0,0
"11753",2017-06-01,"sbsl","transporte regular","voo doméstico",543,553,1096,58007,63363,121370,0,0,0,0
"11754",2017-06-01,"sbsl","transporte regular","voo internacional",0,0,0,0,0,0,0,0,0,0
"11755",2017-06-01,"sbsl","transporte não regular","voo doméstico",241,231,472,1331,1516,2847,55884,140207,196091,0
"11756",2017-06-01,"sbsl","transporte não regular","voo internacional",3,2,5,0,0,0,0,0,0,0
"11757",2017-06-01,"sbsn","transporte regular","voo doméstico",187,187,374,17018,16456,33474,0,0,0,0
"11758",2017-06-01,"sbsn","transporte regular","voo internacional",0,0,0,0,0,0,0,0,0,0
"11759",2017-06-01,"sbsn","transporte não regular","voo doméstico",187,188,375,279,214,493,2950,3750,6700,0
"11760",2017-06-01,"sbsn","transporte não regular","voo internacional",0,0,0,0,0,0,0,0,0,0
"11761",2017-06-01,"sbsp","transporte regular","voo doméstico",6760,6808,13568,850120,827596,1677716,0,0,0,0
"11762",2017-06-01,"sbsp","transporte regular","voo internacional",0,0,0,0,0,0,0,0,0,0
"11763",2017-06-01,"sbsp","transporte não regular","voo doméstico",1813,1790,3603,7812,6283,14095,0,0,0,0
"11764",2017-06-01,"sbsp","transporte não regular","voo internacional",5,4,9,13,10,23,0,0,0,0
"11765",2017-06-01,"sbte","transporte regular","voo doméstico",402,393,795,41740,45619,87359,18444,66154,84598,168096
"11766",2017-06-01,"sbte","transporte regular","voo internacional",0,0,0,0,0,0,0,0,0,0
"11767",2017-06-01,"sbte","transporte não regular","voo doméstico",217,226,443,3165,1925,5090,0,0,0,0
"11768",2017-06-01,"sbte","transporte não regular","voo internacional",0,0,0,0,0,0,0,0,0,0
"11769",2017-06-01,"sbtf","transporte regular","voo doméstico",28,27,55,1293,1293,2586,0,0,0,0
"11770",2017-06-01,"sbtf","transporte regular","voo internacional",0,0,0,0,0,0,0,0,0,0
"11771",2017-06-01,"sbtf","transporte não regular","voo doméstico",139,141,280,367,331,698,1643,3193,4836,17676
"11772",2017-06-01,"sbtf","transporte não regular","voo internacional",0,0,0,0,0,0,0,0,0,0
"11773",2017-06-01,"sbtt","transporte regular","voo doméstico",31,31,62,2391,2627,5018,0,0,0,0
"11774",2017-06-01,"sbtt","transporte regular","voo internacional",0,0,0,0,0,0,0,0,0,0
"11775",2017-06-01,"sbtt","transporte não regular","voo doméstico",80,81,161,305,307,612,836,1550,2386,413
"11776",2017-06-01,"sbtt","transporte não regular","voo internacional",0,0,0,0,0,0,0,0,0,0
"11777",2017-06-01,"sbuf","transporte regular","voo doméstico",7,7,14,386,442,828,0,0,0,0
"11778",2017-06-01,"sbuf","transporte regular","voo internacional",0,0,0,0,0,0,0,0,0,0
"11779",2017-06-01,"sbuf","transporte não regular","voo doméstico",33,32,65,39,61,100,0,0,0,0
"11780",2017-06-01,"sbuf","transporte não regular","voo internacional",0,0,0,0,0,0,0,0,0,0
"11781",2017-06-01,"sbug","transporte regular","voo doméstico",15,15,30,660,669,1329,0,0,0,0
"11782",2017-06-01,"sbug","transporte regular","voo internacional",0,0,0,0,0,0,0,0,0,0
"11783",2017-06-01,"sbug","transporte não regular","voo doméstico",19,15,34,18,37,55,0,0,0,0
"11784",2017-06-01,"sbug","transporte não regular","voo internacional",0,0,0,0,0,0,0,0,0,0
"11785",2017-06-01,"sbul","transporte regular","voo doméstico",436,432,868,41131,41807,82938,0,0,0,0
"11786",2017-06-01,"sbul","transporte regular","voo internacional",0,0,0,0,0,0,0,0,0,0
"11787",2017-06-01,"sbul","transporte não regular","voo doméstico",552,555,1107,2127,1562,3689,0,0,0,0
"11788",2017-06-01,"sbul","transporte não regular","voo internacional",1,1,2,5,8,13,0,0,0,0
"11789",2017-06-01,"sbur","transporte regular","voo doméstico",33,33,66,1877,1743,3620,0,0,0,0
"11790",2017-06-01,"sbur","transporte regular","voo internacional",0,0,0,0,0,0,0,0,0,0
"11791",2017-06-01,"sbur","transporte não regular","voo doméstico",209,207,416,1233,1168,2401,0,0,0,0
"11792",2017-06-01,"sbur","transporte não regular","voo internacional",0,0,0,0,0,0,0,0,0,0
"11793",2017-05-01,"sbbe","transporte regular","voo doméstico",1101,1089,2190,120524,122852,243376,90266,311901,402167,0
"11794",2017-05-01,"sbbe","transporte regular","voo internacional",41,41,82,5436,4659,10095,0,0,0,0
"11795",2017-05-01,"sbbe","transporte não regular","voo doméstico",416,431,847,1897,1067,2964,0,18295,18295,0
"11796",2017-05-01,"sbbe","transporte não regular","voo internacional",9,8,17,15,10,25,0,0,0,0
"11797",2017-05-01,"sbbg","transporte regular","voo doméstico",0,0,0,0,0,0,0,0,0,0
"11798",2017-05-01,"sbbg","transporte regular","voo internacional",0,0,0,0,0,0,0,0,0,0
"11799",2017-05-01,"sbbg","transporte não regular","voo doméstico",14,14,28,63,66,129,0,0,0,0
"11800",2017-05-01,"sbbg","transporte não regular","voo internacional",0,0,0,0,0,0,0,0,0,0
"11801",2017-05-01,"sbbh","transporte regular","voo doméstico",56,55,111,1680,1719,3399,0,0,0,0
"11802",2017-05-01,"sbbh","transporte regular","voo internacional",0,0,0,0,0,0,0,0,0,0
"11803",2017-05-01,"sbbh","transporte não regular","voo doméstico",1702,1699,3401,8158,8242,16400,0,0,0,0
"11804",2017-05-01,"sbbh","transporte não regular","voo internacional",4,4,8,24,24,48,0,0,0,0
"11805",2017-05-01,"sbbi","transporte regular","voo doméstico",0,0,0,0,0,0,0,0,0,0
"11806",2017-05-01,"sbbi","transporte regular","voo internacional",0,0,0,0,0,0,0,0,0,0
"11807",2017-05-01,"sbbi","transporte não regular","voo doméstico",884,871,1755,591,17,608,0,0,0,0
"11808",2017-05-01,"sbbi","transporte não regular","voo internacional",0,0,0,0,0,0,0,0,0,0
"11809",2017-05-01,"sbbv","transporte regular","voo doméstico",89,89,178,11865,11693,23558,0,0,0,0
"11810",2017-05-01,"sbbv","transporte regular","voo internacional",0,0,0,0,0,0,0,0,0,0
"11811",2017-05-01,"sbbv","transporte não regular","voo doméstico",88,91,179,379,275,654,0,0,0,0
"11812",2017-05-01,"sbbv","transporte não regular","voo internacional",13,12,25,11,3,14,0,0,0,0
"11813",2017-05-01,"sbcg","transporte regular","voo doméstico",524,529,1053,60500,58386,118886,0,0,0,0
"11814",2017-05-01,"sbcg","transporte regular","voo internacional",0,0,0,0,0,0,0,0,0,0
"11815",2017-05-01,"sbcg","transporte não regular","voo doméstico",237,238,475,362,949,1311,72842,96592,169434,0
"11816",2017-05-01,"sbcg","transporte não regular","voo internacional",5,4,9,0,0,0,0,0,0,0
"11817",2017-05-01,"sbcj","transporte regular","voo doméstico",87,87,174,5168,5093,10261,0,0,0,0
"11818",2017-05-01,"sbcj","transporte regular","voo internacional",0,0,0,0,0,0,0,0,0,0
"11819",2017-05-01,"sbcj","transporte não regular","voo doméstico",78,76,154,444,27,471,0,0,0,0
"11820",2017-05-01,"sbcj","transporte não regular","voo internacional",0,0,0,0,0,0,0,0,0,0
"11821",2017-05-01,"sbcr","transporte regular","voo doméstico",15,15,30,1094,1051,2145,0,0,0,0
"11822",2017-05-01,"sbcr","transporte regular","voo internacional",0,0,0,0,0,0,0,0,0,0
"11823",2017-05-01,"sbcr","transporte não regular","voo doméstico",49,49,98,371,398,769,0,0,0,0
"11824",2017-05-01,"sbcr","transporte não regular","voo internacional",4,4,8,8,8,16,0,0,0,0
"11825",2017-05-01,"sbct","transporte regular","voo doméstico",2465,2455,4920,267856,261027,528883,136214,10820,147034,336659
"11826",2017-05-01,"sbct","transporte regular","voo internacional",57,56,113,1840,1929,3769,0,89378,89378,0
"11827",2017-05-01,"sbct","transporte não regular","voo doméstico",370,370,740,10765,10214,20979,0,0,0,0
"11828",2017-05-01,"sbct","transporte não regular","voo internacional",11,11,22,145,98,243,0,0,0,0
"11829",2017-05-01,"sbcz","transporte regular","voo doméstico",38,38,76,3477,3178,6655,0,0,0,0
"11830",2017-05-01,"sbcz","transporte regular","voo internacional",0,0,0,0,0,0,0,0,0,0
"11831",2017-05-01,"sbcz","transporte não regular","voo doméstico",152,152,304,619,715,1334,0,0,0,0
"11832",2017-05-01,"sbcz","transporte não regular","voo internacional",0,1,1,0,0,0,0,0,0,0
"11833",2017-05-01,"sbeg","transporte regular","voo doméstico",851,848,1699,91737,89973,181710,2605,0,2605,0
"11834",2017-05-01,"sbeg","transporte regular","voo internacional",94,103,197,3954,3498,7452,0,0,0,0
"11835",2017-05-01,"sbeg","transporte não regular","voo doméstico",406,404,810,5537,4013,9550,0,0,0,0
"11836",2017-05-01,"sbeg","transporte não regular","voo internacional",81,82,163,318,505,823,0,0,0,0
"11837",2017-05-01,"sbfi","transporte regular","voo doméstico",549,547,1096,69480,67022,136502,0,0,0,0
"11838",2017-05-01,"sbfi","transporte regular","voo internacional",21,21,42,2643,2342,4985,0,0,0,0
"11839",2017-05-01,"sbfi","transporte não regular","voo doméstico",217,218,435,6926,7478,14404,0,0,0,0
"11840",2017-05-01,"sbfi","transporte não regular","voo internacional",35,35,70,146,110,256,0,0,0,0
"11841",2017-05-01,"sbgo","transporte regular","voo doméstico",1242,1244,2486,113153,124214,237367,148558,120904,269462,143905
"11842",2017-05-01,"sbgo","transporte regular","voo internacional",0,0,0,0,0,0,0,0,0,0
"11843",2017-05-01,"sbgo","transporte não regular","voo doméstico",1310,1290,2600,4465,4781,9246,0,0,0,0
"11844",2017-05-01,"sbgo","transporte não regular","voo internacional",5,5,10,0,0,0,0,0,0,0
"11845",2017-05-01,"sbht","transporte regular","voo doméstico",116,115,231,4011,4197,8208,0,0,0,0
"11846",2017-05-01,"sbht","transporte regular","voo internacional",0,0,0,0,0,0,0,0,0,0
"11847",2017-05-01,"sbht","transporte não regular","voo doméstico",75,76,151,337,273,610,0,0,0,0
"11848",2017-05-01,"sbht","transporte não regular","voo internacional",0,0,0,0,0,0,0,0,0,0
"11849",2017-05-01,"sbiz","transporte regular","voo doméstico",132,132,264,12892,12982,25874,0,0,0,0
"11850",2017-05-01,"sbiz","transporte regular","voo internacional",0,0,0,0,0,0,0,0,0,0
"11851",2017-05-01,"sbiz","transporte não regular","voo doméstico",120,121,241,383,300,683,0,0,0,0
"11852",2017-05-01,"sbiz","transporte não regular","voo internacional",1,1,2,0,0,0,0,0,0,0
"11853",2017-05-01,"sbjc","transporte regular","voo doméstico",1,1,2,2,2,4,0,0,0,0
"11854",2017-05-01,"sbjc","transporte regular","voo internacional",0,0,0,0,0,0,0,0,0,0
"11855",2017-05-01,"sbjc","transporte não regular","voo doméstico",337,341,678,635,434,1069,0,0,0,0
"11856",2017-05-01,"sbjc","transporte não regular","voo internacional",0,0,0,0,0,0,0,0,0,0
"11857",2017-05-01,"sbjr","transporte regular","voo doméstico",0,0,0,0,0,0,0,0,0,0
"11858",2017-05-01,"sbjr","transporte regular","voo internacional",0,0,0,0,0,0,0,0,0,0
"11859",2017-05-01,"sbjr","transporte não regular","voo doméstico",2243,2242,4485,10303,8283,18586,0,0,0,0
"11860",2017-05-01,"sbjr","transporte não regular","voo internacional",0,0,0,0,0,0,0,0,0,0
"11861",2017-05-01,"sbjv","transporte regular","voo doméstico",213,211,424,20068,19461,39529,0,0,0,0
"11862",2017-05-01,"sbjv","transporte regular","voo internacional",0,0,0,0,0,0,0,0,0,0
"11863",2017-05-01,"sbjv","transporte não regular","voo doméstico",88,92,180,116,68,184,0,0,0,0
"11864",2017-05-01,"sbjv","transporte não regular","voo internacional",1,1,2,0,0,0,0,0,0,0
"11865",2017-05-01,"sblo","transporte regular","voo doméstico",291,292,583,29515,29090,58605,0,0,0,0
"11866",2017-05-01,"sblo","transporte regular","voo internacional",0,0,0,0,0,0,0,0,0,0
"11867",2017-05-01,"sblo","transporte não regular","voo doméstico",649,640,1289,5644,5503,11147,0,0,0,0
"11868",2017-05-01,"sblo","transporte não regular","voo internacional",3,3,6,0,0,0,0,0,0,0
"11869",2017-05-01,"sbma","transporte regular","voo doméstico",139,140,279,11547,11564,23111,0,0,0,0
"11870",2017-05-01,"sbma","transporte regular","voo internacional",0,0,0,0,0,0,0,0,0,0
"11871",2017-05-01,"sbma","transporte não regular","voo doméstico",168,172,340,449,428,877,0,0,0,0
"11872",2017-05-01,"sbma","transporte não regular","voo internacional",0,0,0,0,0,0,0,0,0,0
"11873",2017-05-01,"sbmk","transporte regular","voo doméstico",161,163,324,12074,11851,23925,0,0,0,0
"11874",2017-05-01,"sbmk","transporte regular","voo internacional",0,0,0,0,0,0,0,0,0,0
"11875",2017-05-01,"sbmk","transporte não regular","voo doméstico",262,256,518,535,279,814,0,0,0,0
"11876",2017-05-01,"sbmk","transporte não regular","voo internacional",1,1,2,2,0,2,0,0,0,0
"11877",2017-05-01,"sbmq","transporte regular","voo doméstico",208,210,418,21338,22171,43509,11700,37450,49150,0
"11878",2017-05-01,"sbmq","transporte regular","voo internacional",0,0,0,0,0,0,0,0,0,0
"11879",2017-05-01,"sbmq","transporte não regular","voo doméstico",156,154,310,352,412,764,0,0,0,0
"11880",2017-05-01,"sbmq","transporte não regular","voo internacional",3,3,6,0,0,0,0,0,0,0
"11881",2017-05-01,"sbmt","transporte regular","voo doméstico",0,0,0,0,0,0,0,0,0,0
"11882",2017-05-01,"sbmt","transporte regular","voo internacional",0,0,0,0,0,0,0,0,0,0
"11883",2017-05-01,"sbmt","transporte não regular","voo doméstico",2805,2781,5586,4666,4613,9279,0,0,0,0
"11884",2017-05-01,"sbmt","transporte não regular","voo internacional",0,0,0,0,0,0,0,0,0,0
"11885",2017-05-01,"sbnf","transporte regular","voo doméstico",554,554,1108,60526,57707,118233,0,0,0,0
"11886",2017-05-01,"sbnf","transporte regular","voo internacional",0,0,0,0,0,0,0,0,0,0
"11887",2017-05-01,"sbnf","transporte não regular","voo doméstico",186,191,377,674,523,1197,0,0,0,0
"11888",2017-05-01,"sbnf","transporte não regular","voo internacional",3,3,6,8,7,15,0,0,0,0
"11889",2017-05-01,"sbpb","transporte regular","voo doméstico",4,4,8,363,304,667,0,0,0,0
"11890",2017-05-01,"sbpb","transporte regular","voo internacional",0,0,0,0,0,0,0,0,0,0
"11891",2017-05-01,"sbpb","transporte não regular","voo doméstico",40,42,82,103,97,200,0,0,0,0
"11892",2017-05-01,"sbpb","transporte não regular","voo internacional",0,0,0,0,0,0,0,0,0,0
"11893",2017-05-01,"sbpj","transporte regular","voo doméstico",279,279,558,26416,25984,52400,0,0,0,0
"11894",2017-05-01,"sbpj","transporte regular","voo internacional",0,0,0,0,0,0,0,0,0,0
"11895",2017-05-01,"sbpj","transporte não regular","voo doméstico",284,283,567,836,654,1490,0,0,0,0
"11896",2017-05-01,"sbpj","transporte não regular","voo internacional",1,1,2,0,0,0,0,0,0,0
"11897",2017-05-01,"sbpk","transporte regular","voo doméstico",26,26,52,1300,1359,2659,0,0,0,0
"11898",2017-05-01,"sbpk","transporte regular","voo internacional",0,0,0,0,0,0,0,0,0,0
"11899",2017-05-01,"sbpk","transporte não regular","voo doméstico",26,23,49,42,45,87,0,0,0,0
"11900",2017-05-01,"sbpk","transporte não regular","voo internacional",3,5,8,0,0,0,0,0,0,0
"11901",2017-05-01,"sbpl","transporte regular","voo doméstico",167,168,335,20277,16470,36747,0,0,0,0
"11902",2017-05-01,"sbpl","transporte regular","voo internacional",5,5,10,0,0,0,0,0,0,0
"11903",2017-05-01,"sbpl","transporte não regular","voo doméstico",82,79,161,129,298,427,0,0,0,0
"11904",2017-05-01,"sbpl","transporte não regular","voo internacional",1,1,2,0,0,0,0,0,0,0
"11905",2017-05-01,"sbpp","transporte regular","voo doméstico",0,0,0,0,0,0,0,0,0,0
"11906",2017-05-01,"sbpp","transporte regular","voo internacional",0,0,0,0,0,0,0,0,0,0
"11907",2017-05-01,"sbpp","transporte não regular","voo doméstico",100,96,196,137,145,282,0,0,0,0
"11908",2017-05-01,"sbpp","transporte não regular","voo internacional",10,9,19,14,6,20,0,0,0,0
"11909",2017-05-01,"sbpr","transporte regular","voo doméstico",1,2,3,3,1,4,0,0,0,0
"11910",2017-05-01,"sbpr","transporte regular","voo internacional",0,0,0,0,0,0,0,0,0,0
"11911",2017-05-01,"sbpr","transporte não regular","voo doméstico",957,961,1918,1056,977,2033,0,0,0,0
"11912",2017-05-01,"sbpr","transporte não regular","voo internacional",1,1,2,0,0,0,0,0,0,0
"11913",2017-05-01,"sbpv","transporte regular","voo doméstico",315,315,630,29664,29844,59508,0,0,0,0
"11914",2017-05-01,"sbpv","transporte regular","voo internacional",0,0,0,0,0,0,0,0,0,0
"11915",2017-05-01,"sbpv","transporte não regular","voo doméstico",242,243,485,106,0,106,0,0,0,0
"11916",2017-05-01,"sbpv","transporte não regular","voo internacional",1,1,2,0,0,0,0,0,0,0
"11917",2017-05-01,"sbrb","transporte regular","voo doméstico",121,121,242,13026,12966,25992,0,0,0,701
"11918",2017-05-01,"sbrb","transporte regular","voo internacional",0,0,0,0,0,0,0,0,0,0
"11919",2017-05-01,"sbrb","transporte não regular","voo doméstico",122,122,244,656,601,1257,0,0,0,0
"11920",2017-05-01,"sbrb","transporte não regular","voo internacional",0,0,0,0,0,0,0,0,0,0
"11921",2017-05-01,"sbrj","transporte regular","voo doméstico",3725,3735,7460,368512,365435,733947,1,0,1,0
"11922",2017-05-01,"sbrj","transporte regular","voo internacional",0,0,0,0,0,0,0,0,0,0
"11923",2017-05-01,"sbrj","transporte não regular","voo doméstico",534,527,1061,2105,1227,3332,0,0,0,0
"11924",2017-05-01,"sbrj","transporte não regular","voo internacional",2,2,4,7,0,7,0,0,0,0
"11925",2017-05-01,"sbsj","transporte regular","voo doméstico",0,0,0,0,0,0,0,0,0,0
"11926",2017-05-01,"sbsj","transporte regular","voo internacional",0,0,0,0,0,0,0,0,0,0
"11927",2017-05-01,"sbsj","transporte não regular","voo doméstico",471,448,919,943,836,1779,0,0,0,0
"11928",2017-05-01,"sbsj","transporte não regular","voo internacional",2,16,18,47,3,50,0,0,0,0
"11929",2017-05-01,"sbsl","transporte regular","voo doméstico",576,584,1160,57185,62450,119635,0,0,0,0
"11930",2017-05-01,"sbsl","transporte regular","voo internacional",0,0,0,0,0,0,0,0,0,0
"11931",2017-05-01,"sbsl","transporte não regular","voo doméstico",223,216,439,382,855,1237,60336,187147,247483,0
"11932",2017-05-01,"sbsl","transporte não regular","voo internacional",1,2,3,0,0,0,0,0,0,0
"11933",2017-05-01,"sbsn","transporte regular","voo doméstico",195,195,390,16215,15814,32029,0,0,0,0
"11934",2017-05-01,"sbsn","transporte regular","voo internacional",0,0,0,0,0,0,0,0,0,0
"11935",2017-05-01,"sbsn","transporte não regular","voo doméstico",236,235,471,399,273,672,4880,7470,12350,0
"11936",2017-05-01,"sbsn","transporte não regular","voo internacional",0,0,0,0,0,0,0,0,0,0
"11937",2017-05-01,"sbsp","transporte regular","voo doméstico",7263,7340,14603,872199,875258,1747457,0,0,0,0
"11938",2017-05-01,"sbsp","transporte regular","voo internacional",0,0,0,0,0,0,0,0,0,0
"11939",2017-05-01,"sbsp","transporte não regular","voo doméstico",1761,1664,3425,6267,6380,12647,0,0,0,0
"11940",2017-05-01,"sbsp","transporte não regular","voo internacional",7,9,16,50,18,68,0,0,0,0
"11941",2017-05-01,"sbte","transporte regular","voo doméstico",401,381,782,39303,41926,81229,17369,80088,97457,234388
"11942",2017-05-01,"sbte","transporte regular","voo internacional",0,0,0,0,0,0,0,0,0,0
"11943",2017-05-01,"sbte","transporte não regular","voo doméstico",199,219,418,4420,2220,6640,0,0,0,0
"11944",2017-05-01,"sbte","transporte não regular","voo internacional",0,0,0,0,0,0,0,0,0,0
"11945",2017-05-01,"sbtf","transporte regular","voo doméstico",36,36,72,1271,1340,2611,0,0,0,0
"11946",2017-05-01,"sbtf","transporte regular","voo internacional",0,0,0,0,0,0,0,0,0,0
"11947",2017-05-01,"sbtf","transporte não regular","voo doméstico",144,146,290,487,430,917,1473,2331,3804,15681
"11948",2017-05-01,"sbtf","transporte não regular","voo internacional",1,1,2,0,0,0,0,0,0,0
"11949",2017-05-01,"sbtt","transporte regular","voo doméstico",30,30,60,1886,2314,4200,30,515,545,0
"11950",2017-05-01,"sbtt","transporte regular","voo internacional",0,0,0,0,0,0,0,0,0,0
"11951",2017-05-01,"sbtt","transporte não regular","voo doméstico",64,65,129,262,259,521,288,721,1009,208
"11952",2017-05-01,"sbtt","transporte não regular","voo internacional",0,0,0,0,0,0,0,0,0,0
"11953",2017-05-01,"sbuf","transporte regular","voo doméstico",8,8,16,473,487,960,0,0,0,0
"11954",2017-05-01,"sbuf","transporte regular","voo internacional",0,0,0,0,0,0,0,0,0,0
"11955",2017-05-01,"sbuf","transporte não regular","voo doméstico",27,29,56,88,71,159,0,0,0,0
"11956",2017-05-01,"sbuf","transporte não regular","voo internacional",0,0,0,0,0,0,0,0,0,0
"11957",2017-05-01,"sbug","transporte regular","voo doméstico",15,15,30,768,747,1515,0,0,0,0
"11958",2017-05-01,"sbug","transporte regular","voo internacional",0,0,0,0,0,0,0,0,0,0
"11959",2017-05-01,"sbug","transporte não regular","voo doméstico",18,18,36,55,58,113,0,0,0,0
"11960",2017-05-01,"sbug","transporte não regular","voo internacional",0,0,0,0,0,0,0,0,0,0
"11961",2017-05-01,"sbul","transporte regular","voo doméstico",478,473,951,44992,45291,90283,0,0,0,0
"11962",2017-05-01,"sbul","transporte regular","voo internacional",0,0,0,0,0,0,0,0,0,0
"11963",2017-05-01,"sbul","transporte não regular","voo doméstico",598,602,1200,1870,1244,3114,0,0,0,0
"11964",2017-05-01,"sbul","transporte não regular","voo internacional",0,0,0,0,0,0,0,0,0,0
"11965",2017-05-01,"sbur","transporte regular","voo doméstico",43,44,87,2436,2214,4650,0,0,0,0
"11966",2017-05-01,"sbur","transporte regular","voo internacional",0,0,0,0,0,0,0,0,0,0
"11967",2017-05-01,"sbur","transporte não regular","voo doméstico",255,284,539,1692,1640,3332,0,0,0,0
"11968",2017-05-01,"sbur","transporte não regular","voo internacional",1,2,3,0,0,0,0,0,0,0
"11969",2017-03-01,"sbbe","transporte regular","voo doméstico",1149,1148,2297,125553,123411,248964,92261,311971,404232,0
"11970",2017-03-01,"sbbe","transporte regular","voo internacional",42,41,83,4642,4284,8926,0,124,124,0
"11971",2017-03-01,"sbbe","transporte não regular","voo doméstico",451,453,904,6386,6388,12774,3,0,3,0
"11972",2017-03-01,"sbbe","transporte não regular","voo internacional",13,8,21,13,88,101,0,0,0,0
"11973",2017-03-01,"sbbg","transporte regular","voo doméstico",0,0,0,0,0,0,0,0,0,0
"11974",2017-03-01,"sbbg","transporte regular","voo internacional",0,0,0,0,0,0,0,0,0,0
"11975",2017-03-01,"sbbg","transporte não regular","voo doméstico",10,12,22,52,36,88,0,0,0,0
"11976",2017-03-01,"sbbg","transporte não regular","voo internacional",3,1,4,7,20,27,0,0,0,0
"11977",2017-03-01,"sbbh","transporte regular","voo doméstico",54,54,108,2170,2078,4248,0,0,0,0
"11978",2017-03-01,"sbbh","transporte regular","voo internacional",0,0,0,0,0,0,0,0,0,0
"11979",2017-03-01,"sbbh","transporte não regular","voo doméstico",1653,1649,3302,7914,7903,15817,0,0,0,0
"11980",2017-03-01,"sbbh","transporte não regular","voo internacional",6,5,11,27,38,65,0,0,0,0
"11981",2017-03-01,"sbbi","transporte regular","voo doméstico",0,0,0,0,0,0,0,0,0,0
"11982",2017-03-01,"sbbi","transporte regular","voo internacional",0,0,0,0,0,0,0,0,0,0
"11983",2017-03-01,"sbbi","transporte não regular","voo doméstico",829,810,1639,3277,3091,6368,0,0,0,0
"11984",2017-03-01,"sbbi","transporte não regular","voo internacional",0,0,0,0,0,0,0,0,0,0
"11985",2017-03-01,"sbbv","transporte regular","voo doméstico",88,87,175,12044,11975,24019,0,0,0,0
"11986",2017-03-01,"sbbv","transporte regular","voo internacional",0,0,0,0,0,0,0,0,0,0
"11987",2017-03-01,"sbbv","transporte não regular","voo doméstico",102,105,207,424,172,596,0,0,0,0
"11988",2017-03-01,"sbbv","transporte não regular","voo internacional",10,9,19,3,0,3,0,0,0,0
"11989",2017-03-01,"sbcg","transporte regular","voo doméstico",554,552,1106,63217,63242,126459,0,0,0,0
"11990",2017-03-01,"sbcg","transporte regular","voo internacional",0,0,0,0,0,0,0,0,0,0
"11991",2017-03-01,"sbcg","transporte não regular","voo doméstico",234,236,470,212,230,442,76260,113985,190245,0
"11992",2017-03-01,"sbcg","transporte não regular","voo internacional",10,11,21,0,0,0,0,0,0,0
"11993",2017-03-01,"sbcj","transporte regular","voo doméstico",70,69,139,4783,4825,9608,0,0,0,0
"11994",2017-03-01,"sbcj","transporte regular","voo internacional",0,0,0,0,0,0,0,0,0,0
"11995",2017-03-01,"sbcj","transporte não regular","voo doméstico",92,92,184,558,780,1338,0,0,0,0
"11996",2017-03-01,"sbcj","transporte não regular","voo internacional",2,2,4,0,0,0,0,0,0,0
"11997",2017-03-01,"sbcr","transporte regular","voo doméstico",6,6,12,433,506,939,0,0,0,0
"11998",2017-03-01,"sbcr","transporte regular","voo internacional",0,0,0,0,0,0,0,0,0,0
"11999",2017-03-01,"sbcr","transporte não regular","voo doméstico",65,67,132,927,868,1795,0,0,0,0
"12000",2017-03-01,"sbcr","transporte não regular","voo internacional",3,3,6,7,3,10,0,0,0,0
"12001",2017-03-01,"sbct","transporte regular","voo doméstico",2761,2786,5547,276760,270918,547678,185751,22279,208030,397887
"12002",2017-03-01,"sbct","transporte regular","voo internacional",57,57,114,1944,2031,3975,0,58011,58011,0
"12003",2017-03-01,"sbct","transporte não regular","voo doméstico",240,222,462,2575,4247,6822,0,0,0,0
"12004",2017-03-01,"sbct","transporte não regular","voo internacional",26,20,46,236,132,368,0,0,0,0
"12005",2017-03-01,"sbcz","transporte regular","voo doméstico",38,38,76,3192,2870,6062,0,0,0,0
"12006",2017-03-01,"sbcz","transporte regular","voo internacional",0,0,0,0,0,0,0,0,0,0
"12007",2017-03-01,"sbcz","transporte não regular","voo doméstico",118,120,238,516,474,990,0,0,0,0
"12008",2017-03-01,"sbcz","transporte não regular","voo internacional",3,3,6,0,0,0,0,0,0,0
"12009",2017-03-01,"sbeg","transporte regular","voo doméstico",871,859,1730,94383,96003,190386,0,0,0,0
"12010",2017-03-01,"sbeg","transporte regular","voo internacional",96,106,202,3423,4177,7600,0,0,0,0
"12011",2017-03-01,"sbeg","transporte não regular","voo doméstico",474,475,949,4731,3392,8123,0,0,0,0
"12012",2017-03-01,"sbeg","transporte não regular","voo internacional",83,87,170,579,748,1327,0,0,0,0
"12013",2017-03-01,"sbfi","transporte regular","voo doméstico",633,635,1268,80886,78541,159427,0,0,0,0
"12014",2017-03-01,"sbfi","transporte regular","voo internacional",22,22,44,2635,2648,5283,0,0,0,0
"12015",2017-03-01,"sbfi","transporte não regular","voo doméstico",157,154,311,1693,1520,3213,0,0,0,0
"12016",2017-03-01,"sbfi","transporte não regular","voo internacional",28,30,58,96,73,169,0,0,0,0
"12017",2017-03-01,"sbgo","transporte regular","voo doméstico",1257,1261,2518,120693,120233,240926,169631,120865,290496,164172
"12018",2017-03-01,"sbgo","transporte regular","voo internacional",0,0,0,0,0,0,0,0,0,0
"12019",2017-03-01,"sbgo","transporte não regular","voo doméstico",1289,1275,2564,4786,4944,9730,0,0,0,0
"12020",2017-03-01,"sbgo","transporte não regular","voo internacional",6,6,12,0,0,0,0,0,0,0
"12021",2017-03-01,"sbht","transporte regular","voo doméstico",133,131,264,4591,4517,9108,0,0,0,0
"12022",2017-03-01,"sbht","transporte regular","voo internacional",0,0,0,0,0,0,0,0,0,0
"12023",2017-03-01,"sbht","transporte não regular","voo doméstico",99,100,199,299,212,511,0,0,0,0
"12024",2017-03-01,"sbht","transporte não regular","voo internacional",0,0,0,0,0,0,0,0,0,0
"12025",2017-03-01,"sbiz","transporte regular","voo doméstico",130,131,261,11255,11047,22302,0,0,0,0
"12026",2017-03-01,"sbiz","transporte regular","voo internacional",0,0,0,0,0,0,0,0,0,0
"12027",2017-03-01,"sbiz","transporte não regular","voo doméstico",105,101,206,288,285,573,0,0,0,0
"12028",2017-03-01,"sbiz","transporte não regular","voo internacional",0,0,0,0,0,0,0,0,0,0
"12029",2017-03-01,"sbjc","transporte regular","voo doméstico",1,1,2,3,2,5,0,0,0,0
"12030",2017-03-01,"sbjc","transporte regular","voo internacional",0,0,0,0,0,0,0,0,0,0
"12031",2017-03-01,"sbjc","transporte não regular","voo doméstico",294,293,587,482,361,843,0,0,0,0
"12032",2017-03-01,"sbjc","transporte não regular","voo internacional",0,0,0,0,0,0,0,0,0,0
"12033",2017-03-01,"sbjr","transporte regular","voo doméstico",0,0,0,0,0,0,0,0,0,0
"12034",2017-03-01,"sbjr","transporte regular","voo internacional",0,0,0,0,0,0,0,0,0,0
"12035",2017-03-01,"sbjr","transporte não regular","voo doméstico",2553,2546,5099,12119,9577,21696,0,0,0,0
"12036",2017-03-01,"sbjr","transporte não regular","voo internacional",0,0,0,0,0,0,0,0,0,0
"12037",2017-03-01,"sbjv","transporte regular","voo doméstico",224,225,449,21150,19732,40882,0,0,0,0
"12038",2017-03-01,"sbjv","transporte regular","voo internacional",0,0,0,0,0,0,0,0,0,0
"12039",2017-03-01,"sbjv","transporte não regular","voo doméstico",77,77,154,219,106,325,0,0,0,0
"12040",2017-03-01,"sbjv","transporte não regular","voo internacional",2,2,4,0,0,0,0,0,0,0
"12041",2017-03-01,"sblo","transporte regular","voo doméstico",437,436,873,40042,38505,78547,0,0,0,0
"12042",2017-03-01,"sblo","transporte regular","voo internacional",0,0,0,0,0,0,0,0,0,0
"12043",2017-03-01,"sblo","transporte não regular","voo doméstico",530,526,1056,343,97,440,0,0,0,0
"12044",2017-03-01,"sblo","transporte não regular","voo internacional",1,1,2,0,0,0,0,0,0,0
"12045",2017-03-01,"sbma","transporte regular","voo doméstico",129,129,258,10394,9814,20208,0,0,0,0
"12046",2017-03-01,"sbma","transporte regular","voo internacional",0,0,0,0,0,0,0,0,0,0
"12047",2017-03-01,"sbma","transporte não regular","voo doméstico",207,206,413,1265,1219,2484,0,0,0,0
"12048",2017-03-01,"sbma","transporte não regular","voo internacional",1,1,2,0,0,0,0,0,0,0
"12049",2017-03-01,"sbmk","transporte regular","voo doméstico",164,165,329,11690,10894,22584,0,0,0,0
"12050",2017-03-01,"sbmk","transporte regular","voo internacional",0,0,0,0,0,0,0,0,0,0
"12051",2017-03-01,"sbmk","transporte não regular","voo doméstico",215,215,430,911,625,1536,0,0,0,0
"12052",2017-03-01,"sbmk","transporte não regular","voo internacional",0,0,0,0,0,0,0,0,0,0
"12053",2017-03-01,"sbmq","transporte regular","voo doméstico",228,230,458,23434,24377,47811,12500,32500,45000,0
"12054",2017-03-01,"sbmq","transporte regular","voo internacional",0,0,0,0,0,0,0,0,0,0
"12055",2017-03-01,"sbmq","transporte não regular","voo doméstico",194,196,390,289,161,450,0,0,0,0
"12056",2017-03-01,"sbmq","transporte não regular","voo internacional",5,4,9,0,0,0,0,0,0,0
"12057",2017-03-01,"sbmt","transporte regular","voo doméstico",0,0,0,0,0,0,0,0,0,0
"12058",2017-03-01,"sbmt","transporte regular","voo internacional",0,0,0,0,0,0,0,0,0,0
"12059",2017-03-01,"sbmt","transporte não regular","voo doméstico",2890,2861,5751,4891,5061,9952,0,0,0,0
"12060",2017-03-01,"sbmt","transporte não regular","voo internacional",0,0,0,0,0,0,0,0,0,0
"12061",2017-03-01,"sbnf","transporte regular","voo doméstico",510,509,1019,58844,54884,113728,0,0,0,0
"12062",2017-03-01,"sbnf","transporte regular","voo internacional",0,0,0,0,0,0,0,0,0,0
"12063",2017-03-01,"sbnf","transporte não regular","voo doméstico",231,240,471,943,863,1806,0,0,0,0
"12064",2017-03-01,"sbnf","transporte não regular","voo internacional",2,2,4,1,8,9,0,0,0,0
"12065",2017-03-01,"sbpb","transporte regular","voo doméstico",4,4,8,291,262,553,0,0,0,0
"12066",2017-03-01,"sbpb","transporte regular","voo internacional",0,0,0,0,0,0,0,0,0,0
"12067",2017-03-01,"sbpb","transporte não regular","voo doméstico",41,52,93,159,90,249,0,0,0,0
"12068",2017-03-01,"sbpb","transporte não regular","voo internacional",0,0,0,0,0,0,0,0,0,0
"12069",2017-03-01,"sbpj","transporte regular","voo doméstico",270,271,541,24964,24179,49143,0,0,0,0
"12070",2017-03-01,"sbpj","transporte regular","voo internacional",0,0,0,0,0,0,0,0,0,0
"12071",2017-03-01,"sbpj","transporte não regular","voo doméstico",256,255,511,573,396,969,0,0,0,0
"12072",2017-03-01,"sbpj","transporte não regular","voo internacional",2,2,4,0,0,0,0,0,0,0
"12073",2017-03-01,"sbpk","transporte regular","voo doméstico",26,26,52,1397,1344,2741,0,0,0,0
"12074",2017-03-01,"sbpk","transporte regular","voo internacional",0,0,0,0,0,0,0,0,0,0
"12075",2017-03-01,"sbpk","transporte não regular","voo doméstico",26,23,49,62,61,123,0,0,0,0
"12076",2017-03-01,"sbpk","transporte não regular","voo internacional",4,7,11,4,0,4,0,0,0,0
"12077",2017-03-01,"sbpl","transporte regular","voo doméstico",177,179,356,21958,17159,39117,0,0,0,0
"12078",2017-03-01,"sbpl","transporte regular","voo internacional",4,4,8,0,0,0,0,0,0,0
"12079",2017-03-01,"sbpl","transporte não regular","voo doméstico",75,74,149,88,78,166,0,0,0,0
"12080",2017-03-01,"sbpl","transporte não regular","voo internacional",0,0,0,0,0,0,0,0,0,0
"12081",2017-03-01,"sbpp","transporte regular","voo doméstico",0,0,0,0,0,0,0,0,0,0
"12082",2017-03-01,"sbpp","transporte regular","voo internacional",0,0,0,0,0,0,0,0,0,0
"12083",2017-03-01,"sbpp","transporte não regular","voo doméstico",129,128,257,345,180,525,0,0,0,0
"12084",2017-03-01,"sbpp","transporte não regular","voo internacional",9,9,18,5,3,8,0,0,0,0
"12085",2017-03-01,"sbpr","transporte regular","voo doméstico",0,0,0,0,0,0,0,0,0,0
"12086",2017-03-01,"sbpr","transporte regular","voo internacional",0,0,0,0,0,0,0,0,0,0
"12087",2017-03-01,"sbpr","transporte não regular","voo doméstico",946,943,1889,1132,1055,2187,0,0,0,0
"12088",2017-03-01,"sbpr","transporte não regular","voo internacional",5,4,9,0,0,0,0,0,0,0
"12089",2017-03-01,"sbpv","transporte regular","voo doméstico",354,356,710,31324,31167,62491,0,0,0,0
"12090",2017-03-01,"sbpv","transporte regular","voo internacional",0,0,0,0,0,0,0,0,0,0
"12091",2017-03-01,"sbpv","transporte não regular","voo doméstico",229,231,460,167,0,167,0,0,0,0
"12092",2017-03-01,"sbpv","transporte não regular","voo internacional",0,0,0,0,0,0,0,0,0,0
"12093",2017-03-01,"sbrb","transporte regular","voo doméstico",149,148,297,14337,15466,29803,0,50,50,90
"12094",2017-03-01,"sbrb","transporte regular","voo internacional",0,0,0,0,0,0,0,0,0,0
"12095",2017-03-01,"sbrb","transporte não regular","voo doméstico",133,134,267,866,447,1313,0,0,0,0
"12096",2017-03-01,"sbrb","transporte não regular","voo internacional",0,0,0,0,0,0,0,0,0,0
"12097",2017-03-01,"sbrj","transporte regular","voo doméstico",4025,4033,8058,399494,392382,791876,0,0,0,0
"12098",2017-03-01,"sbrj","transporte regular","voo internacional",0,0,0,0,0,0,0,0,0,0
"12099",2017-03-01,"sbrj","transporte não regular","voo doméstico",573,557,1130,2160,1464,3624,0,0,0,0
"12100",2017-03-01,"sbrj","transporte não regular","voo internacional",1,1,2,5,0,5,0,0,0,0
"12101",2017-03-01,"sbsj","transporte regular","voo doméstico",0,0,0,0,0,0,0,0,0,0
"12102",2017-03-01,"sbsj","transporte regular","voo internacional",0,0,0,0,0,0,0,0,0,0
"12103",2017-03-01,"sbsj","transporte não regular","voo doméstico",477,458,935,782,795,1577,0,0,0,0
"12104",2017-03-01,"sbsj","transporte não regular","voo internacional",1,9,10,16,0,16,0,0,0,0
"12105",2017-03-01,"sbsl","transporte regular","voo doméstico",605,607,1212,58972,60820,119792,0,0,0,0
"12106",2017-03-01,"sbsl","transporte regular","voo internacional",0,0,0,0,0,0,0,0,0,0
"12107",2017-03-01,"sbsl","transporte não regular","voo doméstico",192,192,384,755,682,1437,64183,183877,248060,0
"12108",2017-03-01,"sbsl","transporte não regular","voo internacional",2,2,4,3,0,3,0,0,0,0
"12109",2017-03-01,"sbsn","transporte regular","voo doméstico",222,222,444,18075,15809,33884,0,0,0,0
"12110",2017-03-01,"sbsn","transporte regular","voo internacional",0,0,0,0,0,0,0,0,0,0
"12111",2017-03-01,"sbsn","transporte não regular","voo doméstico",242,238,480,597,480,1077,3270,4320,7590,0
"12112",2017-03-01,"sbsn","transporte não regular","voo internacional",2,2,4,3,0,3,0,0,0,0
"12113",2017-03-01,"sbsp","transporte regular","voo doméstico",7535,7596,15131,894593,912513,1807106,0,0,0,0
"12114",2017-03-01,"sbsp","transporte regular","voo internacional",0,0,0,0,0,0,0,0,0,0
"12115",2017-03-01,"sbsp","transporte não regular","voo doméstico",1916,1811,3727,8327,7927,16254,0,0,0,0
"12116",2017-03-01,"sbsp","transporte não regular","voo internacional",10,10,20,21,20,41,0,0,0,0
"12117",2017-03-01,"sbte","transporte regular","voo doméstico",449,452,901,42044,40762,82806,27914,78425,106339,232288
"12118",2017-03-01,"sbte","transporte regular","voo internacional",0,0,0,0,0,0,0,0,0,0
"12119",2017-03-01,"sbte","transporte não regular","voo doméstico",164,162,326,1016,1262,2278,0,0,0,0
"12120",2017-03-01,"sbte","transporte não regular","voo internacional",1,1,2,0,0,0,0,0,0,0
"12121",2017-03-01,"sbtf","transporte regular","voo doméstico",36,36,72,1294,1434,2728,0,0,0,0
"12122",2017-03-01,"sbtf","transporte regular","voo internacional",0,0,0,0,0,0,0,0,0,0
"12123",2017-03-01,"sbtf","transporte não regular","voo doméstico",149,150,299,765,701,1466,2555,4346,6901,10525
"12124",2017-03-01,"sbtf","transporte não regular","voo internacional",0,0,0,0,0,0,0,0,0,0
"12125",2017-03-01,"sbtt","transporte regular","voo doméstico",30,30,60,1913,2208,4121,0,327,327,0
"12126",2017-03-01,"sbtt","transporte regular","voo internacional",0,0,0,0,0,0,0,0,0,0
"12127",2017-03-01,"sbtt","transporte não regular","voo doméstico",75,74,149,295,315,610,1400,2492,3892,617
"12128",2017-03-01,"sbtt","transporte não regular","voo internacional",0,0,0,0,0,0,0,0,0,0
"12129",2017-03-01,"sbuf","transporte regular","voo doméstico",9,9,18,312,445,757,0,0,0,0
"12130",2017-03-01,"sbuf","transporte regular","voo internacional",0,0,0,0,0,0,0,0,0,0
"12131",2017-03-01,"sbuf","transporte não regular","voo doméstico",29,27,56,44,42,86,0,0,0,0
"12132",2017-03-01,"sbuf","transporte não regular","voo internacional",0,0,0,0,0,0,0,0,0,0
"12133",2017-03-01,"sbug","transporte regular","voo doméstico",17,17,34,944,961,1905,0,0,0,0
"12134",2017-03-01,"sbug","transporte regular","voo internacional",0,0,0,0,0,0,0,0,0,0
"12135",2017-03-01,"sbug","transporte não regular","voo doméstico",15,15,30,32,26,58,0,0,0,0
"12136",2017-03-01,"sbug","transporte não regular","voo internacional",0,0,0,0,0,0,0,0,0,0
"12137",2017-03-01,"sbul","transporte regular","voo doméstico",508,512,1020,46354,45110,91464,0,0,0,0
"12138",2017-03-01,"sbul","transporte regular","voo internacional",0,0,0,0,0,0,0,0,0,0
"12139",2017-03-01,"sbul","transporte não regular","voo doméstico",576,567,1143,1584,1603,3187,0,0,0,0
"12140",2017-03-01,"sbul","transporte não regular","voo internacional",1,1,2,8,8,16,0,0,0,0
"12141",2017-03-01,"sbur","transporte regular","voo doméstico",80,81,161,3073,3558,6631,0,0,0,0
"12142",2017-03-01,"sbur","transporte regular","voo internacional",0,0,0,0,0,0,0,0,0,0
"12143",2017-03-01,"sbur","transporte não regular","voo doméstico",166,160,326,451,533,984,0,0,0,0
"12144",2017-03-01,"sbur","transporte não regular","voo internacional",0,0,0,0,0,0,0,0,0,0
"12145",2017-11-01,"sbbe","transporte regular","voo doméstico",1004,1005,2009,127151,124535,251686,49117,164166,213283,0
"12146",2017-11-01,"sbbe","transporte regular","voo internacional",38,39,77,4341,4505,8846,236,1223,1459,0
"12147",2017-11-01,"sbbe","transporte não regular","voo doméstico",436,437,873,2384,3248,5632,0,18076,18076,0
"12148",2017-11-01,"sbbe","transporte não regular","voo internacional",10,9,19,11,12,23,0,0,0,0
"12149",2017-11-01,"sbbg","transporte regular","voo doméstico",0,0,0,0,0,0,0,0,0,0
"12150",2017-11-01,"sbbg","transporte regular","voo internacional",0,0,0,0,0,0,0,0,0,0
"12151",2017-11-01,"sbbg","transporte não regular","voo doméstico",14,15,29,42,42,84,0,0,0,0
"12152",2017-11-01,"sbbg","transporte não regular","voo internacional",0,0,0,0,0,0,0,0,0,0
"12153",2017-11-01,"sbbh","transporte regular","voo doméstico",50,50,100,1451,1371,2822,0,0,0,0
"12154",2017-11-01,"sbbh","transporte regular","voo internacional",0,0,0,0,0,0,0,0,0,0
"12155",2017-11-01,"sbbh","transporte não regular","voo doméstico",1506,1510,3016,8473,8632,17105,0,0,0,0
"12156",2017-11-01,"sbbh","transporte não regular","voo internacional",5,5,10,28,28,56,0,0,0,0
"12157",2017-11-01,"sbbi","transporte regular","voo doméstico",0,0,0,0,0,0,0,0,0,0
"12158",2017-11-01,"sbbi","transporte regular","voo internacional",0,0,0,0,0,0,0,0,0,0
"12159",2017-11-01,"sbbi","transporte não regular","voo doméstico",1082,1075,2157,3650,3671,7321,0,0,0,0
"12160",2017-11-01,"sbbi","transporte não regular","voo internacional",0,0,0,0,0,0,0,0,0,0
"12161",2017-11-01,"sbbv","transporte regular","voo doméstico",85,85,170,11423,10489,21912,0,0,0,0
"12162",2017-11-01,"sbbv","transporte regular","voo internacional",0,0,0,0,0,0,0,0,0,0
"12163",2017-11-01,"sbbv","transporte não regular","voo doméstico",129,130,259,753,411,1164,0,0,0,0
"12164",2017-11-01,"sbbv","transporte não regular","voo internacional",26,22,48,1,0,1,0,0,0,0
"12165",2017-11-01,"sbcg","transporte regular","voo doméstico",530,529,1059,64347,61889,126236,0,12300,12300,0
"12166",2017-11-01,"sbcg","transporte regular","voo internacional",0,0,0,0,0,0,0,0,0,0
"12167",2017-11-01,"sbcg","transporte não regular","voo doméstico",225,226,451,1253,1140,2393,68424,66863,135287,0
"12168",2017-11-01,"sbcg","transporte não regular","voo internacional",4,4,8,0,0,0,0,0,0,0
"12169",2017-11-01,"sbcj","transporte regular","voo doméstico",81,81,162,4661,4568,9229,0,0,0,0
"12170",2017-11-01,"sbcj","transporte regular","voo internacional",0,0,0,0,0,0,0,0,0,0
"12171",2017-11-01,"sbcj","transporte não regular","voo doméstico",85,87,172,660,109,769,0,0,0,0
"12172",2017-11-01,"sbcj","transporte não regular","voo internacional",0,0,0,0,0,0,0,0,0,0
"12173",2017-11-01,"sbcr","transporte regular","voo doméstico",15,15,30,954,784,1738,0,0,0,0
"12174",2017-11-01,"sbcr","transporte regular","voo internacional",0,0,0,0,0,0,0,0,0,0
"12175",2017-11-01,"sbcr","transporte não regular","voo doméstico",43,40,83,98,87,185,0,0,0,0
"12176",2017-11-01,"sbcr","transporte não regular","voo internacional",2,2,4,1,3,4,0,0,0,0
"12177",2017-11-01,"sbct","transporte regular","voo doméstico",2274,2296,4570,264944,261823,526767,145262,65697,210959,337867
"12178",2017-11-01,"sbct","transporte regular","voo internacional",61,61,122,2246,2206,4452,5244,88435,93679,0
"12179",2017-11-01,"sbct","transporte não regular","voo doméstico",399,377,776,10736,11560,22296,0,0,0,0
"12180",2017-11-01,"sbct","transporte não regular","voo internacional",15,15,30,481,456,937,0,0,0,0
"12181",2017-11-01,"sbcz","transporte regular","voo doméstico",41,41,82,3394,3210,6604,0,0,0,0
"12182",2017-11-01,"sbcz","transporte regular","voo internacional",0,0,0,0,0,0,0,0,0,0
"12183",2017-11-01,"sbcz","transporte não regular","voo doméstico",143,142,285,548,558,1106,0,0,0,0
"12184",2017-11-01,"sbcz","transporte não regular","voo internacional",0,0,0,0,0,0,0,0,0,0
"12185",2017-11-01,"sbeg","transporte regular","voo doméstico",849,846,1695,105642,98989,204631,0,0,0,0
"12186",2017-11-01,"sbeg","transporte regular","voo internacional",108,117,225,5454,5514,10968,0,0,0,0
"12187",2017-11-01,"sbeg","transporte não regular","voo doméstico",612,591,1203,7568,4070,11638,0,0,0,0
"12188",2017-11-01,"sbeg","transporte não regular","voo internacional",63,79,142,399,105,504,0,0,0,0
"12189",2017-11-01,"sbfi","transporte regular","voo doméstico",619,626,1245,90290,88792,179082,0,0,0,0
"12190",2017-11-01,"sbfi","transporte regular","voo internacional",20,21,41,2604,2345,4949,0,0,0,0
"12191",2017-11-01,"sbfi","transporte não regular","voo doméstico",187,175,362,2694,3460,6154,0,0,0,0
"12192",2017-11-01,"sbfi","transporte não regular","voo internacional",49,49,98,67,329,396,0,0,0,0
"12193",2017-11-01,"sbgo","transporte regular","voo doméstico",1147,1168,2315,126581,121954,248535,109312,153589,262901,113084
"12194",2017-11-01,"sbgo","transporte regular","voo internacional",0,0,0,0,0,0,0,0,0,0
"12195",2017-11-01,"sbgo","transporte não regular","voo doméstico",1271,1250,2521,5399,7594,12993,0,0,0,0
"12196",2017-11-01,"sbgo","transporte não regular","voo internacional",1,1,2,0,0,0,0,0,0,0
"12197",2017-11-01,"sbht","transporte regular","voo doméstico",94,96,190,3953,3679,7632,0,0,0,0
"12198",2017-11-01,"sbht","transporte regular","voo internacional",0,0,0,0,0,0,0,0,0,0
"12199",2017-11-01,"sbht","transporte não regular","voo doméstico",63,61,124,597,618,1215,0,0,0,0
"12200",2017-11-01,"sbht","transporte não regular","voo internacional",0,0,0,0,0,0,0,0,0,0
"12201",2017-11-01,"sbiz","transporte regular","voo doméstico",101,101,202,11881,11606,23487,0,0,0,0
"12202",2017-11-01,"sbiz","transporte regular","voo internacional",0,0,0,0,0,0,0,0,0,0
"12203",2017-11-01,"sbiz","transporte não regular","voo doméstico",163,164,327,451,382,833,0,0,0,0
"12204",2017-11-01,"sbiz","transporte não regular","voo internacional",0,0,0,0,0,0,0,0,0,0
"12205",2017-11-01,"sbjc","transporte regular","voo doméstico",0,0,0,0,0,0,0,0,0,0
"12206",2017-11-01,"sbjc","transporte regular","voo internacional",0,0,0,0,0,0,0,0,0,0
"12207",2017-11-01,"sbjc","transporte não regular","voo doméstico",396,407,803,831,549,1380,0,0,0,0
"12208",2017-11-01,"sbjc","transporte não regular","voo internacional",0,0,0,0,0,0,0,0,0,0
"12209",2017-11-01,"sbjr","transporte regular","voo doméstico",0,0,0,0,0,0,0,0,0,0
"12210",2017-11-01,"sbjr","transporte regular","voo internacional",0,0,0,0,0,0,0,0,0,0
"12211",2017-11-01,"sbjr","transporte não regular","voo doméstico",2429,2422,4851,9589,5136,14725,0,0,0,0
"12212",2017-11-01,"sbjr","transporte não regular","voo internacional",2,2,4,1,0,1,0,0,0,0
"12213",2017-11-01,"sbjv","transporte regular","voo doméstico",212,211,423,20675,20347,41022,0,0,0,0
"12214",2017-11-01,"sbjv","transporte regular","voo internacional",0,0,0,0,0,0,0,0,0,0
"12215",2017-11-01,"sbjv","transporte não regular","voo doméstico",147,146,293,133,104,237,0,0,0,0
"12216",2017-11-01,"sbjv","transporte não regular","voo internacional",0,0,0,0,0,0,0,0,0,0
"12217",2017-11-01,"sblo","transporte regular","voo doméstico",350,349,699,34473,33702,68175,0,0,0,0
"12218",2017-11-01,"sblo","transporte regular","voo internacional",0,0,0,0,0,0,0,0,0,0
"12219",2017-11-01,"sblo","transporte não regular","voo doméstico",584,592,1176,3575,3205,6780,0,0,0,0
"12220",2017-11-01,"sblo","transporte não regular","voo internacional",1,1,2,0,0,0,0,0,0,0
"12221",2017-11-01,"sbma","transporte regular","voo doméstico",128,127,255,10651,10601,21252,0,0,0,0
"12222",2017-11-01,"sbma","transporte regular","voo internacional",0,0,0,0,0,0,0,0,0,0
"12223",2017-11-01,"sbma","transporte não regular","voo doméstico",153,157,310,440,425,865,0,0,0,0
"12224",2017-11-01,"sbma","transporte não regular","voo internacional",0,0,0,0,0,0,0,0,0,0
"12225",2017-11-01,"sbmk","transporte regular","voo doméstico",112,122,234,10242,9419,19661,0,0,0,0
"12226",2017-11-01,"sbmk","transporte regular","voo internacional",0,0,0,0,0,0,0,0,0,0
"12227",2017-11-01,"sbmk","transporte não regular","voo doméstico",190,176,366,1087,1494,2581,0,0,0,0
"12228",2017-11-01,"sbmk","transporte não regular","voo internacional",1,1,2,1,0,1,0,0,0,0
"12229",2017-11-01,"sbmq","transporte regular","voo doméstico",198,203,401,22675,21279,43954,7660,35031,42691,0
"12230",2017-11-01,"sbmq","transporte regular","voo internacional",0,0,0,0,0,0,0,0,0,0
"12231",2017-11-01,"sbmq","transporte não regular","voo doméstico",155,148,303,153,263,416,0,0,0,0
"12232",2017-11-01,"sbmq","transporte não regular","voo internacional",2,2,4,0,0,0,0,0,0,0
"12233",2017-11-01,"sbmt","transporte regular","voo doméstico",0,0,0,0,0,0,0,0,0,0
"12234",2017-11-01,"sbmt","transporte regular","voo internacional",0,0,0,0,0,0,0,0,0,0
"12235",2017-11-01,"sbmt","transporte não regular","voo doméstico",2967,2957,5924,5110,5173,10283,0,0,0,0
"12236",2017-11-01,"sbmt","transporte não regular","voo internacional",0,0,0,0,0,0,0,0,0,0
"12237",2017-11-01,"sbnf","transporte regular","voo doméstico",632,632,1264,74845,75667,150512,0,0,0,0
"12238",2017-11-01,"sbnf","transporte regular","voo internacional",0,0,0,0,0,0,0,0,0,0
"12239",2017-11-01,"sbnf","transporte não regular","voo doméstico",258,256,514,1327,1102,2429,0,0,0,0
"12240",2017-11-01,"sbnf","transporte não regular","voo internacional",4,9,13,9,8,17,0,0,0,0
"12241",2017-11-01,"sbpb","transporte regular","voo doméstico",4,4,8,249,291,540,0,0,0,0
"12242",2017-11-01,"sbpb","transporte regular","voo internacional",0,0,0,0,0,0,0,0,0,0
"12243",2017-11-01,"sbpb","transporte não regular","voo doméstico",60,58,118,115,100,215,0,0,0,0
"12244",2017-11-01,"sbpb","transporte não regular","voo internacional",0,0,0,0,0,0,0,0,0,0
"12245",2017-11-01,"sbpj","transporte regular","voo doméstico",288,287,575,27042,27378,54420,0,0,0,0
"12246",2017-11-01,"sbpj","transporte regular","voo internacional",0,0,0,0,0,0,0,0,0,0
"12247",2017-11-01,"sbpj","transporte não regular","voo doméstico",228,224,452,472,128,600,0,0,0,0
"12248",2017-11-01,"sbpj","transporte não regular","voo internacional",1,1,2,0,0,0,0,0,0,0
"12249",2017-11-01,"sbpk","transporte regular","voo doméstico",26,26,52,1138,1230,2368,0,0,0,0
"12250",2017-11-01,"sbpk","transporte regular","voo internacional",0,0,0,0,0,0,0,0,0,0
"12251",2017-11-01,"sbpk","transporte não regular","voo doméstico",38,36,74,75,76,151,0,0,0,0
"12252",2017-11-01,"sbpk","transporte não regular","voo internacional",4,5,9,3,9,12,0,0,0,0
"12253",2017-11-01,"sbpl","transporte regular","voo doméstico",161,161,322,19816,19222,39038,0,0,0,0
"12254",2017-11-01,"sbpl","transporte regular","voo internacional",3,3,6,0,0,0,0,0,0,0
"12255",2017-11-01,"sbpl","transporte não regular","voo doméstico",72,72,144,131,99,230,0,0,0,0
"12256",2017-11-01,"sbpl","transporte não regular","voo internacional",5,5,10,0,0,0,0,0,0,0
"12257",2017-11-01,"sbpp","transporte regular","voo doméstico",0,0,0,0,0,0,0,0,0,0
"12258",2017-11-01,"sbpp","transporte regular","voo internacional",0,0,0,0,0,0,0,0,0,0
"12259",2017-11-01,"sbpp","transporte não regular","voo doméstico",123,122,245,275,163,438,0,0,0,0
"12260",2017-11-01,"sbpp","transporte não regular","voo internacional",6,8,14,5,4,9,0,0,0,0
"12261",2017-11-01,"sbpr","transporte regular","voo doméstico",0,0,0,0,0,0,0,0,0,0
"12262",2017-11-01,"sbpr","transporte regular","voo internacional",0,0,0,0,0,0,0,0,0,0
"12263",2017-11-01,"sbpr","transporte não regular","voo doméstico",656,663,1319,768,708,1476,0,0,0,0
"12264",2017-11-01,"sbpr","transporte não regular","voo internacional",4,3,7,0,0,0,0,0,0,0
"12265",2017-11-01,"sbpv","transporte regular","voo doméstico",286,287,573,32306,30908,63214,0,0,0,0
"12266",2017-11-01,"sbpv","transporte regular","voo internacional",0,0,0,0,0,0,0,0,0,0
"12267",2017-11-01,"sbpv","transporte não regular","voo doméstico",233,230,463,164,487,651,0,0,0,0
"12268",2017-11-01,"sbpv","transporte não regular","voo internacional",0,0,0,0,0,0,0,0,0,0
"12269",2017-11-01,"sbrb","transporte regular","voo doméstico",114,115,229,13700,13047,26747,0,364,364,0
"12270",2017-11-01,"sbrb","transporte regular","voo internacional",0,0,0,0,0,0,0,0,0,0
"12271",2017-11-01,"sbrb","transporte não regular","voo doméstico",133,130,263,542,273,815,0,0,0,0
"12272",2017-11-01,"sbrb","transporte não regular","voo internacional",1,1,2,0,0,0,0,0,0,0
"12273",2017-11-01,"sbrj","transporte regular","voo doméstico",3606,3620,7226,378671,379766,758437,0,0,0,0
"12274",2017-11-01,"sbrj","transporte regular","voo internacional",0,0,0,0,0,0,0,0,0,0
"12275",2017-11-01,"sbrj","transporte não regular","voo doméstico",627,613,1240,6683,5827,12510,0,0,0,0
"12276",2017-11-01,"sbrj","transporte não regular","voo internacional",0,0,0,0,0,0,0,0,0,0
"12277",2017-11-01,"sbsj","transporte regular","voo doméstico",0,0,0,0,0,0,0,0,0,0
"12278",2017-11-01,"sbsj","transporte regular","voo internacional",0,0,0,0,0,0,0,0,0,0
"12279",2017-11-01,"sbsj","transporte não regular","voo doméstico",419,403,822,1714,1559,3273,0,0,0,0
"12280",2017-11-01,"sbsj","transporte não regular","voo internacional",3,14,17,44,5,49,0,0,0,0
"12281",2017-11-01,"sbsl","transporte regular","voo doméstico",553,559,1112,65331,63134,128465,0,0,0,0
"12282",2017-11-01,"sbsl","transporte regular","voo internacional",0,0,0,0,0,0,0,0,0,0
"12283",2017-11-01,"sbsl","transporte não regular","voo doméstico",275,271,546,687,832,1519,58376,204525,262901,0
"12284",2017-11-01,"sbsl","transporte não regular","voo internacional",3,3,6,16,0,16,0,0,0,0
"12285",2017-11-01,"sbsn","transporte regular","voo doméstico",203,203,406,19751,18273,38024,0,0,0,0
"12286",2017-11-01,"sbsn","transporte regular","voo internacional",0,0,0,0,0,0,0,0,0,0
"12287",2017-11-01,"sbsn","transporte não regular","voo doméstico",229,227,456,219,133,352,4580,5850,10430,0
"12288",2017-11-01,"sbsn","transporte não regular","voo internacional",2,2,4,0,0,0,0,0,0,0
"12289",2017-11-01,"sbsp","transporte regular","voo doméstico",7085,7160,14245,913449,909121,1822570,0,0,0,0
"12290",2017-11-01,"sbsp","transporte regular","voo internacional",0,0,0,0,0,0,0,0,0,0
"12291",2017-11-01,"sbsp","transporte não regular","voo doméstico",2174,2101,4275,9511,10300,19811,0,0,0,0
"12292",2017-11-01,"sbsp","transporte não regular","voo internacional",4,4,8,8,8,16,0,0,0,0
"12293",2017-11-01,"sbte","transporte regular","voo doméstico",375,375,750,41574,41847,83421,41244,71891,113135,207511
"12294",2017-11-01,"sbte","transporte regular","voo internacional",0,0,0,0,0,0,0,0,0,0
"12295",2017-11-01,"sbte","transporte não regular","voo doméstico",201,199,400,1186,1182,2368,0,0,0,0
"12296",2017-11-01,"sbte","transporte não regular","voo internacional",1,1,2,0,0,0,0,0,0,0
"12297",2017-11-01,"sbtf","transporte regular","voo doméstico",27,27,54,1114,1215,2329,0,0,0,0
"12298",2017-11-01,"sbtf","transporte regular","voo internacional",0,0,0,0,0,0,0,0,0,0
"12299",2017-11-01,"sbtf","transporte não regular","voo doméstico",137,136,273,281,231,512,2598,2644,5242,15370
"12300",2017-11-01,"sbtf","transporte não regular","voo internacional",0,0,0,0,0,0,0,0,0,0
"12301",2017-11-01,"sbtt","transporte regular","voo doméstico",31,31,62,2782,3006,5788,0,0,0,0
"12302",2017-11-01,"sbtt","transporte regular","voo internacional",0,0,0,0,0,0,0,0,0,0
"12303",2017-11-01,"sbtt","transporte não regular","voo doméstico",114,115,229,460,425,885,1021,2031,3052,476
"12304",2017-11-01,"sbtt","transporte não regular","voo internacional",1,1,2,2,2,4,0,0,0,0
"12305",2017-11-01,"sbuf","transporte regular","voo doméstico",8,8,16,288,423,711,0,0,0,0
"12306",2017-11-01,"sbuf","transporte regular","voo internacional",0,0,0,0,0,0,0,0,0,0
"12307",2017-11-01,"sbuf","transporte não regular","voo doméstico",20,20,40,25,32,57,0,0,0,0
"12308",2017-11-01,"sbuf","transporte não regular","voo internacional",0,0,0,0,0,0,0,0,0,0
"12309",2017-11-01,"sbug","transporte regular","voo doméstico",15,15,30,760,764,1524,0,0,0,0
"12310",2017-11-01,"sbug","transporte regular","voo internacional",0,0,0,0,0,0,0,0,0,0
"12311",2017-11-01,"sbug","transporte não regular","voo doméstico",14,14,28,81,73,154,0,0,0,0
"12312",2017-11-01,"sbug","transporte não regular","voo internacional",1,1,2,0,0,0,0,0,0,0
"12313",2017-11-01,"sbul","transporte regular","voo doméstico",470,466,936,43922,43501,87423,0,0,0,0
"12314",2017-11-01,"sbul","transporte regular","voo internacional",0,0,0,0,0,0,0,0,0,0
"12315",2017-11-01,"sbul","transporte não regular","voo doméstico",495,494,989,2541,2240,4781,0,0,0,0
"12316",2017-11-01,"sbul","transporte não regular","voo internacional",0,0,0,0,0,0,0,0,0,0
"12317",2017-11-01,"sbur","transporte regular","voo doméstico",52,55,107,2344,2248,4592,0,0,0,0
"12318",2017-11-01,"sbur","transporte regular","voo internacional",0,0,0,0,0,0,0,0,0,0
"12319",2017-11-01,"sbur","transporte não regular","voo doméstico",178,174,352,540,529,1069,0,0,0,0
"12320",2017-11-01,"sbur","transporte não regular","voo internacional",0,0,0,0,0,0,0,0,0,0
"12321",2017-10-01,"sbbe","transporte regular","voo doméstico",1084,1079,2163,128425,125146,253571,86598,365763,452361,0
"12322",2017-10-01,"sbbe","transporte regular","voo internacional",41,40,81,5230,5093,10323,4,0,4,0
"12323",2017-10-01,"sbbe","transporte não regular","voo doméstico",435,447,882,3978,3438,7416,3335,70893,74228,0
"12324",2017-10-01,"sbbe","transporte não regular","voo internacional",9,8,17,66,10,76,0,0,0,0
"12325",2017-10-01,"sbbg","transporte regular","voo doméstico",0,0,0,0,0,0,0,0,0,0
"12326",2017-10-01,"sbbg","transporte regular","voo internacional",0,0,0,0,0,0,0,0,0,0
"12327",2017-10-01,"sbbg","transporte não regular","voo doméstico",17,16,33,75,100,175,0,0,0,0
"12328",2017-10-01,"sbbg","transporte não regular","voo internacional",3,3,6,2,10,12,0,0,0,0
"12329",2017-10-01,"sbbh","transporte regular","voo doméstico",46,46,92,2025,1820,3845,0,0,0,0
"12330",2017-10-01,"sbbh","transporte regular","voo internacional",0,0,0,0,0,0,0,0,0,0
"12331",2017-10-01,"sbbh","transporte não regular","voo doméstico",1793,1790,3583,9042,9035,18077,0,0,0,0
"12332",2017-10-01,"sbbh","transporte não regular","voo internacional",2,2,4,10,10,20,0,0,0,0
"12333",2017-10-01,"sbbi","transporte regular","voo doméstico",0,0,0,0,0,0,0,0,0,0
"12334",2017-10-01,"sbbi","transporte regular","voo internacional",0,0,0,0,0,0,0,0,0,0
"12335",2017-10-01,"sbbi","transporte não regular","voo doméstico",897,893,1790,2936,2873,5809,0,0,0,0
"12336",2017-10-01,"sbbi","transporte não regular","voo internacional",0,0,0,0,0,0,0,0,0,0
"12337",2017-10-01,"sbbv","transporte regular","voo doméstico",88,87,175,11261,10679,21940,0,0,0,0
"12338",2017-10-01,"sbbv","transporte regular","voo internacional",0,0,0,0,0,0,0,0,0,0
"12339",2017-10-01,"sbbv","transporte não regular","voo doméstico",126,128,254,573,243,816,0,0,0,0
"12340",2017-10-01,"sbbv","transporte não regular","voo internacional",22,22,44,1,5,6,0,0,0,0
"12341",2017-10-01,"sbcg","transporte regular","voo doméstico",540,547,1087,69677,66588,136265,3693,14470,18163,0
"12342",2017-10-01,"sbcg","transporte regular","voo internacional",0,0,0,0,0,0,0,0,0,0
"12343",2017-10-01,"sbcg","transporte não regular","voo doméstico",296,289,585,2422,3081,5503,66210,67788,133998,0
"12344",2017-10-01,"sbcg","transporte não regular","voo internacional",8,8,16,0,0,0,0,0,0,0
"12345",2017-10-01,"sbcj","transporte regular","voo doméstico",76,76,152,4243,4261,8504,0,0,0,0
"12346",2017-10-01,"sbcj","transporte regular","voo internacional",0,0,0,0,0,0,0,0,0,0
"12347",2017-10-01,"sbcj","transporte não regular","voo doméstico",92,90,182,590,217,807,0,0,0,0
"12348",2017-10-01,"sbcj","transporte não regular","voo internacional",0,0,0,0,0,0,0,0,0,0
"12349",2017-10-01,"sbcr","transporte regular","voo doméstico",18,18,36,1156,1214,2370,0,0,0,0
"12350",2017-10-01,"sbcr","transporte regular","voo internacional",0,0,0,0,0,0,0,0,0,0
"12351",2017-10-01,"sbcr","transporte não regular","voo doméstico",35,37,72,104,82,186,0,0,0,0
"12352",2017-10-01,"sbcr","transporte não regular","voo internacional",0,0,0,0,0,0,0,0,0,0
"12353",2017-10-01,"sbct","transporte regular","voo doméstico",2368,2429,4797,286400,280670,567070,115776,45552,161328,257279
"12354",2017-10-01,"sbct","transporte regular","voo internacional",62,62,124,2258,2153,4411,0,71436,71436,0
"12355",2017-10-01,"sbct","transporte não regular","voo doméstico",413,353,766,7083,12216,19299,0,0,0,0
"12356",2017-10-01,"sbct","transporte não regular","voo internacional",6,7,13,407,478,885,0,0,0,0
"12357",2017-10-01,"sbcz","transporte regular","voo doméstico",40,39,79,3018,3100,6118,0,0,0,0
"12358",2017-10-01,"sbcz","transporte regular","voo internacional",0,0,0,0,0,0,0,0,0,0
"12359",2017-10-01,"sbcz","transporte não regular","voo doméstico",178,181,359,674,659,1333,0,0,0,0
"12360",2017-10-01,"sbcz","transporte não regular","voo internacional",0,0,0,0,0,0,0,0,0,0
"12361",2017-10-01,"sbeg","transporte regular","voo doméstico",869,873,1742,106351,97854,204205,0,0,0,0
"12362",2017-10-01,"sbeg","transporte regular","voo internacional",105,112,217,4594,4620,9214,0,0,0,0
"12363",2017-10-01,"sbeg","transporte não regular","voo doméstico",630,606,1236,7284,4710,11994,0,0,0,0
"12364",2017-10-01,"sbeg","transporte não regular","voo internacional",73,77,150,882,1158,2040,0,0,0,0
"12365",2017-10-01,"sbfi","transporte regular","voo doméstico",636,634,1270,90366,89111,179477,0,0,0,0
"12366",2017-10-01,"sbfi","transporte regular","voo internacional",21,21,42,2803,2702,5505,0,0,0,0
"12367",2017-10-01,"sbfi","transporte não regular","voo doméstico",135,138,273,2743,1972,4715,0,0,0,0
"12368",2017-10-01,"sbfi","transporte não regular","voo internacional",41,41,82,67,85,152,0,0,0,0
"12369",2017-10-01,"sbgo","transporte regular","voo doméstico",1170,1174,2344,128471,127518,255989,105618,153938,259556,108511
"12370",2017-10-01,"sbgo","transporte regular","voo internacional",0,0,0,0,0,0,0,0,0,0
"12371",2017-10-01,"sbgo","transporte não regular","voo doméstico",1440,1424,2864,6157,6459,12616,0,0,0,0
"12372",2017-10-01,"sbgo","transporte não regular","voo internacional",3,2,5,0,0,0,0,0,0,0
"12373",2017-10-01,"sbht","transporte regular","voo doméstico",107,109,216,4330,4216,8546,0,0,0,0
"12374",2017-10-01,"sbht","transporte regular","voo internacional",0,0,0,0,0,0,0,0,0,0
"12375",2017-10-01,"sbht","transporte não regular","voo doméstico",76,74,150,75,215,290,0,0,0,0
"12376",2017-10-01,"sbht","transporte não regular","voo internacional",0,0,0,0,0,0,0,0,0,0
"12377",2017-10-01,"sbiz","transporte regular","voo doméstico",101,101,202,11453,11319,22772,0,0,0,0
"12378",2017-10-01,"sbiz","transporte regular","voo internacional",0,0,0,0,0,0,0,0,0,0
"12379",2017-10-01,"sbiz","transporte não regular","voo doméstico",139,140,279,402,358,760,0,0,0,0
"12380",2017-10-01,"sbiz","transporte não regular","voo internacional",0,0,0,0,0,0,0,0,0,0
"12381",2017-10-01,"sbjc","transporte regular","voo doméstico",0,0,0,0,0,0,0,0,0,0
"12382",2017-10-01,"sbjc","transporte regular","voo internacional",0,0,0,0,0,0,0,0,0,0
"12383",2017-10-01,"sbjc","transporte não regular","voo doméstico",381,373,754,802,641,1443,0,0,0,0
"12384",2017-10-01,"sbjc","transporte não regular","voo internacional",0,0,0,0,0,0,0,0,0,0
"12385",2017-10-01,"sbjr","transporte regular","voo doméstico",0,0,0,0,0,0,0,0,0,0
"12386",2017-10-01,"sbjr","transporte regular","voo internacional",0,0,0,0,0,0,0,0,0,0
"12387",2017-10-01,"sbjr","transporte não regular","voo doméstico",2372,2369,4741,10212,5533,15745,0,0,0,0
"12388",2017-10-01,"sbjr","transporte não regular","voo internacional",3,3,6,6,0,6,0,0,0,0
"12389",2017-10-01,"sbjv","transporte regular","voo doméstico",213,214,427,21746,21803,43549,0,0,0,0
"12390",2017-10-01,"sbjv","transporte regular","voo internacional",0,0,0,0,0,0,0,0,0,0
"12391",2017-10-01,"sbjv","transporte não regular","voo doméstico",101,101,202,105,199,304,0,0,0,0
"12392",2017-10-01,"sbjv","transporte não regular","voo internacional",0,0,0,0,0,0,0,0,0,0
"12393",2017-10-01,"sblo","transporte regular","voo doméstico",400,403,803,38813,37873,76686,0,0,0,0
"12394",2017-10-01,"sblo","transporte regular","voo internacional",0,0,0,0,0,0,0,0,0,0
"12395",2017-10-01,"sblo","transporte não regular","voo doméstico",481,479,960,535,1080,1615,0,0,0,0
"12396",2017-10-01,"sblo","transporte não regular","voo internacional",1,1,2,0,0,0,0,0,0,0
"12397",2017-10-01,"sbma","transporte regular","voo doméstico",130,128,258,10855,10707,21562,0,0,0,0
"12398",2017-10-01,"sbma","transporte regular","voo internacional",0,0,0,0,0,0,0,0,0,0
"12399",2017-10-01,"sbma","transporte não regular","voo doméstico",158,153,311,426,454,880,0,0,0,0
"12400",2017-10-01,"sbma","transporte não regular","voo internacional",0,0,0,0,0,0,0,0,0,0
"12401",2017-10-01,"sbmk","transporte regular","voo doméstico",110,118,228,10090,9850,19940,0,0,0,0
"12402",2017-10-01,"sbmk","transporte regular","voo internacional",0,0,0,0,0,0,0,0,0,0
"12403",2017-10-01,"sbmk","transporte não regular","voo doméstico",251,248,499,978,1077,2055,0,0,0,0
"12404",2017-10-01,"sbmk","transporte não regular","voo internacional",1,1,2,1,0,1,0,0,0,0
"12405",2017-10-01,"sbmq","transporte regular","voo doméstico",225,229,454,22418,21718,44136,10910,33700,44610,0
"12406",2017-10-01,"sbmq","transporte regular","voo internacional",0,0,0,0,0,0,0,0,0,0
"12407",2017-10-01,"sbmq","transporte não regular","voo doméstico",148,146,294,560,483,1043,0,0,0,0
"12408",2017-10-01,"sbmq","transporte não regular","voo internacional",2,3,5,0,0,0,0,0,0,0
"12409",2017-10-01,"sbmt","transporte regular","voo doméstico",0,0,0,0,0,0,0,0,0,0
"12410",2017-10-01,"sbmt","transporte regular","voo internacional",0,0,0,0,0,0,0,0,0,0
"12411",2017-10-01,"sbmt","transporte não regular","voo doméstico",2925,2916,5841,5189,5273,10462,0,0,0,0
"12412",2017-10-01,"sbmt","transporte não regular","voo internacional",6,3,9,0,0,0,0,0,0,0
"12413",2017-10-01,"sbnf","transporte regular","voo doméstico",606,614,1220,74540,75049,149589,0,0,0,0
"12414",2017-10-01,"sbnf","transporte regular","voo internacional",0,0,0,0,0,0,0,0,0,0
"12415",2017-10-01,"sbnf","transporte não regular","voo doméstico",275,269,544,3676,3930,7606,0,0,0,0
"12416",2017-10-01,"sbnf","transporte não regular","voo internacional",2,2,4,6,0,6,0,0,0,0
"12417",2017-10-01,"sbpb","transporte regular","voo doméstico",4,4,8,304,351,655,0,0,0,0
"12418",2017-10-01,"sbpb","transporte regular","voo internacional",0,0,0,0,0,0,0,0,0,0
"12419",2017-10-01,"sbpb","transporte não regular","voo doméstico",62,64,126,141,106,247,0,0,0,0
"12420",2017-10-01,"sbpb","transporte não regular","voo internacional",0,0,0,0,0,0,0,0,0,0
"12421",2017-10-01,"sbpj","transporte regular","voo doméstico",301,299,600,27789,27765,55554,0,0,0,0
"12422",2017-10-01,"sbpj","transporte regular","voo internacional",0,0,0,0,0,0,0,0,0,0
"12423",2017-10-01,"sbpj","transporte não regular","voo doméstico",273,277,550,540,363,903,0,0,0,0
"12424",2017-10-01,"sbpj","transporte não regular","voo internacional",3,3,6,0,0,0,0,0,0,0
"12425",2017-10-01,"sbpk","transporte regular","voo doméstico",22,23,45,1040,914,1954,0,0,0,0
"12426",2017-10-01,"sbpk","transporte regular","voo internacional",0,0,0,0,0,0,0,0,0,0
"12427",2017-10-01,"sbpk","transporte não regular","voo doméstico",33,32,65,62,55,117,0,0,0,0
"12428",2017-10-01,"sbpk","transporte não regular","voo internacional",1,3,4,0,0,0,0,0,0,0
"12429",2017-10-01,"sbpl","transporte regular","voo doméstico",165,136,301,17833,18812,36645,0,0,0,0
"12430",2017-10-01,"sbpl","transporte regular","voo internacional",5,5,10,0,0,0,0,0,0,0
"12431",2017-10-01,"sbpl","transporte não regular","voo doméstico",77,103,180,2828,85,2913,0,0,0,0
"12432",2017-10-01,"sbpl","transporte não regular","voo internacional",2,2,4,0,0,0,0,0,0,0
"12433",2017-10-01,"sbpp","transporte regular","voo doméstico",0,0,0,0,0,0,0,0,0,0
"12434",2017-10-01,"sbpp","transporte regular","voo internacional",0,0,0,0,0,0,0,0,0,0
"12435",2017-10-01,"sbpp","transporte não regular","voo doméstico",101,98,199,135,130,265,0,0,0,0
"12436",2017-10-01,"sbpp","transporte não regular","voo internacional",8,10,18,18,12,30,0,0,0,0
"12437",2017-10-01,"sbpr","transporte regular","voo doméstico",0,0,0,0,0,0,0,0,0,0
"12438",2017-10-01,"sbpr","transporte regular","voo internacional",0,0,0,0,0,0,0,0,0,0
"12439",2017-10-01,"sbpr","transporte não regular","voo doméstico",795,790,1585,1007,882,1889,0,0,0,0
"12440",2017-10-01,"sbpr","transporte não regular","voo internacional",1,2,3,0,0,0,0,0,0,0
"12441",2017-10-01,"sbpv","transporte regular","voo doméstico",289,288,577,32091,32374,64465,0,0,0,0
"12442",2017-10-01,"sbpv","transporte regular","voo internacional",0,0,0,0,0,0,0,0,0,0
"12443",2017-10-01,"sbpv","transporte não regular","voo doméstico",213,211,424,104,101,205,0,0,0,0
"12444",2017-10-01,"sbpv","transporte não regular","voo internacional",1,1,2,0,0,0,0,0,0,0
"12445",2017-10-01,"sbrb","transporte regular","voo doméstico",116,115,231,12607,12615,25222,0,0,0,0
"12446",2017-10-01,"sbrb","transporte regular","voo internacional",0,0,0,0,0,0,0,0,0,0
"12447",2017-10-01,"sbrb","transporte não regular","voo doméstico",150,149,299,583,285,868,0,0,0,0
"12448",2017-10-01,"sbrb","transporte não regular","voo internacional",2,2,4,1,0,1,0,0,0,0
"12449",2017-10-01,"sbrj","transporte regular","voo doméstico",3643,3682,7325,391922,385273,777195,0,0,0,0
"12450",2017-10-01,"sbrj","transporte regular","voo internacional",0,0,0,0,0,0,0,0,0,0
"12451",2017-10-01,"sbrj","transporte não regular","voo doméstico",644,603,1247,7302,9318,16620,0,0,0,0
"12452",2017-10-01,"sbrj","transporte não regular","voo internacional",2,2,4,0,0,0,0,0,0,0
"12453",2017-10-01,"sbsj","transporte regular","voo doméstico",0,0,0,0,0,0,0,0,0,0
"12454",2017-10-01,"sbsj","transporte regular","voo internacional",0,0,0,0,0,0,0,0,0,0
"12455",2017-10-01,"sbsj","transporte não regular","voo doméstico",399,389,788,1328,1274,2602,0,0,0,0
"12456",2017-10-01,"sbsj","transporte não regular","voo internacional",3,9,12,4,2,6,0,0,0,0
"12457",2017-10-01,"sbsl","transporte regular","voo doméstico",562,562,1124,64778,63150,127928,0,0,0,0
"12458",2017-10-01,"sbsl","transporte regular","voo internacional",0,0,0,0,0,0,0,0,0,0
"12459",2017-10-01,"sbsl","transporte não regular","voo doméstico",223,219,442,950,1113,2063,51501,147605,199106,0
"12460",2017-10-01,"sbsl","transporte não regular","voo internacional",1,2,3,0,0,0,0,0,0,0
"12461",2017-10-01,"sbsn","transporte regular","voo doméstico",207,206,413,19781,19517,39298,0,0,0,0
"12462",2017-10-01,"sbsn","transporte regular","voo internacional",0,0,0,0,0,0,0,0,0,0
"12463",2017-10-01,"sbsn","transporte não regular","voo doméstico",258,258,516,883,429,1312,0,0,0,0
"12464",2017-10-01,"sbsn","transporte não regular","voo internacional",4,4,8,0,0,0,0,0,0,0
"12465",2017-10-01,"sbsp","transporte regular","voo doméstico",7343,7381,14724,960938,927298,1888236,0,0,0,0
"12466",2017-10-01,"sbsp","transporte regular","voo internacional",0,0,0,0,0,0,0,0,0,0
"12467",2017-10-01,"sbsp","transporte não regular","voo doméstico",2194,2142,4336,11853,11629,23482,0,0,0,0
"12468",2017-10-01,"sbsp","transporte não regular","voo internacional",6,6,12,10,14,24,0,0,0,0
"12469",2017-10-01,"sbte","transporte regular","voo doméstico",385,385,770,43843,41109,84952,23772,68831,92603,179738
"12470",2017-10-01,"sbte","transporte regular","voo internacional",0,0,0,0,0,0,0,0,0,0
"12471",2017-10-01,"sbte","transporte não regular","voo doméstico",206,205,411,1233,1280,2513,0,30749,30749,920
"12472",2017-10-01,"sbte","transporte não regular","voo internacional",0,0,0,0,0,0,0,0,0,0
"12473",2017-10-01,"sbtf","transporte regular","voo doméstico",31,31,62,1304,1446,2750,0,0,0,0
"12474",2017-10-01,"sbtf","transporte regular","voo internacional",0,0,0,0,0,0,0,0,0,0
"12475",2017-10-01,"sbtf","transporte não regular","voo doméstico",116,116,232,210,203,413,1180,4171,5351,13512
"12476",2017-10-01,"sbtf","transporte não regular","voo internacional",0,0,0,0,0,0,0,0,0,0
"12477",2017-10-01,"sbtt","transporte regular","voo doméstico",32,32,64,2468,2908,5376,0,0,0,0
"12478",2017-10-01,"sbtt","transporte regular","voo internacional",0,0,0,0,0,0,0,0,0,0
"12479",2017-10-01,"sbtt","transporte não regular","voo doméstico",80,80,160,308,296,604,1351,3177,4528,718
"12480",2017-10-01,"sbtt","transporte não regular","voo internacional",0,0,0,0,0,0,0,0,0,0
"12481",2017-10-01,"sbuf","transporte regular","voo doméstico",8,8,16,406,386,792,0,0,0,0
"12482",2017-10-01,"sbuf","transporte regular","voo internacional",0,0,0,0,0,0,0,0,0,0
"12483",2017-10-01,"sbuf","transporte não regular","voo doméstico",17,17,34,75,48,123,0,0,0,0
"12484",2017-10-01,"sbuf","transporte não regular","voo internacional",0,0,0,0,0,0,0,0,0,0
"12485",2017-10-01,"sbug","transporte regular","voo doméstico",16,16,32,884,822,1706,0,0,0,0
"12486",2017-10-01,"sbug","transporte regular","voo internacional",0,0,0,0,0,0,0,0,0,0
"12487",2017-10-01,"sbug","transporte não regular","voo doméstico",13,13,26,58,57,115,0,0,0,0
"12488",2017-10-01,"sbug","transporte não regular","voo internacional",0,0,0,0,0,0,0,0,0,0
"12489",2017-10-01,"sbul","transporte regular","voo doméstico",463,452,915,45371,45261,90632,0,0,0,0
"12490",2017-10-01,"sbul","transporte regular","voo internacional",0,0,0,0,0,0,0,0,0,0
"12491",2017-10-01,"sbul","transporte não regular","voo doméstico",573,592,1165,3365,2373,5738,0,0,0,0
"12492",2017-10-01,"sbul","transporte não regular","voo internacional",2,2,4,17,12,29,0,0,0,0
"12493",2017-10-01,"sbur","transporte regular","voo doméstico",50,49,99,2262,2237,4499,0,0,0,0
"12494",2017-10-01,"sbur","transporte regular","voo internacional",0,0,0,0,0,0,0,0,0,0
"12495",2017-10-01,"sbur","transporte não regular","voo doméstico",174,182,356,565,536,1101,0,0,0,0
"12496",2017-10-01,"sbur","transporte não regular","voo internacional",0,0,0,0,0,0,0,0,0,0
"12497",2017-09-01,"sbbe","transporte regular","voo doméstico",988,993,1981,120220,120157,240377,77388,288915,366303,0
"12498",2017-09-01,"sbbe","transporte regular","voo internacional",42,43,85,6400,5344,11744,0,0,0,0
"12499",2017-09-01,"sbbe","transporte não regular","voo doméstico",431,423,854,1492,1765,3257,0,64137,64137,0
"12500",2017-09-01,"sbbe","transporte não regular","voo internacional",2,3,5,254,164,418,0,0,0,0
"12501",2017-09-01,"sbbg","transporte regular","voo doméstico",0,0,0,0,0,0,0,0,0,0
"12502",2017-09-01,"sbbg","transporte regular","voo internacional",0,0,0,0,0,0,0,0,0,0
"12503",2017-09-01,"sbbg","transporte não regular","voo doméstico",12,13,25,48,55,103,0,0,0,0
"12504",2017-09-01,"sbbg","transporte não regular","voo internacional",1,1,2,3,0,3,0,0,0,0
"12505",2017-09-01,"sbbh","transporte regular","voo doméstico",50,50,100,1944,2011,3955,0,0,0,0
"12506",2017-09-01,"sbbh","transporte regular","voo internacional",0,0,0,0,0,0,0,0,0,0
"12507",2017-09-01,"sbbh","transporte não regular","voo doméstico",1789,1793,3582,8575,8533,17108,0,0,0,0
"12508",2017-09-01,"sbbh","transporte não regular","voo internacional",4,4,8,23,23,46,0,0,0,0
"12509",2017-09-01,"sbbi","transporte regular","voo doméstico",0,0,0,0,0,0,0,0,0,0
"12510",2017-09-01,"sbbi","transporte regular","voo internacional",0,0,0,0,0,0,0,0,0,0
"12511",2017-09-01,"sbbi","transporte não regular","voo doméstico",1197,1178,2375,3292,3309,6601,0,0,0,0
"12512",2017-09-01,"sbbi","transporte não regular","voo internacional",0,0,0,0,0,0,0,0,0,0
"12513",2017-09-01,"sbbv","transporte regular","voo doméstico",84,84,168,10983,9838,20821,0,0,0,0
"12514",2017-09-01,"sbbv","transporte regular","voo internacional",0,0,0,0,0,0,0,0,0,0
"12515",2017-09-01,"sbbv","transporte não regular","voo doméstico",125,130,255,603,303,906,0,0,0,0
"12516",2017-09-01,"sbbv","transporte não regular","voo internacional",17,10,27,1,0,1,0,0,0,0
"12517",2017-09-01,"sbcg","transporte regular","voo doméstico",528,543,1071,65116,62370,127486,3802,4151,7953,0
"12518",2017-09-01,"sbcg","transporte regular","voo internacional",0,0,0,0,0,0,0,0,0,0
"12519",2017-09-01,"sbcg","transporte não regular","voo doméstico",290,284,574,831,2414,3245,58608,70343,128951,0
"12520",2017-09-01,"sbcg","transporte não regular","voo internacional",11,8,19,0,0,0,0,0,0,0
"12521",2017-09-01,"sbcj","transporte regular","voo doméstico",79,79,158,4817,4370,9187,0,0,0,0
"12522",2017-09-01,"sbcj","transporte regular","voo internacional",0,0,0,0,0,0,0,0,0,0
"12523",2017-09-01,"sbcj","transporte não regular","voo doméstico",97,97,194,614,281,895,0,0,0,0
"12524",2017-09-01,"sbcj","transporte não regular","voo internacional",0,0,0,0,0,0,0,0,0,0
"12525",2017-09-01,"sbcr","transporte regular","voo doméstico",17,17,34,1265,1164,2429,0,0,0,0
"12526",2017-09-01,"sbcr","transporte regular","voo internacional",0,0,0,0,0,0,0,0,0,0
"12527",2017-09-01,"sbcr","transporte não regular","voo doméstico",48,46,94,130,130,260,0,0,0,0
"12528",2017-09-01,"sbcr","transporte não regular","voo internacional",3,3,6,1,6,7,0,0,0,0
"12529",2017-09-01,"sbct","transporte regular","voo doméstico",2412,2461,4873,285991,279833,565824,81394,54915,136309,237570
"12530",2017-09-01,"sbct","transporte regular","voo internacional",55,56,111,2103,2256,4359,0,73109,73109,0
"12531",2017-09-01,"sbct","transporte não regular","voo doméstico",367,319,686,6599,11723,18322,0,0,0,0
"12532",2017-09-01,"sbct","transporte não regular","voo internacional",17,12,29,362,348,710,0,0,0,0
"12533",2017-09-01,"sbcz","transporte regular","voo doméstico",41,41,82,3182,3026,6208,0,0,0,0
"12534",2017-09-01,"sbcz","transporte regular","voo internacional",0,0,0,0,0,0,0,0,0,0
"12535",2017-09-01,"sbcz","transporte não regular","voo doméstico",209,206,415,833,831,1664,0,0,0,0
"12536",2017-09-01,"sbcz","transporte não regular","voo internacional",0,0,0,0,0,0,0,0,0,0
"12537",2017-09-01,"sbeg","transporte regular","voo doméstico",825,815,1640,99475,92416,191891,0,431,431,0
"12538",2017-09-01,"sbeg","transporte regular","voo internacional",83,88,171,4137,3495,7632,0,0,0,0
"12539",2017-09-01,"sbeg","transporte não regular","voo doméstico",587,591,1178,9088,5330,14418,0,0,0,0
"12540",2017-09-01,"sbeg","transporte não regular","voo internacional",80,82,162,607,1636,2243,0,0,0,0
"12541",2017-09-01,"sbfi","transporte regular","voo doméstico",613,611,1224,84515,83936,168451,0,0,0,0
"12542",2017-09-01,"sbfi","transporte regular","voo internacional",21,21,42,2802,2582,5384,0,0,0,0
"12543",2017-09-01,"sbfi","transporte não regular","voo doméstico",181,178,359,2285,2711,4996,0,0,0,0
"12544",2017-09-01,"sbfi","transporte não regular","voo internacional",39,47,86,218,222,440,0,0,0,0
"12545",2017-09-01,"sbgo","transporte regular","voo doméstico",1140,1140,2280,123787,120786,244573,98352,153520,251872,99325
"12546",2017-09-01,"sbgo","transporte regular","voo internacional",0,0,0,0,0,0,0,0,0,0
"12547",2017-09-01,"sbgo","transporte não regular","voo doméstico",1484,1480,2964,6735,6056,12791,0,0,0,0
"12548",2017-09-01,"sbgo","transporte não regular","voo internacional",1,2,3,0,0,0,0,0,0,0
"12549",2017-09-01,"sbht","transporte regular","voo doméstico",115,115,230,4153,3926,8079,0,0,0,0
"12550",2017-09-01,"sbht","transporte regular","voo internacional",0,0,0,0,0,0,0,0,0,0
"12551",2017-09-01,"sbht","transporte não regular","voo doméstico",58,58,116,209,130,339,0,0,0,0
"12552",2017-09-01,"sbht","transporte não regular","voo internacional",0,0,0,0,0,0,0,0,0,0
"12553",2017-09-01,"sbiz","transporte regular","voo doméstico",94,94,188,11828,11290,23118,0,0,0,0
"12554",2017-09-01,"sbiz","transporte regular","voo internacional",0,0,0,0,0,0,0,0,0,0
"12555",2017-09-01,"sbiz","transporte não regular","voo doméstico",161,162,323,433,426,859,0,0,0,0
"12556",2017-09-01,"sbiz","transporte não regular","voo internacional",1,0,1,0,0,0,0,0,0,0
"12557",2017-09-01,"sbjc","transporte regular","voo doméstico",0,0,0,0,0,0,0,0,0,0
"12558",2017-09-01,"sbjc","transporte regular","voo internacional",0,0,0,0,0,0,0,0,0,0
"12559",2017-09-01,"sbjc","transporte não regular","voo doméstico",386,391,777,712,627,1339,0,0,0,0
"12560",2017-09-01,"sbjc","transporte não regular","voo internacional",0,0,0,0,0,0,0,0,0,0
"12561",2017-09-01,"sbjr","transporte regular","voo doméstico",0,0,0,0,0,0,0,0,0,0
"12562",2017-09-01,"sbjr","transporte regular","voo internacional",0,0,0,0,0,0,0,0,0,0
"12563",2017-09-01,"sbjr","transporte não regular","voo doméstico",2668,2681,5349,10710,6285,16995,0,0,0,0
"12564",2017-09-01,"sbjr","transporte não regular","voo internacional",4,4,8,4,0,4,0,0,0,0
"12565",2017-09-01,"sbjv","transporte regular","voo doméstico",203,203,406,19391,19028,38419,0,0,0,0
"12566",2017-09-01,"sbjv","transporte regular","voo internacional",0,0,0,0,0,0,0,0,0,0
"12567",2017-09-01,"sbjv","transporte não regular","voo doméstico",129,131,260,279,274,553,0,0,0,0
"12568",2017-09-01,"sbjv","transporte não regular","voo internacional",0,0,0,0,0,0,0,0,0,0
"12569",2017-09-01,"sblo","transporte regular","voo doméstico",381,380,761,37353,37104,74457,0,0,0,0
"12570",2017-09-01,"sblo","transporte regular","voo internacional",0,0,0,0,0,0,0,0,0,0
"12571",2017-09-01,"sblo","transporte não regular","voo doméstico",658,657,1315,1564,985,2549,0,0,0,0
"12572",2017-09-01,"sblo","transporte não regular","voo internacional",4,4,8,0,0,0,0,0,0,0
"12573",2017-09-01,"sbma","transporte regular","voo doméstico",124,124,248,10785,10080,20865,0,0,0,0
"12574",2017-09-01,"sbma","transporte regular","voo internacional",0,0,0,0,0,0,0,0,0,0
"12575",2017-09-01,"sbma","transporte não regular","voo doméstico",157,160,317,491,503,994,0,0,0,0
"12576",2017-09-01,"sbma","transporte não regular","voo internacional",0,0,0,0,0,0,0,0,0,0
"12577",2017-09-01,"sbmk","transporte regular","voo doméstico",104,114,218,9982,8978,18960,0,0,0,0
"12578",2017-09-01,"sbmk","transporte regular","voo internacional",0,0,0,0,0,0,0,0,0,0
"12579",2017-09-01,"sbmk","transporte não regular","voo doméstico",232,222,454,687,961,1648,0,0,0,0
"12580",2017-09-01,"sbmk","transporte não regular","voo internacional",2,2,4,0,0,0,0,0,0,0
"12581",2017-09-01,"sbmq","transporte regular","voo doméstico",212,212,424,23394,22921,46315,11900,34200,46100,0
"12582",2017-09-01,"sbmq","transporte regular","voo internacional",0,0,0,0,0,0,0,0,0,0
"12583",2017-09-01,"sbmq","transporte não regular","voo doméstico",117,113,230,164,65,229,0,0,0,0
"12584",2017-09-01,"sbmq","transporte não regular","voo internacional",5,3,8,0,0,0,0,0,0,0
"12585",2017-09-01,"sbmt","transporte regular","voo doméstico",0,1,1,0,0,0,0,0,0,0
"12586",2017-09-01,"sbmt","transporte regular","voo internacional",0,0,0,0,0,0,0,0,0,0
"12587",2017-09-01,"sbmt","transporte não regular","voo doméstico",3421,3435,6856,5874,5865,11739,0,1,1,0
"12588",2017-09-01,"sbmt","transporte não regular","voo internacional",3,3,6,0,0,0,0,0,0,0
"12589",2017-09-01,"sbnf","transporte regular","voo doméstico",581,579,1160,64992,66987,131979,0,0,0,0
"12590",2017-09-01,"sbnf","transporte regular","voo internacional",0,0,0,0,0,0,0,0,0,0
"12591",2017-09-01,"sbnf","transporte não regular","voo doméstico",252,252,504,1590,1521,3111,0,0,0,0
"12592",2017-09-01,"sbnf","transporte não regular","voo internacional",3,3,6,4,6,10,0,0,0,0
"12593",2017-09-01,"sbpb","transporte regular","voo doméstico",5,5,10,332,422,754,0,0,0,0
"12594",2017-09-01,"sbpb","transporte regular","voo internacional",0,0,0,0,0,0,0,0,0,0
"12595",2017-09-01,"sbpb","transporte não regular","voo doméstico",128,126,254,256,283,539,0,0,0,0
"12596",2017-09-01,"sbpb","transporte não regular","voo internacional",0,0,0,0,0,0,0,0,0,0
"12597",2017-09-01,"sbpj","transporte regular","voo doméstico",286,285,571,27270,26148,53418,0,0,0,0
"12598",2017-09-01,"sbpj","transporte regular","voo internacional",0,0,0,0,0,0,0,0,0,0
"12599",2017-09-01,"sbpj","transporte não regular","voo doméstico",273,269,542,583,277,860,0,0,0,0
"12600",2017-09-01,"sbpj","transporte não regular","voo internacional",1,0,1,0,0,0,0,0,0,0
"12601",2017-09-01,"sbpk","transporte regular","voo doméstico",16,15,31,712,887,1599,0,0,0,0
"12602",2017-09-01,"sbpk","transporte regular","voo internacional",0,0,0,0,0,0,0,0,0,0
"12603",2017-09-01,"sbpk","transporte não regular","voo doméstico",23,21,44,53,50,103,0,0,0,0
"12604",2017-09-01,"sbpk","transporte não regular","voo internacional",0,1,1,0,0,0,0,0,0,0
"12605",2017-09-01,"sbpl","transporte regular","voo doméstico",159,160,319,20649,18199,38848,0,0,0,0
"12606",2017-09-01,"sbpl","transporte regular","voo internacional",4,4,8,0,0,0,0,0,0,0
"12607",2017-09-01,"sbpl","transporte não regular","voo doméstico",82,86,168,235,244,479,0,0,0,0
"12608",2017-09-01,"sbpl","transporte não regular","voo internacional",1,1,2,0,0,0,0,0,0,0
"12609",2017-09-01,"sbpp","transporte regular","voo doméstico",0,0,0,0,0,0,0,0,0,0
"12610",2017-09-01,"sbpp","transporte regular","voo internacional",0,0,0,0,0,0,0,0,0,0
"12611",2017-09-01,"sbpp","transporte não regular","voo doméstico",109,111,220,154,164,318,0,0,0,0
"12612",2017-09-01,"sbpp","transporte não regular","voo internacional",9,8,17,6,5,11,0,0,0,0
"12613",2017-09-01,"sbpr","transporte regular","voo doméstico",0,0,0,0,0,0,0,0,0,0
"12614",2017-09-01,"sbpr","transporte regular","voo internacional",0,0,0,0,0,0,0,0,0,0
"12615",2017-09-01,"sbpr","transporte não regular","voo doméstico",982,977,1959,1194,1028,2222,0,0,0,0
"12616",2017-09-01,"sbpr","transporte não regular","voo internacional",10,10,20,0,0,0,0,0,0,0
"12617",2017-09-01,"sbpv","transporte regular","voo doméstico",308,309,617,32893,31077,63970,0,0,0,0
"12618",2017-09-01,"sbpv","transporte regular","voo internacional",0,0,0,0,0,0,0,0,0,0
"12619",2017-09-01,"sbpv","transporte não regular","voo doméstico",213,213,426,47,0,47,0,0,0,0
"12620",2017-09-01,"sbpv","transporte não regular","voo internacional",0,0,0,0,0,0,0,0,0,0
"12621",2017-09-01,"sbrb","transporte regular","voo doméstico",115,116,231,11824,12007,23831,0,0,0,0
"12622",2017-09-01,"sbrb","transporte regular","voo internacional",0,0,0,0,0,0,0,0,0,0
"12623",2017-09-01,"sbrb","transporte não regular","voo doméstico",131,132,263,456,321,777,0,0,0,0
"12624",2017-09-01,"sbrb","transporte não regular","voo internacional",0,0,0,0,0,0,0,0,0,0
"12625",2017-09-01,"sbrj","transporte regular","voo doméstico",3738,3745,7483,393566,401841,795407,0,366,366,0
"12626",2017-09-01,"sbrj","transporte regular","voo internacional",0,0,0,0,0,0,0,0,0,0
"12627",2017-09-01,"sbrj","transporte não regular","voo doméstico",638,628,1266,4641,3989,8630,0,0,0,0
"12628",2017-09-01,"sbrj","transporte não regular","voo internacional",3,3,6,0,0,0,0,0,0,0
"12629",2017-09-01,"sbsj","transporte regular","voo doméstico",0,0,0,0,0,0,0,0,0,0
"12630",2017-09-01,"sbsj","transporte regular","voo internacional",0,0,0,0,0,0,0,0,0,0
"12631",2017-09-01,"sbsj","transporte não regular","voo doméstico",456,443,899,1252,1331,2583,0,0,0,0
"12632",2017-09-01,"sbsj","transporte não regular","voo internacional",3,13,16,37,6,43,0,0,0,0
"12633",2017-09-01,"sbsl","transporte regular","voo doméstico",519,519,1038,65320,64666,129986,0,0,0,0
"12634",2017-09-01,"sbsl","transporte regular","voo internacional",0,0,0,0,0,0,0,0,0,0
"12635",2017-09-01,"sbsl","transporte não regular","voo doméstico",236,237,473,761,562,1323,58352,162822,221174,0
"12636",2017-09-01,"sbsl","transporte não regular","voo internacional",2,2,4,0,0,0,0,0,0,0
"12637",2017-09-01,"sbsn","transporte regular","voo doméstico",180,180,360,19292,18512,37804,0,0,0,0
"12638",2017-09-01,"sbsn","transporte regular","voo internacional",0,0,0,0,0,0,0,0,0,0
"12639",2017-09-01,"sbsn","transporte não regular","voo doméstico",274,276,550,1007,579,1586,1918,2530,4448,0
"12640",2017-09-01,"sbsn","transporte não regular","voo internacional",0,1,1,0,0,0,0,0,0,0
"12641",2017-09-01,"sbsp","transporte regular","voo doméstico",7075,7109,14184,907525,868670,1776195,0,0,0,0
"12642",2017-09-01,"sbsp","transporte regular","voo internacional",0,0,0,0,0,0,0,0,0,0
"12643",2017-09-01,"sbsp","transporte não regular","voo doméstico",2087,2054,4141,13941,13455,27396,0,0,0,0
"12644",2017-09-01,"sbsp","transporte não regular","voo internacional",7,8,15,14,14,28,0,0,0,0
"12645",2017-09-01,"sbte","transporte regular","voo doméstico",377,377,754,40956,40592,81548,22825,75259,98084,179550
"12646",2017-09-01,"sbte","transporte regular","voo internacional",0,0,0,0,0,0,0,0,0,0
"12647",2017-09-01,"sbte","transporte não regular","voo doméstico",180,185,365,1519,1323,2842,0,0,0,0
"12648",2017-09-01,"sbte","transporte não regular","voo internacional",0,0,0,0,0,0,0,0,0,0
"12649",2017-09-01,"sbtf","transporte regular","voo doméstico",31,31,62,1288,1344,2632,0,0,0,0
"12650",2017-09-01,"sbtf","transporte regular","voo internacional",0,0,0,0,0,0,0,0,0,0
"12651",2017-09-01,"sbtf","transporte não regular","voo doméstico",101,102,203,181,125,306,1803,2356,4159,13615
"12652",2017-09-01,"sbtf","transporte não regular","voo internacional",0,0,0,0,0,0,0,0,0,0
"12653",2017-09-01,"sbtt","transporte regular","voo doméstico",30,30,60,2583,2721,5304,0,428,428,0
"12654",2017-09-01,"sbtt","transporte regular","voo internacional",0,0,0,0,0,0,0,0,0,0
"12655",2017-09-01,"sbtt","transporte não regular","voo doméstico",74,74,148,327,310,637,478,985,1463,240
"12656",2017-09-01,"sbtt","transporte não regular","voo internacional",0,0,0,0,0,0,0,0,0,0
"12657",2017-09-01,"sbuf","transporte regular","voo doméstico",7,7,14,388,334,722,0,0,0,0
"12658",2017-09-01,"sbuf","transporte regular","voo internacional",0,0,0,0,0,0,0,0,0,0
"12659",2017-09-01,"sbuf","transporte não regular","voo doméstico",27,27,54,121,118,239,0,0,0,0
"12660",2017-09-01,"sbuf","transporte não regular","voo internacional",0,0,0,0,0,0,0,0,0,0
"12661",2017-09-01,"sbug","transporte regular","voo doméstico",12,12,24,597,666,1263,0,0,0,0
"12662",2017-09-01,"sbug","transporte regular","voo internacional",0,0,0,0,0,0,0,0,0,0
"12663",2017-09-01,"sbug","transporte não regular","voo doméstico",14,12,26,123,90,213,0,0,0,0
"12664",2017-09-01,"sbug","transporte não regular","voo internacional",0,0,0,0,0,0,0,0,0,0
"12665",2017-09-01,"sbul","transporte regular","voo doméstico",429,428,857,42169,42830,84999,0,0,0,0
"12666",2017-09-01,"sbul","transporte regular","voo internacional",0,0,0,0,0,0,0,0,0,0
"12667",2017-09-01,"sbul","transporte não regular","voo doméstico",675,669,1344,4152,4119,8271,0,0,0,0
"12668",2017-09-01,"sbul","transporte não regular","voo internacional",3,3,6,15,16,31,0,0,0,0
"12669",2017-09-01,"sbur","transporte regular","voo doméstico",40,42,82,2300,2216,4516,0,0,0,0
"12670",2017-09-01,"sbur","transporte regular","voo internacional",0,0,0,0,0,0,0,0,0,0
"12671",2017-09-01,"sbur","transporte não regular","voo doméstico",241,229,470,874,1010,1884,0,0,0,0
"12672",2017-09-01,"sbur","transporte não regular","voo internacional",0,0,0,0,0,0,0,0,0,0
"12673",2018-04-01,"sbbe","transporte regular","voo doméstico",1007,1004,2011,120045,117820,237865,88076,290105,378181,0
"12674",2018-04-01,"sbbe","transporte regular","voo internacional",56,55,111,7418,6400,13818,2,25,27,0
"12675",2018-04-01,"sbbe","transporte não regular","voo doméstico",418,419,837,1343,1413,2756,0,0,0,0
"12676",2018-04-01,"sbbe","transporte não regular","voo internacional",11,10,21,119,52,171,0,0,0,0
"12677",2018-04-01,"sbbg","transporte regular","voo doméstico",0,0,0,0,0,0,0,0,0,0
"12678",2018-04-01,"sbbg","transporte regular","voo internacional",0,0,0,0,0,0,0,0,0,0
"12679",2018-04-01,"sbbg","transporte não regular","voo doméstico",9,10,19,40,34,74,0,0,0,0
"12680",2018-04-01,"sbbg","transporte não regular","voo internacional",2,2,4,1,0,1,0,0,0,0
"12681",2018-04-01,"sbbh","transporte regular","voo doméstico",70,70,140,2165,2235,4400,0,0,0,0
"12682",2018-04-01,"sbbh","transporte regular","voo internacional",0,0,0,0,0,0,0,0,0,0
"12683",2018-04-01,"sbbh","transporte não regular","voo doméstico",1652,1643,3295,7746,7786,15532,0,0,0,0
"12684",2018-04-01,"sbbh","transporte não regular","voo internacional",3,3,6,15,15,30,0,0,0,0
"12685",2018-04-01,"sbbi","transporte regular","voo doméstico",0,0,0,0,0,0,0,0,0,0
"12686",2018-04-01,"sbbi","transporte regular","voo internacional",0,0,0,0,0,0,0,0,0,0
"12687",2018-04-01,"sbbi","transporte não regular","voo doméstico",1567,1567,3134,829,683,1512,0,0,0,0
"12688",2018-04-01,"sbbi","transporte não regular","voo internacional",6,6,12,10,0,10,0,0,0,0
"12689",2018-04-01,"sbbv","transporte regular","voo doméstico",90,90,180,12775,9981,22756,0,0,0,0
"12690",2018-04-01,"sbbv","transporte regular","voo internacional",0,0,0,0,0,0,0,0,0,0
"12691",2018-04-01,"sbbv","transporte não regular","voo doméstico",106,111,217,257,50,307,0,0,0,0
"12692",2018-04-01,"sbbv","transporte não regular","voo internacional",24,18,42,6,8,14,0,0,0,0
"12693",2018-04-01,"sbcg","transporte regular","voo doméstico",537,535,1072,64352,63110,127462,0,0,0,0
"12694",2018-04-01,"sbcg","transporte regular","voo internacional",9,9,18,106,82,188,0,0,0,0
"12695",2018-04-01,"sbcg","transporte não regular","voo doméstico",288,291,579,325,142,467,66006,80903,146909,0
"12696",2018-04-01,"sbcg","transporte não regular","voo internacional",11,9,20,0,0,0,0,0,0,0
"12697",2018-04-01,"sbcj","transporte regular","voo doméstico",68,69,137,4320,4350,8670,0,0,0,0
"12698",2018-04-01,"sbcj","transporte regular","voo internacional",0,0,0,0,0,0,0,0,0,0
"12699",2018-04-01,"sbcj","transporte não regular","voo doméstico",101,100,201,765,187,952,0,0,0,0
"12700",2018-04-01,"sbcj","transporte não regular","voo internacional",0,0,0,0,0,0,0,0,0,0
"12701",2018-04-01,"sbcr","transporte regular","voo doméstico",14,14,28,1078,992,2070,0,0,0,0
"12702",2018-04-01,"sbcr","transporte regular","voo internacional",0,0,0,0,0,0,0,0,0,0
"12703",2018-04-01,"sbcr","transporte não regular","voo doméstico",48,48,96,143,178,321,0,0,0,0
"12704",2018-04-01,"sbcr","transporte não regular","voo internacional",4,4,8,5,1,6,0,0,0,0
"12705",2018-04-01,"sbct","transporte regular","voo doméstico",2298,2297,4595,258272,244711,502983,125561,41077,166638,274056
"12706",2018-04-01,"sbct","transporte regular","voo internacional",77,77,154,3539,2964,6503,0,25096,25096,0
"12707",2018-04-01,"sbct","transporte não regular","voo doméstico",280,277,557,1451,859,2310,0,0,0,0
"12708",2018-04-01,"sbct","transporte não regular","voo internacional",16,13,29,88,97,185,0,0,0,0
"12709",2018-04-01,"sbcz","transporte regular","voo doméstico",36,36,72,3145,2878,6023,0,0,0,0
"12710",2018-04-01,"sbcz","transporte regular","voo internacional",0,0,0,0,0,0,0,0,0,0
"12711",2018-04-01,"sbcz","transporte não regular","voo doméstico",137,141,278,476,475,951,0,0,0,0
"12712",2018-04-01,"sbcz","transporte não regular","voo internacional",0,0,0,0,0,0,0,0,0,0
"12713",2018-04-01,"sbeg","transporte regular","voo doméstico",827,822,1649,94121,87061,181182,0,0,0,0
"12714",2018-04-01,"sbeg","transporte regular","voo internacional",108,113,221,5094,4577,9671,0,0,0,0
"12715",2018-04-01,"sbeg","transporte não regular","voo doméstico",446,447,893,4832,3395,8227,0,0,0,0
"12716",2018-04-01,"sbeg","transporte não regular","voo internacional",61,65,126,429,0,429,0,0,0,0
"12717",2018-04-01,"sbfi","transporte regular","voo doméstico",551,602,1153,79166,74463,153629,0,0,0,0
"12718",2018-04-01,"sbfi","transporte regular","voo internacional",169,169,338,18782,19434,38216,0,0,0,0
"12719",2018-04-01,"sbfi","transporte não regular","voo doméstico",202,145,347,1204,7787,8991,0,0,0,0
"12720",2018-04-01,"sbfi","transporte não regular","voo internacional",39,46,85,111,238,349,0,0,0,0
"12721",2018-04-01,"sbgo","transporte regular","voo doméstico",1274,1271,2545,128648,124329,252977,113916,160048,273964,125400
"12722",2018-04-01,"sbgo","transporte regular","voo internacional",0,0,0,0,0,0,0,0,0,0
"12723",2018-04-01,"sbgo","transporte não regular","voo doméstico",1494,1489,2983,4935,4292,9227,0,0,0,0
"12724",2018-04-01,"sbgo","transporte não regular","voo internacional",2,2,4,0,0,0,0,0,0,0
"12725",2018-04-01,"sbht","transporte regular","voo doméstico",97,97,194,4012,4018,8030,0,0,0,0
"12726",2018-04-01,"sbht","transporte regular","voo internacional",0,0,0,0,0,0,0,0,0,0
"12727",2018-04-01,"sbht","transporte não regular","voo doméstico",21,21,42,86,53,139,0,0,0,0
"12728",2018-04-01,"sbht","transporte não regular","voo internacional",0,0,0,0,0,0,0,0,0,0
"12729",2018-04-01,"sbiz","transporte regular","voo doméstico",86,86,172,10420,9521,19941,0,0,0,0
"12730",2018-04-01,"sbiz","transporte regular","voo internacional",0,0,0,0,0,0,0,0,0,0
"12731",2018-04-01,"sbiz","transporte não regular","voo doméstico",103,103,206,250,236,486,0,0,0,0
"12732",2018-04-01,"sbiz","transporte não regular","voo internacional",0,0,0,0,0,0,0,0,0,0
"12733",2018-04-01,"sbjc","transporte regular","voo doméstico",0,0,0,0,0,0,0,0,0,0
"12734",2018-04-01,"sbjc","transporte regular","voo internacional",0,0,0,0,0,0,0,0,0,0
"12735",2018-04-01,"sbjc","transporte não regular","voo doméstico",209,208,417,446,252,698,0,0,0,0
"12736",2018-04-01,"sbjc","transporte não regular","voo internacional",0,0,0,0,0,0,0,0,0,0
"12737",2018-04-01,"sbjr","transporte regular","voo doméstico",0,0,0,0,0,0,0,0,0,0
"12738",2018-04-01,"sbjr","transporte regular","voo internacional",0,0,0,0,0,0,0,0,0,0
"12739",2018-04-01,"sbjr","transporte não regular","voo doméstico",2640,2629,5269,10459,5037,15496,0,0,0,0
"12740",2018-04-01,"sbjr","transporte não regular","voo internacional",3,3,6,5,0,5,0,0,0,0
"12741",2018-04-01,"sbjv","transporte regular","voo doméstico",206,205,411,20313,19452,39765,0,0,0,0
"12742",2018-04-01,"sbjv","transporte regular","voo internacional",0,0,0,0,0,0,0,0,0,0
"12743",2018-04-01,"sbjv","transporte não regular","voo doméstico",112,114,226,159,253,412,0,0,0,0
"12744",2018-04-01,"sbjv","transporte não regular","voo internacional",1,1,2,0,0,0,0,0,0,0
"12745",2018-04-01,"sblo","transporte regular","voo doméstico",445,448,893,43130,39763,82893,0,0,0,0
"12746",2018-04-01,"sblo","transporte regular","voo internacional",0,0,0,0,0,0,0,0,0,0
"12747",2018-04-01,"sblo","transporte não regular","voo doméstico",735,730,1465,267,181,448,0,0,0,0
"12748",2018-04-01,"sblo","transporte não regular","voo internacional",8,8,16,0,0,0,0,0,0,0
"12749",2018-04-01,"sbma","transporte regular","voo doméstico",120,120,240,10677,10349,21026,0,0,0,0
"12750",2018-04-01,"sbma","transporte regular","voo internacional",0,0,0,0,0,0,0,0,0,0
"12751",2018-04-01,"sbma","transporte não regular","voo doméstico",155,154,309,448,370,818,0,0,0,0
"12752",2018-04-01,"sbma","transporte não regular","voo internacional",1,1,2,0,0,0,0,0,0,0
"12753",2018-04-01,"sbmk","transporte regular","voo doméstico",133,133,266,9585,9370,18955,0,0,0,0
"12754",2018-04-01,"sbmk","transporte regular","voo internacional",0,0,0,0,0,0,0,0,0,0
"12755",2018-04-01,"sbmk","transporte não regular","voo doméstico",214,207,421,464,29,493,0,0,0,0
"12756",2018-04-01,"sbmk","transporte não regular","voo internacional",1,1,2,0,0,0,0,0,0,0
"12757",2018-04-01,"sbmq","transporte regular","voo doméstico",196,198,394,21479,18540,40019,12590,32880,45470,0
"12758",2018-04-01,"sbmq","transporte regular","voo internacional",0,0,0,0,0,0,0,0,0,0
"12759",2018-04-01,"sbmq","transporte não regular","voo doméstico",135,131,266,239,152,391,0,0,0,0
"12760",2018-04-01,"sbmq","transporte não regular","voo internacional",5,5,10,0,0,0,0,0,0,0
"12761",2018-04-01,"sbmt","transporte regular","voo doméstico",0,0,0,0,0,0,0,0,0,0
"12762",2018-04-01,"sbmt","transporte regular","voo internacional",0,0,0,0,0,0,0,0,0,0
"12763",2018-04-01,"sbmt","transporte não regular","voo doméstico",3500,3506,7006,5667,5806,11473,0,0,0,0
"12764",2018-04-01,"sbmt","transporte não regular","voo internacional",0,0,0,0,0,0,0,0,0,0
"12765",2018-04-01,"sbnf","transporte regular","voo doméstico",626,626,1252,77447,76023,153470,0,0,0,0
"12766",2018-04-01,"sbnf","transporte regular","voo internacional",18,17,35,1868,1586,3454,0,0,0,0
"12767",2018-04-01,"sbnf","transporte não regular","voo doméstico",297,305,602,638,514,1152,0,0,0,0
"12768",2018-04-01,"sbnf","transporte não regular","voo internacional",4,3,7,0,2,2,0,0,0,0
"12769",2018-04-01,"sbpb","transporte regular","voo doméstico",4,4,8,244,287,531,0,0,0,0
"12770",2018-04-01,"sbpb","transporte regular","voo internacional",0,0,0,0,0,0,0,0,0,0
"12771",2018-04-01,"sbpb","transporte não regular","voo doméstico",39,40,79,96,81,177,0,0,0,0
"12772",2018-04-01,"sbpb","transporte não regular","voo internacional",0,0,0,0,0,0,0,0,0,0
"12773",2018-04-01,"sbpj","transporte regular","voo doméstico",290,289,579,27501,26167,53668,0,0,0,0
"12774",2018-04-01,"sbpj","transporte regular","voo internacional",0,0,0,0,0,0,0,0,0,0
"12775",2018-04-01,"sbpj","transporte não regular","voo doméstico",220,221,441,401,325,726,0,0,0,0
"12776",2018-04-01,"sbpj","transporte não regular","voo internacional",2,2,4,0,0,0,0,0,0,0
"12777",2018-04-01,"sbpk","transporte regular","voo doméstico",26,26,52,1213,1181,2394,0,0,0,0
"12778",2018-04-01,"sbpk","transporte regular","voo internacional",0,0,0,0,0,0,0,0,0,0
"12779",2018-04-01,"sbpk","transporte não regular","voo doméstico",27,26,53,102,110,212,0,0,0,0
"12780",2018-04-01,"sbpk","transporte não regular","voo internacional",6,7,13,10,5,15,0,0,0,0
"12781",2018-04-01,"sbpl","transporte regular","voo doméstico",157,157,314,19296,18300,37596,0,0,0,0
"12782",2018-04-01,"sbpl","transporte regular","voo internacional",4,4,8,0,0,0,0,0,0,0
"12783",2018-04-01,"sbpl","transporte não regular","voo doméstico",60,64,124,114,111,225,0,0,0,0
"12784",2018-04-01,"sbpl","transporte não regular","voo internacional",1,1,2,4,4,8,0,0,0,0
"12785",2018-04-01,"sbpp","transporte regular","voo doméstico",0,0,0,0,0,0,0,0,0,0
"12786",2018-04-01,"sbpp","transporte regular","voo internacional",0,0,0,0,0,0,0,0,0,0
"12787",2018-04-01,"sbpp","transporte não regular","voo doméstico",123,122,245,207,191,398,0,0,0,0
"12788",2018-04-01,"sbpp","transporte não regular","voo internacional",12,11,23,11,24,35,0,0,0,0
"12789",2018-04-01,"sbpr","transporte regular","voo doméstico",0,0,0,0,0,0,0,0,0,0
"12790",2018-04-01,"sbpr","transporte regular","voo internacional",0,0,0,0,0,0,0,0,0,0
"12791",2018-04-01,"sbpr","transporte não regular","voo doméstico",873,866,1739,1067,1017,2084,0,0,0,0
"12792",2018-04-01,"sbpr","transporte não regular","voo internacional",2,2,4,0,0,0,0,0,0,0
"12793",2018-04-01,"sbpv","transporte regular","voo doméstico",316,316,632,32968,30843,63811,0,0,0,0
"12794",2018-04-01,"sbpv","transporte regular","voo internacional",0,0,0,0,0,0,0,0,0,0
"12795",2018-04-01,"sbpv","transporte não regular","voo doméstico",298,299,597,198,0,198,0,0,0,0
"12796",2018-04-01,"sbpv","transporte não regular","voo internacional",0,0,0,0,0,0,0,0,0,0
"12797",2018-04-01,"sbrb","transporte regular","voo doméstico",136,136,272,11035,10230,21265,0,42,42,0
"12798",2018-04-01,"sbrb","transporte regular","voo internacional",0,0,0,0,0,0,0,0,0,0
"12799",2018-04-01,"sbrb","transporte não regular","voo doméstico",143,141,284,319,347,666,0,0,0,0
"12800",2018-04-01,"sbrb","transporte não regular","voo internacional",3,3,6,0,0,0,0,0,0,0
"12801",2018-04-01,"sbrj","transporte regular","voo doméstico",3723,3726,7449,383356,381006,764362,0,0,0,0
"12802",2018-04-01,"sbrj","transporte regular","voo internacional",0,0,0,0,0,0,0,0,0,0
"12803",2018-04-01,"sbrj","transporte não regular","voo doméstico",543,537,1080,1063,461,1524,0,0,0,0
"12804",2018-04-01,"sbrj","transporte não regular","voo internacional",0,0,0,0,0,0,0,0,0,0
"12805",2018-04-01,"sbsj","transporte regular","voo doméstico",0,0,0,0,0,0,0,0,0,0
"12806",2018-04-01,"sbsj","transporte regular","voo internacional",0,0,0,0,0,0,0,0,0,0
"12807",2018-04-01,"sbsj","transporte não regular","voo doméstico",461,454,915,1452,1477,2929,0,0,0,0
"12808",2018-04-01,"sbsj","transporte não regular","voo internacional",3,13,16,45,20,65,0,0,0,0
"12809",2018-04-01,"sbsl","transporte regular","voo doméstico",488,488,976,57941,52323,110264,451,0,451,0
"12810",2018-04-01,"sbsl","transporte regular","voo internacional",0,0,0,0,0,0,0,0,0,0
"12811",2018-04-01,"sbsl","transporte não regular","voo doméstico",180,177,357,229,163,392,52655,186971,239626,0
"12812",2018-04-01,"sbsl","transporte não regular","voo internacional",2,4,6,11,2,13,0,0,0,0
"12813",2018-04-01,"sbsn","transporte regular","voo doméstico",219,218,437,15865,15167,31032,0,0,0,0
"12814",2018-04-01,"sbsn","transporte regular","voo internacional",0,0,0,0,0,0,0,0,0,0
"12815",2018-04-01,"sbsn","transporte não regular","voo doméstico",210,214,424,932,876,1808,7680,10300,17980,0
"12816",2018-04-01,"sbsn","transporte não regular","voo internacional",0,0,0,0,0,0,0,0,0,0
"12817",2018-04-01,"sbsp","transporte regular","voo doméstico",7121,7150,14271,873201,857121,1730322,0,0,0,0
"12818",2018-04-01,"sbsp","transporte regular","voo internacional",0,0,0,0,0,0,0,0,0,0
"12819",2018-04-01,"sbsp","transporte não regular","voo doméstico",2086,2053,4139,6015,5380,11395,0,0,0,0
"12820",2018-04-01,"sbsp","transporte não regular","voo internacional",4,5,9,10,10,20,0,0,0,0
"12821",2018-04-01,"sbte","transporte regular","voo doméstico",362,364,726,38387,34490,72877,23132,83251,106383,197486
"12822",2018-04-01,"sbte","transporte regular","voo internacional",0,0,0,0,0,0,0,0,0,0
"12823",2018-04-01,"sbte","transporte não regular","voo doméstico",222,215,437,1089,1125,2214,0,2383,2383,9512
"12824",2018-04-01,"sbte","transporte não regular","voo internacional",0,0,0,0,0,0,0,0,0,0
"12825",2018-04-01,"sbtf","transporte regular","voo doméstico",29,29,58,1213,1193,2406,0,0,0,0
"12826",2018-04-01,"sbtf","transporte regular","voo internacional",0,0,0,0,0,0,0,0,0,0
"12827",2018-04-01,"sbtf","transporte não regular","voo doméstico",90,89,179,124,96,220,283,15,298,2600
"12828",2018-04-01,"sbtf","transporte não regular","voo internacional",0,0,0,0,0,0,0,0,0,0
"12829",2018-04-01,"sbtt","transporte regular","voo doméstico",30,30,60,1881,2196,4077,0,0,0,0
"12830",2018-04-01,"sbtt","transporte regular","voo internacional",0,0,0,0,0,0,0,0,0,0
"12831",2018-04-01,"sbtt","transporte não regular","voo doméstico",60,60,120,287,310,597,559,727,1286,0
"12832",2018-04-01,"sbtt","transporte não regular","voo internacional",1,0,1,0,6,6,0,0,0,0
"12833",2018-04-01,"sbuf","transporte regular","voo doméstico",8,8,16,443,432,875,0,0,0,0
"12834",2018-04-01,"sbuf","transporte regular","voo internacional",0,0,0,0,0,0,0,0,0,0
"12835",2018-04-01,"sbuf","transporte não regular","voo doméstico",34,36,70,121,109,230,0,0,0,0
"12836",2018-04-01,"sbuf","transporte não regular","voo internacional",0,0,0,0,0,0,0,0,0,0
"12837",2018-04-01,"sbug","transporte regular","voo doméstico",16,16,32,871,894,1765,0,0,0,0
"12838",2018-04-01,"sbug","transporte regular","voo internacional",0,0,0,0,0,0,0,0,0,0
"12839",2018-04-01,"sbug","transporte não regular","voo doméstico",10,10,20,74,72,146,0,0,0,0
"12840",2018-04-01,"sbug","transporte não regular","voo internacional",0,0,0,0,0,0,0,0,0,0
"12841",2018-04-01,"sbul","transporte regular","voo doméstico",494,494,988,46568,45172,91740,9,0,9,0
"12842",2018-04-01,"sbul","transporte regular","voo internacional",0,0,0,0,0,0,0,0,0,0
"12843",2018-04-01,"sbul","transporte não regular","voo doméstico",517,513,1030,1198,1029,2227,0,0,0,0
"12844",2018-04-01,"sbul","transporte não regular","voo internacional",3,3,6,8,6,14,0,0,0,0
"12845",2018-04-01,"sbur","transporte regular","voo doméstico",42,41,83,2023,2015,4038,0,0,0,0
"12846",2018-04-01,"sbur","transporte regular","voo internacional",0,0,0,0,0,0,0,0,0,0
"12847",2018-04-01,"sbur","transporte não regular","voo doméstico",251,234,485,865,936,1801,0,0,0,0
"12848",2018-04-01,"sbur","transporte não regular","voo internacional",1,1,2,0,0,0,0,0,0,0
"12849",2018-08-01,"sbbe","transporte regular","voo doméstico",1148,1147,2295,144957,143816,288773,113488,273883,387371,0
"12850",2018-08-01,"sbbe","transporte regular","voo internacional",56,57,113,8233,7967,16200,33,66,99,0
"12851",2018-08-01,"sbbe","transporte não regular","voo doméstico",468,475,943,1080,1310,2390,0,0,0,0
"12852",2018-08-01,"sbbe","transporte não regular","voo internacional",12,12,24,3,10,13,0,0,0,0
"12853",2018-08-01,"sbbg","transporte regular","voo doméstico",0,0,0,0,0,0,0,0,0,0
"12854",2018-08-01,"sbbg","transporte regular","voo internacional",0,0,0,0,0,0,0,0,0,0
"12855",2018-08-01,"sbbg","transporte não regular","voo doméstico",13,15,28,52,40,92,0,0,0,0
"12856",2018-08-01,"sbbg","transporte não regular","voo internacional",2,0,2,0,4,4,0,0,0,0
"12857",2018-08-01,"sbbh","transporte regular","voo doméstico",2,2,4,28,41,69,0,0,0,0
"12858",2018-08-01,"sbbh","transporte regular","voo internacional",0,0,0,0,0,0,0,0,0,0
"12859",2018-08-01,"sbbh","transporte não regular","voo doméstico",1721,1713,3434,8171,8224,16395,0,0,0,0
"12860",2018-08-01,"sbbh","transporte não regular","voo internacional",19,19,38,108,108,216,0,0,0,0
"12861",2018-08-01,"sbbi","transporte regular","voo doméstico",0,0,0,0,0,0,0,0,0,0
"12862",2018-08-01,"sbbi","transporte regular","voo internacional",0,0,0,0,0,0,0,0,0,0
"12863",2018-08-01,"sbbi","transporte não regular","voo doméstico",1136,1136,2272,739,614,1353,0,0,0,0
"12864",2018-08-01,"sbbi","transporte não regular","voo internacional",0,0,0,0,0,0,0,0,0,0
"12865",2018-08-01,"sbbv","transporte regular","voo doméstico",97,97,194,15545,12557,28102,0,0,0,0
"12866",2018-08-01,"sbbv","transporte regular","voo internacional",0,0,0,0,0,0,0,0,0,0
"12867",2018-08-01,"sbbv","transporte não regular","voo doméstico",96,104,200,70,6,76,0,0,0,0
"12868",2018-08-01,"sbbv","transporte não regular","voo internacional",16,11,27,0,7,7,0,0,0,0
"12869",2018-08-01,"sbcg","transporte regular","voo doméstico",551,551,1102,64540,62269,126809,36875,12312,49187,0
"12870",2018-08-01,"sbcg","transporte regular","voo internacional",0,0,0,0,0,0,0,0,0,0
"12871",2018-08-01,"sbcg","transporte não regular","voo doméstico",291,300,591,339,242,581,0,0,0,0
"12872",2018-08-01,"sbcg","transporte não regular","voo internacional",11,9,20,0,0,0,0,0,0,0
"12873",2018-08-01,"sbcj","transporte regular","voo doméstico",88,88,176,5027,5050,10077,0,0,0,0
"12874",2018-08-01,"sbcj","transporte regular","voo internacional",0,0,0,0,0,0,0,0,0,0
"12875",2018-08-01,"sbcj","transporte não regular","voo doméstico",108,110,218,1156,173,1329,0,0,0,0
"12876",2018-08-01,"sbcj","transporte não regular","voo internacional",0,0,0,0,0,0,0,0,0,0
"12877",2018-08-01,"sbcr","transporte regular","voo doméstico",19,19,38,1199,1323,2522,0,0,0,0
"12878",2018-08-01,"sbcr","transporte regular","voo internacional",0,0,0,0,0,0,0,0,0,0
"12879",2018-08-01,"sbcr","transporte não regular","voo doméstico",62,61,123,151,148,299,0,0,0,0
"12880",2018-08-01,"sbcr","transporte não regular","voo internacional",2,2,4,7,6,13,0,0,0,0
"12881",2018-08-01,"sbct","transporte regular","voo doméstico",2414,2428,4842,266701,260447,527148,142951,63193,206144,326150
"12882",2018-08-01,"sbct","transporte regular","voo internacional",79,79,158,3392,3181,6573,0,81730,81730,19394
"12883",2018-08-01,"sbct","transporte não regular","voo doméstico",257,252,509,1133,1425,2558,6277,739,7016,7306
"12884",2018-08-01,"sbct","transporte não regular","voo internacional",23,22,45,46,42,88,0,0,0,0
"12885",2018-08-01,"sbcz","transporte regular","voo doméstico",30,30,60,3764,911,4675,0,0,0,0
"12886",2018-08-01,"sbcz","transporte regular","voo internacional",0,0,0,0,0,0,0,0,0,0
"12887",2018-08-01,"sbcz","transporte não regular","voo doméstico",205,207,412,960,880,1840,0,0,0,0
"12888",2018-08-01,"sbcz","transporte não regular","voo internacional",0,0,0,0,0,0,0,0,0,0
"12889",2018-08-01,"sbeg","transporte regular","voo doméstico",1024,1012,2036,113889,106164,220053,116127,313032,429159,0
"12890",2018-08-01,"sbeg","transporte regular","voo internacional",106,106,212,5059,4512,9571,0,0,0,0
"12891",2018-08-01,"sbeg","transporte não regular","voo doméstico",503,508,1011,4752,3475,8227,0,8545,8545,0
"12892",2018-08-01,"sbeg","transporte não regular","voo internacional",55,64,119,73,240,313,0,0,0,0
"12893",2018-08-01,"sbfi","transporte regular","voo doméstico",594,626,1220,86503,81913,168416,0,0,0,0
"12894",2018-08-01,"sbfi","transporte regular","voo internacional",22,22,44,2939,2602,5541,0,0,0,0
"12895",2018-08-01,"sbfi","transporte não regular","voo doméstico",208,176,384,1188,6253,7441,0,0,0,0
"12896",2018-08-01,"sbfi","transporte não regular","voo internacional",68,70,138,141,137,278,0,0,0,0
"12897",2018-08-01,"sbgo","transporte regular","voo doméstico",1273,1279,2552,134100,131401,265501,191862,254740,446602,0
"12898",2018-08-01,"sbgo","transporte regular","voo internacional",0,0,0,0,0,0,0,0,0,0
"12899",2018-08-01,"sbgo","transporte não regular","voo doméstico",1696,1695,3391,5204,5247,10451,0,0,0,0
"12900",2018-08-01,"sbgo","transporte não regular","voo internacional",9,8,17,0,0,0,0,0,0,0
"12901",2018-08-01,"sbht","transporte regular","voo doméstico",83,83,166,4255,4004,8259,0,0,0,0
"12902",2018-08-01,"sbht","transporte regular","voo internacional",0,0,0,0,0,0,0,0,0,0
"12903",2018-08-01,"sbht","transporte não regular","voo doméstico",54,55,109,89,141,230,0,0,0,0
"12904",2018-08-01,"sbht","transporte não regular","voo internacional",0,0,0,0,0,0,0,0,0,0
"12905",2018-08-01,"sbiz","transporte regular","voo doméstico",99,99,198,11721,10832,22553,0,0,0,0
"12906",2018-08-01,"sbiz","transporte regular","voo internacional",0,0,0,0,0,0,0,0,0,0
"12907",2018-08-01,"sbiz","transporte não regular","voo doméstico",115,112,227,213,199,412,0,0,0,0
"12908",2018-08-01,"sbiz","transporte não regular","voo internacional",0,0,0,0,0,0,0,0,0,0
"12909",2018-08-01,"sbjc","transporte regular","voo doméstico",0,0,0,0,0,0,0,0,0,0
"12910",2018-08-01,"sbjc","transporte regular","voo internacional",0,0,0,0,0,0,0,0,0,0
"12911",2018-08-01,"sbjc","transporte não regular","voo doméstico",320,316,636,658,408,1066,0,0,0,0
"12912",2018-08-01,"sbjc","transporte não regular","voo internacional",0,0,0,0,0,0,0,0,0,0
"12913",2018-08-01,"sbjr","transporte regular","voo doméstico",0,0,0,0,0,0,0,0,0,0
"12914",2018-08-01,"sbjr","transporte regular","voo internacional",0,0,0,0,0,0,0,0,0,0
"12915",2018-08-01,"sbjr","transporte não regular","voo doméstico",2369,2360,4729,10699,5721,16420,0,0,0,0
"12916",2018-08-01,"sbjr","transporte não regular","voo internacional",0,0,0,0,0,0,0,0,0,0
"12917",2018-08-01,"sbjv","transporte regular","voo doméstico",214,214,428,20718,19940,40658,0,0,0,0
"12918",2018-08-01,"sbjv","transporte regular","voo internacional",0,0,0,0,0,0,0,0,0,0
"12919",2018-08-01,"sbjv","transporte não regular","voo doméstico",85,86,171,110,52,162,0,0,0,0
"12920",2018-08-01,"sbjv","transporte não regular","voo internacional",0,0,0,0,0,0,0,0,0,0
"12921",2018-08-01,"sblo","transporte regular","voo doméstico",425,430,855,42834,39951,82785,0,0,0,0
"12922",2018-08-01,"sblo","transporte regular","voo internacional",0,0,0,0,0,0,0,0,0,0
"12923",2018-08-01,"sblo","transporte não regular","voo doméstico",567,559,1126,208,475,683,0,0,0,0
"12924",2018-08-01,"sblo","transporte não regular","voo internacional",3,3,6,0,0,0,0,0,0,0
"12925",2018-08-01,"sbma","transporte regular","voo doméstico",127,127,254,12063,11285,23348,0,0,0,0
"12926",2018-08-01,"sbma","transporte regular","voo internacional",0,0,0,0,0,0,0,0,0,0
"12927",2018-08-01,"sbma","transporte não regular","voo doméstico",204,203,407,467,458,925,0,0,0,0
"12928",2018-08-01,"sbma","transporte não regular","voo internacional",1,1,2,0,0,0,0,0,0,0
"12929",2018-08-01,"sbmk","transporte regular","voo doméstico",142,142,284,10145,8659,18804,0,0,0,0
"12930",2018-08-01,"sbmk","transporte regular","voo internacional",0,0,0,0,0,0,0,0,0,0
"12931",2018-08-01,"sbmk","transporte não regular","voo doméstico",188,188,376,461,21,482,0,0,0,0
"12932",2018-08-01,"sbmk","transporte não regular","voo internacional",0,0,0,0,0,0,0,0,0,0
"12933",2018-08-01,"sbmq","transporte regular","voo doméstico",197,200,397,22938,24754,47692,19180,29520,48700,0
"12934",2018-08-01,"sbmq","transporte regular","voo internacional",0,0,0,0,0,0,0,0,0,0
"12935",2018-08-01,"sbmq","transporte não regular","voo doméstico",161,160,321,200,104,304,0,0,0,0
"12936",2018-08-01,"sbmq","transporte não regular","voo internacional",3,4,7,0,0,0,0,0,0,0
"12937",2018-08-01,"sbmt","transporte regular","voo doméstico",0,0,0,0,0,0,0,0,0,0
"12938",2018-08-01,"sbmt","transporte regular","voo internacional",0,0,0,0,0,0,0,0,0,0
"12939",2018-08-01,"sbmt","transporte não regular","voo doméstico",2784,2782,5566,4596,4602,9198,0,0,0,0
"12940",2018-08-01,"sbmt","transporte não regular","voo internacional",0,0,0,0,0,0,0,0,0,0
"12941",2018-08-01,"sbnf","transporte regular","voo doméstico",619,622,1241,72040,73160,145200,0,0,0,0
"12942",2018-08-01,"sbnf","transporte regular","voo internacional",18,19,37,2030,1780,3810,0,0,0,0
"12943",2018-08-01,"sbnf","transporte não regular","voo doméstico",249,249,498,444,1504,1948,0,0,0,0
"12944",2018-08-01,"sbnf","transporte não regular","voo internacional",2,2,4,2,0,2,0,0,0,0
"12945",2018-08-01,"sbpb","transporte regular","voo doméstico",4,4,8,273,331,604,0,0,0,0
"12946",2018-08-01,"sbpb","transporte regular","voo internacional",0,0,0,0,0,0,0,0,0,0
"12947",2018-08-01,"sbpb","transporte não regular","voo doméstico",54,54,108,143,126,269,0,0,0,0
"12948",2018-08-01,"sbpb","transporte não regular","voo internacional",0,0,0,0,0,0,0,0,0,0
"12949",2018-08-01,"sbpj","transporte regular","voo doméstico",280,279,559,29773,28556,58329,0,0,0,0
"12950",2018-08-01,"sbpj","transporte regular","voo internacional",0,0,0,0,0,0,0,0,0,0
"12951",2018-08-01,"sbpj","transporte não regular","voo doméstico",320,319,639,764,261,1025,0,0,0,0
"12952",2018-08-01,"sbpj","transporte não regular","voo internacional",6,6,12,3,0,3,0,0,0,0
"12953",2018-08-01,"sbpk","transporte regular","voo doméstico",27,27,54,1580,1628,3208,0,0,0,0
"12954",2018-08-01,"sbpk","transporte regular","voo internacional",0,0,0,0,0,0,0,0,0,0
"12955",2018-08-01,"sbpk","transporte não regular","voo doméstico",84,82,166,592,495,1087,0,0,0,0
"12956",2018-08-01,"sbpk","transporte não regular","voo internacional",1,3,4,0,0,0,0,0,0,0
"12957",2018-08-01,"sbpl","transporte regular","voo doméstico",167,166,333,20596,19030,39626,0,0,0,0
"12958",2018-08-01,"sbpl","transporte regular","voo internacional",1,1,2,0,0,0,0,0,0,0
"12959",2018-08-01,"sbpl","transporte não regular","voo doméstico",74,75,149,151,123,274,0,0,0,0
"12960",2018-08-01,"sbpl","transporte não regular","voo internacional",0,0,0,0,0,0,0,0,0,0
"12961",2018-08-01,"sbpp","transporte regular","voo doméstico",0,0,0,0,0,0,0,0,0,0
"12962",2018-08-01,"sbpp","transporte regular","voo internacional",0,0,0,0,0,0,0,0,0,0
"12963",2018-08-01,"sbpp","transporte não regular","voo doméstico",106,100,206,139,157,296,0,0,0,0
"12964",2018-08-01,"sbpp","transporte não regular","voo internacional",2,2,4,2,1,3,0,0,0,0
"12965",2018-08-01,"sbpr","transporte regular","voo doméstico",0,0,0,0,0,0,0,0,0,0
"12966",2018-08-01,"sbpr","transporte regular","voo internacional",0,0,0,0,0,0,0,0,0,0
"12967",2018-08-01,"sbpr","transporte não regular","voo doméstico",886,887,1773,1019,951,1970,0,0,0,0
"12968",2018-08-01,"sbpr","transporte não regular","voo internacional",0,0,0,0,0,0,0,0,0,0
"12969",2018-08-01,"sbpv","transporte regular","voo doméstico",343,343,686,35851,34389,70240,0,0,0,0
"12970",2018-08-01,"sbpv","transporte regular","voo internacional",0,0,0,0,0,0,0,0,0,0
"12971",2018-08-01,"sbpv","transporte não regular","voo doméstico",288,284,572,38,0,38,0,0,0,0
"12972",2018-08-01,"sbpv","transporte não regular","voo internacional",0,0,0,0,0,0,0,0,0,0
"12973",2018-08-01,"sbrb","transporte regular","voo doméstico",178,178,356,17416,15484,32900,0,0,0,0
"12974",2018-08-01,"sbrb","transporte regular","voo internacional",0,0,0,0,0,0,0,0,0,0
"12975",2018-08-01,"sbrb","transporte não regular","voo doméstico",164,163,327,475,335,810,0,0,0,0
"12976",2018-08-01,"sbrb","transporte não regular","voo internacional",2,2,4,0,0,0,0,0,0,0
"12977",2018-08-01,"sbrj","transporte regular","voo doméstico",3735,3737,7472,395671,394638,790309,0,0,0,0
"12978",2018-08-01,"sbrj","transporte regular","voo internacional",0,0,0,0,0,0,0,0,0,0
"12979",2018-08-01,"sbrj","transporte não regular","voo doméstico",553,554,1107,1596,1265,2861,0,0,0,0
"12980",2018-08-01,"sbrj","transporte não regular","voo internacional",5,5,10,0,0,0,0,0,0,0
"12981",2018-08-01,"sbsj","transporte regular","voo doméstico",0,0,0,0,0,0,0,0,0,0
"12982",2018-08-01,"sbsj","transporte regular","voo internacional",0,0,0,0,0,0,0,0,0,0
"12983",2018-08-01,"sbsj","transporte não regular","voo doméstico",379,366,745,1414,1288,2702,0,0,0,0
"12984",2018-08-01,"sbsj","transporte não regular","voo internacional",10,16,26,38,24,62,0,0,0,0
"12985",2018-08-01,"sbsl","transporte regular","voo doméstico",565,571,1136,71741,68036,139777,0,0,0,0
"12986",2018-08-01,"sbsl","transporte regular","voo internacional",0,0,0,0,0,0,0,0,0,0
"12987",2018-08-01,"sbsl","transporte não regular","voo doméstico",272,266,538,413,832,1245,0,0,0,0
"12988",2018-08-01,"sbsl","transporte não regular","voo internacional",1,0,1,0,0,0,0,0,0,0
"12989",2018-08-01,"sbsn","transporte regular","voo doméstico",231,231,462,20071,17366,37437,0,0,0,0
"12990",2018-08-01,"sbsn","transporte regular","voo internacional",0,0,0,0,0,0,0,0,0,0
"12991",2018-08-01,"sbsn","transporte não regular","voo doméstico",234,232,466,564,367,931,1610,1300,2910,0
"12992",2018-08-01,"sbsn","transporte não regular","voo internacional",3,3,6,0,0,0,0,0,0,0
"12993",2018-08-01,"sbsp","transporte regular","voo doméstico",7495,7547,15042,934189,939292,1873481,0,0,0,0
"12994",2018-08-01,"sbsp","transporte regular","voo internacional",0,0,0,0,0,0,0,0,0,0
"12995",2018-08-01,"sbsp","transporte não regular","voo doméstico",2095,2051,4146,6705,6261,12966,0,0,0,0
"12996",2018-08-01,"sbsp","transporte não regular","voo internacional",53,51,104,106,108,214,0,0,0,0
"12997",2018-08-01,"sbte","transporte regular","voo doméstico",360,360,720,48176,43647,91823,0,0,0,0
"12998",2018-08-01,"sbte","transporte regular","voo internacional",0,0,0,0,0,0,0,0,0,0
"12999",2018-08-01,"sbte","transporte não regular","voo doméstico",252,252,504,1701,1465,3166,0,0,0,0
"13000",2018-08-01,"sbte","transporte não regular","voo internacional",0,0,0,0,0,0,0,0,0,0
"13001",2018-08-01,"sbtf","transporte regular","voo doméstico",28,28,56,1155,1178,2333,0,0,0,0
"13002",2018-08-01,"sbtf","transporte regular","voo internacional",0,0,0,0,0,0,0,0,0,0
"13003",2018-08-01,"sbtf","transporte não regular","voo doméstico",122,122,244,177,113,290,692,81,773,1252
"13004",2018-08-01,"sbtf","transporte não regular","voo internacional",0,0,0,0,0,0,0,0,0,0
"13005",2018-08-01,"sbtt","transporte regular","voo doméstico",29,29,58,2209,2346,4555,0,0,0,0
"13006",2018-08-01,"sbtt","transporte regular","voo internacional",0,0,0,0,0,0,0,0,0,0
"13007",2018-08-01,"sbtt","transporte não regular","voo doméstico",83,83,166,370,362,732,827,503,1330,0
"13008",2018-08-01,"sbtt","transporte não regular","voo internacional",3,4,7,20,12,32,0,0,0,0
"13009",2018-08-01,"sbuf","transporte regular","voo doméstico",9,9,18,595,512,1107,0,0,0,0
"13010",2018-08-01,"sbuf","transporte regular","voo internacional",0,0,0,0,0,0,0,0,0,0
"13011",2018-08-01,"sbuf","transporte não regular","voo doméstico",21,21,42,70,57,127,0,0,0,0
"13012",2018-08-01,"sbuf","transporte não regular","voo internacional",0,0,0,0,0,0,0,0,0,0
"13013",2018-08-01,"sbug","transporte regular","voo doméstico",17,17,34,812,869,1681,0,0,0,0
"13014",2018-08-01,"sbug","transporte regular","voo internacional",0,0,0,0,0,0,0,0,0,0
"13015",2018-08-01,"sbug","transporte não regular","voo doméstico",10,10,20,23,15,38,0,0,0,0
"13016",2018-08-01,"sbug","transporte não regular","voo internacional",0,0,0,0,0,0,0,0,0,0
"13017",2018-08-01,"sbul","transporte regular","voo doméstico",566,567,1133,50543,48003,98546,0,148,148,0
"13018",2018-08-01,"sbul","transporte regular","voo internacional",0,0,0,0,0,0,0,0,0,0
"13019",2018-08-01,"sbul","transporte não regular","voo doméstico",623,618,1241,1396,1270,2666,0,0,0,0
"13020",2018-08-01,"sbul","transporte não regular","voo internacional",1,1,2,9,8,17,0,0,0,0
"13021",2018-08-01,"sbur","transporte regular","voo doméstico",62,62,124,3543,3469,7012,0,0,0,0
"13022",2018-08-01,"sbur","transporte regular","voo internacional",0,0,0,0,0,0,0,0,0,0
"13023",2018-08-01,"sbur","transporte não regular","voo doméstico",253,257,510,855,926,1781,0,0,0,0
"13024",2018-08-01,"sbur","transporte não regular","voo internacional",1,1,2,0,0,0,0,0,0,0
"13025",2018-12-01,"sbbe","transporte regular","voo doméstico",1210,1204,2414,160156,158832,318988,0,0,0,0
"13026",2018-12-01,"sbbe","transporte regular","voo internacional",59,58,117,8087,8134,16221,0,5,5,0
"13027",2018-12-01,"sbbe","transporte não regular","voo doméstico",443,444,887,2351,1998,4349,0,0,0,0
"13028",2018-12-01,"sbbe","transporte não regular","voo internacional",8,9,17,0,10,10,0,0,0,0
"13029",2018-12-01,"sbbg","transporte regular","voo doméstico",0,0,0,0,0,0,0,0,0,0
"13030",2018-12-01,"sbbg","transporte regular","voo internacional",0,0,0,0,0,0,0,0,0,0
"13031",2018-12-01,"sbbg","transporte não regular","voo doméstico",12,13,25,56,55,111,0,0,0,0
"13032",2018-12-01,"sbbg","transporte não regular","voo internacional",1,1,2,3,5,8,0,0,0,0
"13033",2018-12-01,"sbbh","transporte regular","voo doméstico",0,0,0,0,0,0,0,0,0,0
"13034",2018-12-01,"sbbh","transporte regular","voo internacional",0,0,0,0,0,0,0,0,0,0
"13035",2018-12-01,"sbbh","transporte não regular","voo doméstico",1501,1538,3039,7411,7370,14781,0,0,0,0
"13036",2018-12-01,"sbbh","transporte não regular","voo internacional",1,1,2,4,4,8,0,0,0,0
"13037",2018-12-01,"sbbi","transporte regular","voo doméstico",0,0,0,0,0,0,0,0,0,0
"13038",2018-12-01,"sbbi","transporte regular","voo internacional",0,0,0,0,0,0,0,0,0,0
"13039",2018-12-01,"sbbi","transporte não regular","voo doméstico",1537,1552,3089,893,814,1707,0,0,0,0
"13040",2018-12-01,"sbbi","transporte não regular","voo internacional",0,0,0,0,0,0,0,0,0,0
"13041",2018-12-01,"sbbv","transporte regular","voo doméstico",102,102,204,16895,12821,29716,0,0,0,0
"13042",2018-12-01,"sbbv","transporte regular","voo internacional",0,0,0,0,0,0,0,0,0,0
"13043",2018-12-01,"sbbv","transporte não regular","voo doméstico",106,107,213,185,58,243,0,0,0,0
"13044",2018-12-01,"sbbv","transporte não regular","voo internacional",29,25,54,7,6,13,0,0,0,0
"13045",2018-12-01,"sbcg","transporte regular","voo doméstico",561,558,1119,75008,66125,141133,0,0,0,0
"13046",2018-12-01,"sbcg","transporte regular","voo internacional",0,0,0,0,0,0,0,0,0,0
"13047",2018-12-01,"sbcg","transporte não regular","voo doméstico",199,202,401,359,263,622,0,0,0,0
"13048",2018-12-01,"sbcg","transporte não regular","voo internacional",10,9,19,0,0,0,0,0,0,0
"13049",2018-12-01,"sbcj","transporte regular","voo doméstico",73,73,146,5564,4255,9819,0,0,0,0
"13050",2018-12-01,"sbcj","transporte regular","voo internacional",0,0,0,0,0,0,0,0,0,0
"13051",2018-12-01,"sbcj","transporte não regular","voo doméstico",69,69,138,1019,241,1260,0,0,0,0
"13052",2018-12-01,"sbcj","transporte não regular","voo internacional",0,0,0,0,0,0,0,0,0,0
"13053",2018-12-01,"sbcr","transporte regular","voo doméstico",25,25,50,1555,1142,2697,0,0,0,0
"13054",2018-12-01,"sbcr","transporte regular","voo internacional",0,0,0,0,0,0,0,0,0,0
"13055",2018-12-01,"sbcr","transporte não regular","voo doméstico",74,74,148,88,87,175,0,0,0,0
"13056",2018-12-01,"sbcr","transporte não regular","voo internacional",5,5,10,21,21,42,0,0,0,0
"13057",2018-12-01,"sbct","transporte regular","voo doméstico",2328,2319,4647,265478,253643,519121,142837,46512,189349,211303
"13058",2018-12-01,"sbct","transporte regular","voo internacional",73,74,147,3031,2725,5756,0,3788,3788,0
"13059",2018-12-01,"sbct","transporte não regular","voo doméstico",348,363,711,8650,8225,16875,0,58616,58616,0
"13060",2018-12-01,"sbct","transporte não regular","voo internacional",24,21,45,276,116,392,0,0,0,0
"13061",2018-12-01,"sbcz","transporte regular","voo doméstico",30,31,61,3177,2483,5660,0,0,0,0
"13062",2018-12-01,"sbcz","transporte regular","voo internacional",0,0,0,0,0,0,0,0,0,0
"13063",2018-12-01,"sbcz","transporte não regular","voo doméstico",155,152,307,525,512,1037,0,0,0,0
"13064",2018-12-01,"sbcz","transporte não regular","voo internacional",0,0,0,0,0,0,0,0,0,0
"13065",2018-12-01,"sbeg","transporte regular","voo doméstico",1069,1056,2125,143210,119072,262282,148617,179823,328440,0
"13066",2018-12-01,"sbeg","transporte regular","voo internacional",99,108,207,6919,5176,12095,0,0,0,0
"13067",2018-12-01,"sbeg","transporte não regular","voo doméstico",492,487,979,5321,3587,8908,0,0,0,0
"13068",2018-12-01,"sbeg","transporte não regular","voo internacional",70,85,155,155,5,160,0,0,0,0
"13069",2018-12-01,"sbfi","transporte regular","voo doméstico",679,671,1350,93006,87167,180173,0,0,0,0
"13070",2018-12-01,"sbfi","transporte regular","voo internacional",22,22,44,2744,1780,4524,0,0,0,0
"13071",2018-12-01,"sbfi","transporte não regular","voo doméstico",245,255,500,11536,8726,20262,0,0,0,0
"13072",2018-12-01,"sbfi","transporte não regular","voo internacional",46,45,91,47,45,92,0,0,0,0
"13073",2018-12-01,"sbgo","transporte regular","voo doméstico",1328,1327,2655,143890,134496,278386,236841,279608,516449,0
"13074",2018-12-01,"sbgo","transporte regular","voo internacional",0,0,0,0,0,0,0,0,0,0
"13075",2018-12-01,"sbgo","transporte não regular","voo doméstico",1213,1249,2462,4551,3964,8515,0,0,0,0
"13076",2018-12-01,"sbgo","transporte não regular","voo internacional",2,1,3,0,0,0,0,0,0,0
"13077",2018-12-01,"sbht","transporte regular","voo doméstico",81,81,162,4090,3744,7834,0,0,0,0
"13078",2018-12-01,"sbht","transporte regular","voo internacional",0,0,0,0,0,0,0,0,0,0
"13079",2018-12-01,"sbht","transporte não regular","voo doméstico",66,66,132,285,83,368,0,0,0,0
"13080",2018-12-01,"sbht","transporte não regular","voo internacional",0,0,0,0,0,0,0,0,0,0
"13081",2018-12-01,"sbiz","transporte regular","voo doméstico",116,115,231,14737,13527,28264,0,0,0,0
"13082",2018-12-01,"sbiz","transporte regular","voo internacional",0,0,0,0,0,0,0,0,0,0
"13083",2018-12-01,"sbiz","transporte não regular","voo doméstico",84,82,166,207,211,418,0,0,0,0
"13084",2018-12-01,"sbiz","transporte não regular","voo internacional",0,0,0,0,0,0,0,0,0,0
"13085",2018-12-01,"sbjc","transporte regular","voo doméstico",0,0,0,0,0,0,0,0,0,0
"13086",2018-12-01,"sbjc","transporte regular","voo internacional",0,0,0,0,0,0,0,0,0,0
"13087",2018-12-01,"sbjc","transporte não regular","voo doméstico",287,286,573,485,352,837,0,0,0,0
"13088",2018-12-01,"sbjc","transporte não regular","voo internacional",0,0,0,0,0,0,0,0,0,0
"13089",2018-12-01,"sbjr","transporte regular","voo doméstico",0,0,0,0,0,0,0,0,0,0
"13090",2018-12-01,"sbjr","transporte regular","voo internacional",0,0,0,0,0,0,0,0,0,0
"13091",2018-12-01,"sbjr","transporte não regular","voo doméstico",3450,3450,6900,12325,4741,17066,0,0,0,0
"13092",2018-12-01,"sbjr","transporte não regular","voo internacional",2,1,3,3,0,3,0,0,0,0
"13093",2018-12-01,"sbjv","transporte regular","voo doméstico",203,203,406,21071,21193,42264,0,0,0,0
"13094",2018-12-01,"sbjv","transporte regular","voo internacional",0,0,0,0,0,0,0,0,0,0
"13095",2018-12-01,"sbjv","transporte não regular","voo doméstico",87,88,175,159,81,240,0,0,0,0
"13096",2018-12-01,"sbjv","transporte não regular","voo internacional",0,0,0,0,0,0,0,0,0,0
"13097",2018-12-01,"sblo","transporte regular","voo doméstico",416,414,830,42893,41671,84564,0,0,0,0
"13098",2018-12-01,"sblo","transporte regular","voo internacional",0,0,0,0,0,0,0,0,0,0
"13099",2018-12-01,"sblo","transporte não regular","voo doméstico",435,440,875,311,437,748,0,0,0,0
"13100",2018-12-01,"sblo","transporte não regular","voo internacional",1,1,2,0,0,0,0,0,0,0
"13101",2018-12-01,"sbma","transporte regular","voo doméstico",131,130,261,12722,12021,24743,0,0,0,0
"13102",2018-12-01,"sbma","transporte regular","voo internacional",0,0,0,0,0,0,0,0,0,0
"13103",2018-12-01,"sbma","transporte não regular","voo doméstico",118,120,238,200,194,394,0,0,0,0
"13104",2018-12-01,"sbma","transporte não regular","voo internacional",1,1,2,0,0,0,0,0,0,0
"13105",2018-12-01,"sbmk","transporte regular","voo doméstico",132,131,263,9333,8266,17599,0,0,0,0
"13106",2018-12-01,"sbmk","transporte regular","voo internacional",0,0,0,0,0,0,0,0,0,0
"13107",2018-12-01,"sbmk","transporte não regular","voo doméstico",191,191,382,331,2,333,0,0,0,0
"13108",2018-12-01,"sbmk","transporte não regular","voo internacional",0,0,0,0,0,0,0,0,0,0
"13109",2018-12-01,"sbmq","transporte regular","voo doméstico",211,209,420,28041,23330,51371,14960,35122,50082,0
"13110",2018-12-01,"sbmq","transporte regular","voo internacional",0,0,0,0,0,0,0,0,0,0
"13111",2018-12-01,"sbmq","transporte não regular","voo doméstico",121,121,242,793,469,1262,0,0,0,0
"13112",2018-12-01,"sbmq","transporte não regular","voo internacional",6,8,14,0,0,0,0,0,0,0
"13113",2018-12-01,"sbmt","transporte regular","voo doméstico",0,0,0,0,0,0,0,0,0,0
"13114",2018-12-01,"sbmt","transporte regular","voo internacional",0,0,0,0,0,0,0,0,0,0
"13115",2018-12-01,"sbmt","transporte não regular","voo doméstico",3180,3205,6385,4967,4745,9712,0,0,0,0
"13116",2018-12-01,"sbmt","transporte não regular","voo internacional",0,0,0,0,0,0,0,0,0,0
"13117",2018-12-01,"sbnf","transporte regular","voo doméstico",663,657,1320,79447,87723,167170,0,0,0,0
"13118",2018-12-01,"sbnf","transporte regular","voo internacional",18,21,39,2200,1849,4049,0,0,0,0
"13119",2018-12-01,"sbnf","transporte não regular","voo doméstico",439,429,868,592,1215,1807,0,0,0,0
"13120",2018-12-01,"sbnf","transporte não regular","voo internacional",6,5,11,0,31,31,0,0,0,0
"13121",2018-12-01,"sbpb","transporte regular","voo doméstico",5,5,10,263,405,668,0,0,0,0
"13122",2018-12-01,"sbpb","transporte regular","voo internacional",0,0,0,0,0,0,0,0,0,0
"13123",2018-12-01,"sbpb","transporte não regular","voo doméstico",50,46,96,125,173,298,0,0,0,0
"13124",2018-12-01,"sbpb","transporte não regular","voo internacional",0,0,0,0,0,0,0,0,0,0
"13125",2018-12-01,"sbpj","transporte regular","voo doméstico",272,271,543,28058,26806,54864,0,0,0,0
"13126",2018-12-01,"sbpj","transporte regular","voo internacional",0,0,0,0,0,0,0,0,0,0
"13127",2018-12-01,"sbpj","transporte não regular","voo doméstico",162,165,327,298,279,577,0,0,0,0
"13128",2018-12-01,"sbpj","transporte não regular","voo internacional",2,2,4,0,0,0,0,0,0,0
"13129",2018-12-01,"sbpk","transporte regular","voo doméstico",22,22,44,1236,1276,2512,0,0,0,0
"13130",2018-12-01,"sbpk","transporte regular","voo internacional",0,0,0,0,0,0,0,0,0,0
"13131",2018-12-01,"sbpk","transporte não regular","voo doméstico",42,45,87,80,82,162,0,0,0,0
"13132",2018-12-01,"sbpk","transporte não regular","voo internacional",2,1,3,0,4,4,0,0,0,0
"13133",2018-12-01,"sbpl","transporte regular","voo doméstico",164,165,329,20382,21187,41569,0,0,0,0
"13134",2018-12-01,"sbpl","transporte regular","voo internacional",2,2,4,0,0,0,0,0,0,0
"13135",2018-12-01,"sbpl","transporte não regular","voo doméstico",67,66,133,90,81,171,0,0,0,0
"13136",2018-12-01,"sbpl","transporte não regular","voo internacional",1,1,2,0,0,0,0,0,0,0
"13137",2018-12-01,"sbpp","transporte regular","voo doméstico",0,0,0,0,0,0,0,0,0,0
"13138",2018-12-01,"sbpp","transporte regular","voo internacional",0,0,0,0,0,0,0,0,0,0
"13139",2018-12-01,"sbpp","transporte não regular","voo doméstico",121,124,245,225,232,457,0,0,0,0
"13140",2018-12-01,"sbpp","transporte não regular","voo internacional",7,5,12,11,16,27,0,0,0,0
"13141",2018-12-01,"sbpr","transporte regular","voo doméstico",0,0,0,0,0,0,0,0,0,0
"13142",2018-12-01,"sbpr","transporte regular","voo internacional",0,0,0,0,0,0,0,0,0,0
"13143",2018-12-01,"sbpr","transporte não regular","voo doméstico",616,624,1240,752,661,1413,0,0,0,0
"13144",2018-12-01,"sbpr","transporte não regular","voo internacional",0,0,0,0,0,0,0,0,0,0
"13145",2018-12-01,"sbpv","transporte regular","voo doméstico",337,337,674,42294,36343,78637,0,0,0,0
"13146",2018-12-01,"sbpv","transporte regular","voo internacional",0,0,0,0,0,0,0,0,0,0
"13147",2018-12-01,"sbpv","transporte não regular","voo doméstico",193,193,386,119,72,191,0,0,0,0
"13148",2018-12-01,"sbpv","transporte não regular","voo internacional",0,0,0,0,0,0,0,0,0,0
"13149",2018-12-01,"sbrb","transporte regular","voo doméstico",152,152,304,20123,14828,34951,0,0,0,0
"13150",2018-12-01,"sbrb","transporte regular","voo internacional",0,0,0,0,0,0,0,0,0,0
"13151",2018-12-01,"sbrb","transporte não regular","voo doméstico",176,181,357,416,373,789,0,0,0,0
"13152",2018-12-01,"sbrb","transporte não regular","voo internacional",1,1,2,0,0,0,0,0,0,0
"13153",2018-12-01,"sbrj","transporte regular","voo doméstico",3692,3720,7412,391595,417315,808910,0,0,0,0
"13154",2018-12-01,"sbrj","transporte regular","voo internacional",0,0,0,0,0,0,0,0,0,0
"13155",2018-12-01,"sbrj","transporte não regular","voo doméstico",573,554,1127,1561,870,2431,0,0,0,0
"13156",2018-12-01,"sbrj","transporte não regular","voo internacional",2,1,3,1,0,1,0,0,0,0
"13157",2018-12-01,"sbsj","transporte regular","voo doméstico",17,17,34,870,757,1627,0,0,0,0
"13158",2018-12-01,"sbsj","transporte regular","voo internacional",0,0,0,0,0,0,0,0,0,0
"13159",2018-12-01,"sbsj","transporte não regular","voo doméstico",364,351,715,899,864,1763,0,0,0,0
"13160",2018-12-01,"sbsj","transporte não regular","voo internacional",3,22,25,56,3,59,0,0,0,0
"13161",2018-12-01,"sbsl","transporte regular","voo doméstico",589,587,1176,74314,77926,152240,0,0,0,0
"13162",2018-12-01,"sbsl","transporte regular","voo internacional",0,0,0,0,0,0,0,0,0,0
"13163",2018-12-01,"sbsl","transporte não regular","voo doméstico",226,232,458,658,835,1493,0,0,0,0
"13164",2018-12-01,"sbsl","transporte não regular","voo internacional",1,1,2,0,0,0,0,0,0,0
"13165",2018-12-01,"sbsn","transporte regular","voo doméstico",259,256,515,23264,21566,44830,0,0,0,0
"13166",2018-12-01,"sbsn","transporte regular","voo internacional",0,0,0,0,0,0,0,0,0,0
"13167",2018-12-01,"sbsn","transporte não regular","voo doméstico",174,177,351,2249,2381,4630,1950,2500,4450,0
"13168",2018-12-01,"sbsn","transporte não regular","voo internacional",1,1,2,0,0,0,0,0,0,0
"13169",2018-12-01,"sbsp","transporte regular","voo doméstico",7194,7246,14440,1014958,926055,1941013,0,0,0,0
"13170",2018-12-01,"sbsp","transporte regular","voo internacional",0,0,0,0,0,0,0,0,0,0
"13171",2018-12-01,"sbsp","transporte não regular","voo doméstico",2263,2190,4453,39166,30110,69276,0,0,0,0
"13172",2018-12-01,"sbsp","transporte não regular","voo internacional",3,3,6,6,6,12,0,0,0,0
"13173",2018-12-01,"sbte","transporte regular","voo doméstico",390,390,780,49894,55481,105375,0,0,0,0
"13174",2018-12-01,"sbte","transporte regular","voo internacional",0,0,0,0,0,0,0,0,0,0
"13175",2018-12-01,"sbte","transporte não regular","voo doméstico",141,145,286,846,1130,1976,0,0,0,0
"13176",2018-12-01,"sbte","transporte não regular","voo internacional",0,0,0,0,0,0,0,0,0,0
"13177",2018-12-01,"sbtf","transporte regular","voo doméstico",34,34,68,1479,1572,3051,0,0,0,0
"13178",2018-12-01,"sbtf","transporte regular","voo internacional",0,0,0,0,0,0,0,0,0,0
"13179",2018-12-01,"sbtf","transporte não regular","voo doméstico",107,108,215,173,186,359,659,8,667,2275
"13180",2018-12-01,"sbtf","transporte não regular","voo internacional",1,1,2,0,0,0,0,0,0,0
"13181",2018-12-01,"sbtt","transporte regular","voo doméstico",31,31,62,2857,3481,6338,0,0,0,0
"13182",2018-12-01,"sbtt","transporte regular","voo internacional",0,0,0,0,0,0,0,0,0,0
"13183",2018-12-01,"sbtt","transporte não regular","voo doméstico",91,92,183,431,360,791,635,395,1030,0
"13184",2018-12-01,"sbtt","transporte não regular","voo internacional",2,1,3,2,3,5,0,0,0,0
"13185",2018-12-01,"sbuf","transporte regular","voo doméstico",9,9,18,489,488,977,0,0,0,0
"13186",2018-12-01,"sbuf","transporte regular","voo internacional",0,0,0,0,0,0,0,0,0,0
"13187",2018-12-01,"sbuf","transporte não regular","voo doméstico",21,21,42,42,51,93,0,0,0,0
"13188",2018-12-01,"sbuf","transporte não regular","voo internacional",0,0,0,0,0,0,0,0,0,0
"13189",2018-12-01,"sbug","transporte regular","voo doméstico",16,16,32,792,766,1558,0,0,0,0
"13190",2018-12-01,"sbug","transporte regular","voo internacional",0,0,0,0,0,0,0,0,0,0
"13191",2018-12-01,"sbug","transporte não regular","voo doméstico",11,12,23,21,12,33,0,0,0,0
"13192",2018-12-01,"sbug","transporte não regular","voo internacional",0,0,0,0,0,0,0,0,0,0
"13193",2018-12-01,"sbul","transporte regular","voo doméstico",529,530,1059,51227,48693,99920,0,0,0,0
"13194",2018-12-01,"sbul","transporte regular","voo internacional",0,0,0,0,0,0,0,0,0,0
"13195",2018-12-01,"sbul","transporte não regular","voo doméstico",401,406,807,1142,929,2071,0,0,0,0
"13196",2018-12-01,"sbul","transporte não regular","voo internacional",2,2,4,2,2,4,0,0,0,0
"13197",2018-12-01,"sbur","transporte regular","voo doméstico",50,51,101,2513,2385,4898,0,0,0,0
"13198",2018-12-01,"sbur","transporte regular","voo internacional",0,0,0,0,0,0,0,0,0,0
"13199",2018-12-01,"sbur","transporte não regular","voo doméstico",168,165,333,640,606,1246,0,0,0,0
"13200",2018-12-01,"sbur","transporte não regular","voo internacional",1,1,2,0,0,0,0,0,0,0
"13201",2018-02-01,"sbbe","transporte regular","voo doméstico",963,980,1943,118059,108063,226122,72051,241153,313204,0
"13202",2018-02-01,"sbbe","transporte regular","voo internacional",51,51,102,6180,6442,12622,3,53,56,0
"13203",2018-02-01,"sbbe","transporte não regular","voo doméstico",354,335,689,1955,3929,5884,0,0,0,0
"13204",2018-02-01,"sbbe","transporte não regular","voo internacional",7,5,12,10,10,20,0,0,0,0
"13205",2018-02-01,"sbbg","transporte regular","voo doméstico",0,0,0,0,0,0,0,0,0,0
"13206",2018-02-01,"sbbg","transporte regular","voo internacional",0,0,0,0,0,0,0,0,0,0
"13207",2018-02-01,"sbbg","transporte não regular","voo doméstico",10,11,21,40,47,87,0,0,0,0
"13208",2018-02-01,"sbbg","transporte não regular","voo internacional",1,0,1,0,2,2,0,0,0,0
"13209",2018-02-01,"sbbh","transporte regular","voo doméstico",89,89,178,2569,2508,5077,0,0,0,0
"13210",2018-02-01,"sbbh","transporte regular","voo internacional",0,0,0,0,0,0,0,0,0,0
"13211",2018-02-01,"sbbh","transporte não regular","voo doméstico",1274,1285,2559,6232,6144,12376,0,0,0,0
"13212",2018-02-01,"sbbh","transporte não regular","voo internacional",4,4,8,12,12,24,0,0,0,0
"13213",2018-02-01,"sbbi","transporte regular","voo doméstico",0,0,0,0,0,0,0,0,0,0
"13214",2018-02-01,"sbbi","transporte regular","voo internacional",0,0,0,0,0,0,0,0,0,0
"13215",2018-02-01,"sbbi","transporte não regular","voo doméstico",947,953,1900,2759,2777,5536,0,0,0,0
"13216",2018-02-01,"sbbi","transporte não regular","voo internacional",0,0,0,0,0,0,0,0,0,0
"13217",2018-02-01,"sbbv","transporte regular","voo doméstico",80,80,160,10695,10683,21378,0,0,0,0
"13218",2018-02-01,"sbbv","transporte regular","voo internacional",0,0,0,0,0,0,0,0,0,0
"13219",2018-02-01,"sbbv","transporte não regular","voo doméstico",99,103,202,127,70,197,0,0,0,0
"13220",2018-02-01,"sbbv","transporte não regular","voo internacional",18,16,34,2,9,11,0,0,0,0
"13221",2018-02-01,"sbcg","transporte regular","voo doméstico",494,494,988,53994,57927,111921,0,0,0,0
"13222",2018-02-01,"sbcg","transporte regular","voo internacional",12,12,24,76,74,150,0,0,0,0
"13223",2018-02-01,"sbcg","transporte não regular","voo doméstico",174,173,347,524,269,793,60328,69603,129931,0
"13224",2018-02-01,"sbcg","transporte não regular","voo internacional",8,5,13,0,0,0,0,0,0,0
"13225",2018-02-01,"sbcj","transporte regular","voo doméstico",67,67,134,3796,3572,7368,0,0,0,0
"13226",2018-02-01,"sbcj","transporte regular","voo internacional",0,0,0,0,0,0,0,0,0,0
"13227",2018-02-01,"sbcj","transporte não regular","voo doméstico",57,57,114,933,374,1307,0,0,0,0
"13228",2018-02-01,"sbcj","transporte não regular","voo internacional",0,0,0,0,0,0,0,0,0,0
"13229",2018-02-01,"sbcr","transporte regular","voo doméstico",12,12,24,625,887,1512,0,0,0,0
"13230",2018-02-01,"sbcr","transporte regular","voo internacional",0,0,0,0,0,0,0,0,0,0
"13231",2018-02-01,"sbcr","transporte não regular","voo doméstico",32,32,64,448,395,843,0,0,0,0
"13232",2018-02-01,"sbcr","transporte não regular","voo internacional",0,0,0,0,0,0,0,0,0,0
"13233",2018-02-01,"sbct","transporte regular","voo doméstico",1959,1976,3935,208319,217025,425344,132196,33471,165667,303267
"13234",2018-02-01,"sbct","transporte regular","voo internacional",71,71,142,3629,3443,7072,0,29207,29207,0
"13235",2018-02-01,"sbct","transporte não regular","voo doméstico",345,319,664,13486,14903,28389,0,0,0,0
"13236",2018-02-01,"sbct","transporte não regular","voo internacional",9,11,20,29,21,50,0,0,0,0
"13237",2018-02-01,"sbcz","transporte regular","voo doméstico",39,38,77,3028,2541,5569,0,0,0,0
"13238",2018-02-01,"sbcz","transporte regular","voo internacional",0,0,0,0,0,0,0,0,0,0
"13239",2018-02-01,"sbcz","transporte não regular","voo doméstico",118,120,238,393,423,816,0,0,0,0
"13240",2018-02-01,"sbcz","transporte não regular","voo internacional",1,1,2,0,0,0,0,0,0,0
"13241",2018-02-01,"sbeg","transporte regular","voo doméstico",779,773,1552,87808,90133,177941,0,0,0,0
"13242",2018-02-01,"sbeg","transporte regular","voo internacional",101,111,212,4655,6051,10706,0,0,0,0
"13243",2018-02-01,"sbeg","transporte não regular","voo doméstico",440,443,883,7656,5028,12684,0,0,0,0
"13244",2018-02-01,"sbeg","transporte não regular","voo internacional",62,57,119,333,207,540,0,0,0,0
"13245",2018-02-01,"sbfi","transporte regular","voo doméstico",553,558,1111,80543,85156,165699,0,0,0,0
"13246",2018-02-01,"sbfi","transporte regular","voo internacional",20,20,40,2731,3121,5852,0,0,0,0
"13247",2018-02-01,"sbfi","transporte não regular","voo doméstico",211,207,418,10837,11883,22720,0,0,0,0
"13248",2018-02-01,"sbfi","transporte não regular","voo internacional",40,38,78,85,110,195,0,0,0,0
"13249",2018-02-01,"sbgo","transporte regular","voo doméstico",1061,1055,2116,105555,103845,209400,90308,137252,227560,101834
"13250",2018-02-01,"sbgo","transporte regular","voo internacional",0,0,0,0,0,0,0,0,0,0
"13251",2018-02-01,"sbgo","transporte não regular","voo doméstico",1249,1256,2505,7040,6176,13216,0,0,0,0
"13252",2018-02-01,"sbgo","transporte não regular","voo internacional",1,1,2,0,0,0,0,0,0,0
"13253",2018-02-01,"sbht","transporte regular","voo doméstico",88,88,176,3618,3341,6959,0,0,0,0
"13254",2018-02-01,"sbht","transporte regular","voo internacional",0,0,0,0,0,0,0,0,0,0
"13255",2018-02-01,"sbht","transporte não regular","voo doméstico",44,43,87,121,106,227,0,0,0,0
"13256",2018-02-01,"sbht","transporte não regular","voo internacional",0,0,0,0,0,0,0,0,0,0
"13257",2018-02-01,"sbiz","transporte regular","voo doméstico",96,96,192,10933,10078,21011,0,0,0,0
"13258",2018-02-01,"sbiz","transporte regular","voo internacional",0,0,0,0,0,0,0,0,0,0
"13259",2018-02-01,"sbiz","transporte não regular","voo doméstico",103,101,204,276,240,516,0,0,0,0
"13260",2018-02-01,"sbiz","transporte não regular","voo internacional",0,0,0,0,0,0,0,0,0,0
"13261",2018-02-01,"sbjc","transporte regular","voo doméstico",0,0,0,0,0,0,0,0,0,0
"13262",2018-02-01,"sbjc","transporte regular","voo internacional",0,0,0,0,0,0,0,0,0,0
"13263",2018-02-01,"sbjc","transporte não regular","voo doméstico",257,251,508,469,251,720,0,0,0,0
"13264",2018-02-01,"sbjc","transporte não regular","voo internacional",0,0,0,0,0,0,0,0,0,0
"13265",2018-02-01,"sbjr","transporte regular","voo doméstico",0,0,0,0,0,0,0,0,0,0
"13266",2018-02-01,"sbjr","transporte regular","voo internacional",0,0,0,0,0,0,0,0,0,0
"13267",2018-02-01,"sbjr","transporte não regular","voo doméstico",2615,2618,5233,9543,4772,14315,0,0,0,0
"13268",2018-02-01,"sbjr","transporte não regular","voo internacional",4,4,8,5,0,5,0,0,0,0
"13269",2018-02-01,"sbjv","transporte regular","voo doméstico",177,177,354,15675,15884,31559,0,0,0,0
"13270",2018-02-01,"sbjv","transporte regular","voo internacional",0,0,0,0,0,0,0,0,0,0
"13271",2018-02-01,"sbjv","transporte não regular","voo doméstico",107,106,213,808,861,1669,0,0,0,0
"13272",2018-02-01,"sbjv","transporte não regular","voo internacional",0,0,0,0,0,0,0,0,0,0
"13273",2018-02-01,"sblo","transporte regular","voo doméstico",352,344,696,29252,29329,58581,0,0,0,0
"13274",2018-02-01,"sblo","transporte regular","voo internacional",0,0,0,0,0,0,0,0,0,0
"13275",2018-02-01,"sblo","transporte não regular","voo doméstico",512,516,1028,1310,915,2225,0,0,0,0
"13276",2018-02-01,"sblo","transporte não regular","voo internacional",1,1,2,0,0,0,0,0,0,0
"13277",2018-02-01,"sbma","transporte regular","voo doméstico",114,115,229,10108,8726,18834,0,0,0,0
"13278",2018-02-01,"sbma","transporte regular","voo internacional",0,0,0,0,0,0,0,0,0,0
"13279",2018-02-01,"sbma","transporte não regular","voo doméstico",104,106,210,333,246,579,0,0,0,0
"13280",2018-02-01,"sbma","transporte não regular","voo internacional",2,1,3,0,0,0,0,0,0,0
"13281",2018-02-01,"sbmk","transporte regular","voo doméstico",82,74,156,5820,6150,11970,0,0,0,0
"13282",2018-02-01,"sbmk","transporte regular","voo internacional",0,0,0,0,0,0,0,0,0,0
"13283",2018-02-01,"sbmk","transporte não regular","voo doméstico",166,170,336,2016,1472,3488,0,0,0,0
"13284",2018-02-01,"sbmk","transporte não regular","voo internacional",0,0,0,0,0,0,0,0,0,0
"13285",2018-02-01,"sbmq","transporte regular","voo doméstico",182,182,364,19438,19069,38507,12040,25520,37560,0
"13286",2018-02-01,"sbmq","transporte regular","voo internacional",0,0,0,0,0,0,0,0,0,0
"13287",2018-02-01,"sbmq","transporte não regular","voo doméstico",102,101,203,218,40,258,0,0,0,0
"13288",2018-02-01,"sbmq","transporte não regular","voo internacional",3,5,8,0,0,0,0,0,0,0
"13289",2018-02-01,"sbmt","transporte regular","voo doméstico",0,0,0,0,0,0,0,0,0,0
"13290",2018-02-01,"sbmt","transporte regular","voo internacional",0,0,0,0,0,0,0,0,0,0
"13291",2018-02-01,"sbmt","transporte não regular","voo doméstico",2896,2883,5779,4865,4829,9694,0,0,0,0
"13292",2018-02-01,"sbmt","transporte não regular","voo internacional",0,0,0,0,0,0,0,0,0,0
"13293",2018-02-01,"sbnf","transporte regular","voo doméstico",610,599,1209,65626,65768,131394,8,0,8,0
"13294",2018-02-01,"sbnf","transporte regular","voo internacional",24,26,50,2645,2421,5066,0,0,0,0
"13295",2018-02-01,"sbnf","transporte não regular","voo doméstico",299,304,603,2533,2200,4733,0,0,0,0
"13296",2018-02-01,"sbnf","transporte não regular","voo internacional",3,5,8,38,8,46,0,0,0,0
"13297",2018-02-01,"sbpb","transporte regular","voo doméstico",3,3,6,204,259,463,0,0,0,0
"13298",2018-02-01,"sbpb","transporte regular","voo internacional",0,0,0,0,0,0,0,0,0,0
"13299",2018-02-01,"sbpb","transporte não regular","voo doméstico",79,79,158,248,283,531,0,0,0,0
"13300",2018-02-01,"sbpb","transporte não regular","voo internacional",0,0,0,0,0,0,0,0,0,0
"13301",2018-02-01,"sbpj","transporte regular","voo doméstico",261,261,522,23401,22341,45742,0,0,0,0
"13302",2018-02-01,"sbpj","transporte regular","voo internacional",0,0,0,0,0,0,0,0,0,0
"13303",2018-02-01,"sbpj","transporte não regular","voo doméstico",199,204,403,301,162,463,0,0,0,0
"13304",2018-02-01,"sbpj","transporte não regular","voo internacional",1,1,2,0,0,0,0,0,0,0
"13305",2018-02-01,"sbpk","transporte regular","voo doméstico",23,23,46,1087,1186,2273,0,0,0,0
"13306",2018-02-01,"sbpk","transporte regular","voo internacional",0,0,0,0,0,0,0,0,0,0
"13307",2018-02-01,"sbpk","transporte não regular","voo doméstico",30,32,62,44,50,94,0,0,0,0
"13308",2018-02-01,"sbpk","transporte não regular","voo internacional",3,2,5,4,0,4,0,0,0,0
"13309",2018-02-01,"sbpl","transporte regular","voo doméstico",142,145,287,17766,16544,34310,0,0,0,0
"13310",2018-02-01,"sbpl","transporte regular","voo internacional",1,1,2,0,0,0,0,0,0,0
"13311",2018-02-01,"sbpl","transporte não regular","voo doméstico",81,79,160,270,429,699,0,0,0,0
"13312",2018-02-01,"sbpl","transporte não regular","voo internacional",0,0,0,0,0,0,0,0,0,0
"13313",2018-02-01,"sbpp","transporte regular","voo doméstico",0,0,0,0,0,0,0,0,0,0
"13314",2018-02-01,"sbpp","transporte regular","voo internacional",0,0,0,0,0,0,0,0,0,0
"13315",2018-02-01,"sbpp","transporte não regular","voo doméstico",105,99,204,154,168,322,0,0,0,0
"13316",2018-02-01,"sbpp","transporte não regular","voo internacional",4,4,8,4,3,7,0,0,0,0
"13317",2018-02-01,"sbpr","transporte regular","voo doméstico",0,0,0,0,0,0,0,0,0,0
"13318",2018-02-01,"sbpr","transporte regular","voo internacional",0,0,0,0,0,0,0,0,0,0
"13319",2018-02-01,"sbpr","transporte não regular","voo doméstico",545,542,1087,627,632,1259,0,0,0,0
"13320",2018-02-01,"sbpr","transporte não regular","voo internacional",0,1,1,0,0,0,0,0,0,0
"13321",2018-02-01,"sbpv","transporte regular","voo doméstico",278,279,557,27112,30207,57319,0,0,0,0
"13322",2018-02-01,"sbpv","transporte regular","voo internacional",0,0,0,0,0,0,0,0,0,0
"13323",2018-02-01,"sbpv","transporte não regular","voo doméstico",171,169,340,215,15,230,0,0,0,0
"13324",2018-02-01,"sbpv","transporte não regular","voo internacional",0,0,0,0,0,0,0,0,0,0
"13325",2018-02-01,"sbrb","transporte regular","voo doméstico",103,104,207,6519,7094,13613,0,0,0,0
"13326",2018-02-01,"sbrb","transporte regular","voo internacional",0,0,0,0,0,0,0,0,0,0
"13327",2018-02-01,"sbrb","transporte não regular","voo doméstico",97,96,193,297,146,443,0,0,0,0
"13328",2018-02-01,"sbrb","transporte não regular","voo internacional",1,1,2,0,0,0,0,0,0,0
"13329",2018-02-01,"sbrj","transporte regular","voo doméstico",3291,3330,6621,344186,339352,683538,0,0,0,0
"13330",2018-02-01,"sbrj","transporte regular","voo internacional",0,0,0,0,0,0,0,0,0,0
"13331",2018-02-01,"sbrj","transporte não regular","voo doméstico",679,640,1319,9680,11613,21293,0,0,0,0
"13332",2018-02-01,"sbrj","transporte não regular","voo internacional",1,1,2,2,0,2,0,0,0,0
"13333",2018-02-01,"sbsj","transporte regular","voo doméstico",0,0,0,0,0,0,0,0,0,0
"13334",2018-02-01,"sbsj","transporte regular","voo internacional",0,0,0,0,0,0,0,0,0,0
"13335",2018-02-01,"sbsj","transporte não regular","voo doméstico",395,375,770,864,896,1760,0,0,0,0
"13336",2018-02-01,"sbsj","transporte não regular","voo internacional",0,5,5,3,0,3,0,0,0,0
"13337",2018-02-01,"sbsl","transporte regular","voo doméstico",490,481,971,58975,53310,112285,0,0,0,0
"13338",2018-02-01,"sbsl","transporte regular","voo internacional",0,0,0,0,0,0,0,0,0,0
"13339",2018-02-01,"sbsl","transporte não regular","voo doméstico",187,196,383,3685,2610,6295,42965,147192,190157,0
"13340",2018-02-01,"sbsl","transporte não regular","voo internacional",0,0,0,0,0,0,0,0,0,0
"13341",2018-02-01,"sbsn","transporte regular","voo doméstico",208,208,416,15369,13581,28950,0,0,0,0
"13342",2018-02-01,"sbsn","transporte regular","voo internacional",0,0,0,0,0,0,0,0,0,0
"13343",2018-02-01,"sbsn","transporte não regular","voo doméstico",167,167,334,361,226,587,2400,3500,5900,0
"13344",2018-02-01,"sbsn","transporte não regular","voo internacional",0,0,0,0,0,0,0,0,0,0
"13345",2018-02-01,"sbsp","transporte regular","voo doméstico",6653,6694,13347,800128,803593,1603721,0,0,0,0
"13346",2018-02-01,"sbsp","transporte regular","voo internacional",0,0,0,0,0,0,0,0,0,0
"13347",2018-02-01,"sbsp","transporte não regular","voo doméstico",1853,1810,3663,9425,9316,18741,0,0,0,0
"13348",2018-02-01,"sbsp","transporte não regular","voo internacional",5,4,9,8,15,23,0,0,0,0
"13349",2018-02-01,"sbte","transporte regular","voo doméstico",334,336,670,37005,31955,68960,16356,71903,88259,174017
"13350",2018-02-01,"sbte","transporte regular","voo internacional",0,0,0,0,0,0,0,0,0,0
"13351",2018-02-01,"sbte","transporte não regular","voo doméstico",170,174,344,2625,1938,4563,0,1553,1553,1600
"13352",2018-02-01,"sbte","transporte não regular","voo internacional",0,0,0,0,0,0,0,0,0,0
"13353",2018-02-01,"sbtf","transporte regular","voo doméstico",27,27,54,954,1247,2201,0,0,0,0
"13354",2018-02-01,"sbtf","transporte regular","voo internacional",0,0,0,0,0,0,0,0,0,0
"13355",2018-02-01,"sbtf","transporte não regular","voo doméstico",88,88,176,139,84,223,0,0,0,0
"13356",2018-02-01,"sbtf","transporte não regular","voo internacional",0,0,0,0,0,0,0,0,0,0
"13357",2018-02-01,"sbtt","transporte regular","voo doméstico",27,27,54,2069,2625,4694,70,0,70,0
"13358",2018-02-01,"sbtt","transporte regular","voo internacional",0,0,0,0,0,0,0,0,0,0
"13359",2018-02-01,"sbtt","transporte não regular","voo doméstico",68,69,137,406,317,723,0,0,0,0
"13360",2018-02-01,"sbtt","transporte não regular","voo internacional",0,0,0,0,0,0,0,0,0,0
"13361",2018-02-01,"sbuf","transporte regular","voo doméstico",8,8,16,282,380,662,0,0,0,0
"13362",2018-02-01,"sbuf","transporte regular","voo internacional",0,0,0,0,0,0,0,0,0,0
"13363",2018-02-01,"sbuf","transporte não regular","voo doméstico",11,13,24,47,60,107,0,0,0,0
"13364",2018-02-01,"sbuf","transporte não regular","voo internacional",0,0,0,0,0,0,0,0,0,0
"13365",2018-02-01,"sbug","transporte regular","voo doméstico",15,15,30,828,835,1663,0,0,0,0
"13366",2018-02-01,"sbug","transporte regular","voo internacional",0,0,0,0,0,0,0,0,0,0
"13367",2018-02-01,"sbug","transporte não regular","voo doméstico",12,12,24,121,124,245,0,0,0,0
"13368",2018-02-01,"sbug","transporte não regular","voo internacional",0,0,0,0,0,0,0,0,0,0
"13369",2018-02-01,"sbul","transporte regular","voo doméstico",385,385,770,34665,35166,69831,0,0,0,0
"13370",2018-02-01,"sbul","transporte regular","voo internacional",0,0,0,0,0,0,0,0,0,0
"13371",2018-02-01,"sbul","transporte não regular","voo doméstico",422,430,852,3388,3350,6738,0,0,0,0
"13372",2018-02-01,"sbul","transporte não regular","voo internacional",0,0,0,0,0,0,0,0,0,0
"13373",2018-02-01,"sbur","transporte regular","voo doméstico",40,38,78,1829,1844,3673,0,0,0,0
"13374",2018-02-01,"sbur","transporte regular","voo internacional",0,0,0,0,0,0,0,0,0,0
"13375",2018-02-01,"sbur","transporte não regular","voo doméstico",159,164,323,548,492,1040,0,0,0,0
"13376",2018-02-01,"sbur","transporte não regular","voo internacional",0,0,0,0,0,0,0,0,0,0
"13377",2018-01-01,"sbbe","transporte regular","voo doméstico",1218,1223,2441,147897,145825,293722,88895,299351,388246,0
"13378",2018-01-01,"sbbe","transporte regular","voo internacional",57,60,117,8336,7255,15591,4,119,123,0
"13379",2018-01-01,"sbbe","transporte não regular","voo doméstico",367,358,725,3145,3954,7099,0,0,0,0
"13380",2018-01-01,"sbbe","transporte não regular","voo internacional",6,6,12,223,224,447,0,0,0,0
"13381",2018-01-01,"sbbg","transporte regular","voo doméstico",0,0,0,0,0,0,0,0,0,0
"13382",2018-01-01,"sbbg","transporte regular","voo internacional",0,0,0,0,0,0,0,0,0,0
"13383",2018-01-01,"sbbg","transporte não regular","voo doméstico",16,16,32,73,63,136,0,0,0,0
"13384",2018-01-01,"sbbg","transporte não regular","voo internacional",0,0,0,0,0,0,0,0,0,0
"13385",2018-01-01,"sbbh","transporte regular","voo doméstico",71,72,143,2465,2499,4964,0,0,0,0
"13386",2018-01-01,"sbbh","transporte regular","voo internacional",0,0,0,0,0,0,0,0,0,0
"13387",2018-01-01,"sbbh","transporte não regular","voo doméstico",1345,1322,2667,6606,6719,13325,0,0,0,0
"13388",2018-01-01,"sbbh","transporte não regular","voo internacional",0,0,0,0,0,0,0,0,0,0
"13389",2018-01-01,"sbbi","transporte regular","voo doméstico",0,0,0,0,0,0,0,0,0,0
"13390",2018-01-01,"sbbi","transporte regular","voo internacional",0,0,0,0,0,0,0,0,0,0
"13391",2018-01-01,"sbbi","transporte não regular","voo doméstico",859,842,1701,2181,2207,4388,0,0,0,0
"13392",2018-01-01,"sbbi","transporte não regular","voo internacional",1,1,2,0,0,0,0,0,0,0
"13393",2018-01-01,"sbbv","transporte regular","voo doméstico",89,89,178,12339,12791,25130,0,0,0,0
"13394",2018-01-01,"sbbv","transporte regular","voo internacional",0,0,0,0,0,0,0,0,0,0
"13395",2018-01-01,"sbbv","transporte não regular","voo doméstico",110,109,219,414,218,632,0,0,0,0
"13396",2018-01-01,"sbbv","transporte não regular","voo internacional",21,20,41,0,1,1,0,0,0,0
"13397",2018-01-01,"sbcg","transporte regular","voo doméstico",586,585,1171,73932,75741,149673,0,8377,8377,0
"13398",2018-01-01,"sbcg","transporte regular","voo internacional",9,9,18,75,84,159,0,0,0,0
"13399",2018-01-01,"sbcg","transporte não regular","voo doméstico",146,147,293,396,421,817,68462,70613,139075,0
"13400",2018-01-01,"sbcg","transporte não regular","voo internacional",5,5,10,0,0,0,0,0,0,0
"13401",2018-01-01,"sbcj","transporte regular","voo doméstico",87,87,174,4098,5501,9599,56,0,56,0
"13402",2018-01-01,"sbcj","transporte regular","voo internacional",0,0,0,0,0,0,0,0,0,0
"13403",2018-01-01,"sbcj","transporte não regular","voo doméstico",77,77,154,789,286,1075,0,0,0,0
"13404",2018-01-01,"sbcj","transporte não regular","voo internacional",0,0,0,0,0,0,0,0,0,0
"13405",2018-01-01,"sbcr","transporte regular","voo doméstico",18,18,36,912,1067,1979,0,0,0,0
"13406",2018-01-01,"sbcr","transporte regular","voo internacional",0,0,0,0,0,0,0,0,0,0
"13407",2018-01-01,"sbcr","transporte não regular","voo doméstico",30,30,60,396,320,716,0,0,0,0
"13408",2018-01-01,"sbcr","transporte não regular","voo internacional",2,2,4,0,0,0,0,0,0,0
"13409",2018-01-01,"sbct","transporte regular","voo doméstico",2273,2304,4577,262198,252257,514455,160178,55787,215965,327712
"13410",2018-01-01,"sbct","transporte regular","voo internacional",79,80,159,3527,4261,7788,0,123946,123946,47275
"13411",2018-01-01,"sbct","transporte não regular","voo doméstico",327,300,627,13642,15996,29638,0,0,0,0
"13412",2018-01-01,"sbct","transporte não regular","voo internacional",10,11,21,181,253,434,0,0,0,0
"13413",2018-01-01,"sbcz","transporte regular","voo doméstico",43,43,86,3146,2584,5730,0,0,0,0
"13414",2018-01-01,"sbcz","transporte regular","voo internacional",0,0,0,0,0,0,0,0,0,0
"13415",2018-01-01,"sbcz","transporte não regular","voo doméstico",155,155,310,516,520,1036,0,0,0,0
"13416",2018-01-01,"sbcz","transporte não regular","voo internacional",0,0,0,0,0,0,0,0,0,0
"13417",2018-01-01,"sbeg","transporte regular","voo doméstico",921,909,1830,116959,118187,235146,0,0,0,0
"13418",2018-01-01,"sbeg","transporte regular","voo internacional",109,115,224,6678,6466,13144,0,0,0,0
"13419",2018-01-01,"sbeg","transporte não regular","voo doméstico",537,541,1078,5876,4362,10238,0,0,0,0
"13420",2018-01-01,"sbeg","transporte não regular","voo internacional",72,73,145,627,250,877,0,0,0,0
"13421",2018-01-01,"sbfi","transporte regular","voo doméstico",739,761,1500,117022,104363,221385,0,0,0,0
"13422",2018-01-01,"sbfi","transporte regular","voo internacional",21,21,42,2093,1963,4056,0,0,0,0
"13423",2018-01-01,"sbfi","transporte não regular","voo doméstico",240,213,453,16000,17234,33234,0,0,0,0
"13424",2018-01-01,"sbfi","transporte não regular","voo internacional",43,47,90,72,91,163,0,0,0,0
"13425",2018-01-01,"sbgo","transporte regular","voo doméstico",1208,1229,2437,130761,133928,264689,148664,152003,300667,115456
"13426",2018-01-01,"sbgo","transporte regular","voo internacional",0,0,0,0,0,0,0,0,0,0
"13427",2018-01-01,"sbgo","transporte não regular","voo doméstico",1367,1361,2728,8306,10011,18317,0,0,0,0
"13428",2018-01-01,"sbgo","transporte não regular","voo internacional",3,2,5,0,0,0,0,0,0,0
"13429",2018-01-01,"sbht","transporte regular","voo doméstico",91,91,182,3959,4270,8229,0,0,0,0
"13430",2018-01-01,"sbht","transporte regular","voo internacional",0,0,0,0,0,0,0,0,0,0
"13431",2018-01-01,"sbht","transporte não regular","voo doméstico",44,44,88,46,86,132,0,60,60,0
"13432",2018-01-01,"sbht","transporte não regular","voo internacional",0,0,0,0,0,0,0,0,0,0
"13433",2018-01-01,"sbiz","transporte regular","voo doméstico",107,107,214,12631,12882,25513,0,0,0,0
"13434",2018-01-01,"sbiz","transporte regular","voo internacional",0,0,0,0,0,0,0,0,0,0
"13435",2018-01-01,"sbiz","transporte não regular","voo doméstico",114,116,230,308,269,577,0,0,0,0
"13436",2018-01-01,"sbiz","transporte não regular","voo internacional",0,0,0,0,0,0,0,0,0,0
"13437",2018-01-01,"sbjc","transporte regular","voo doméstico",0,0,0,0,0,0,0,0,0,0
"13438",2018-01-01,"sbjc","transporte regular","voo internacional",0,0,0,0,0,0,0,0,0,0
"13439",2018-01-01,"sbjc","transporte não regular","voo doméstico",322,319,641,597,404,1001,0,0,0,0
"13440",2018-01-01,"sbjc","transporte não regular","voo internacional",0,0,0,0,0,0,0,0,0,0
"13441",2018-01-01,"sbjr","transporte regular","voo doméstico",0,0,0,0,0,0,0,0,0,0
"13442",2018-01-01,"sbjr","transporte regular","voo internacional",0,0,0,0,0,0,0,0,0,0
"13443",2018-01-01,"sbjr","transporte não regular","voo doméstico",2821,2819,5640,10717,6022,16739,0,0,0,0
"13444",2018-01-01,"sbjr","transporte não regular","voo internacional",1,1,2,0,0,0,0,0,0,0
"13445",2018-01-01,"sbjv","transporte regular","voo doméstico",216,214,430,20719,18973,39692,0,0,0,0
"13446",2018-01-01,"sbjv","transporte regular","voo internacional",0,0,0,0,0,0,0,0,0,0
"13447",2018-01-01,"sbjv","transporte não regular","voo doméstico",155,159,314,149,93,242,0,0,0,0
"13448",2018-01-01,"sbjv","transporte não regular","voo internacional",0,0,0,0,0,0,0,0,0,0
"13449",2018-01-01,"sblo","transporte regular","voo doméstico",374,374,748,33276,32307,65583,0,0,0,0
"13450",2018-01-01,"sblo","transporte regular","voo internacional",0,0,0,0,0,0,0,0,0,0
"13451",2018-01-01,"sblo","transporte não regular","voo doméstico",453,446,899,2149,2073,4222,0,0,0,0
"13452",2018-01-01,"sblo","transporte não regular","voo internacional",0,0,0,0,0,0,0,0,0,0
"13453",2018-01-01,"sbma","transporte regular","voo doméstico",137,136,273,11246,11390,22636,0,0,0,0
"13454",2018-01-01,"sbma","transporte regular","voo internacional",0,0,0,0,0,0,0,0,0,0
"13455",2018-01-01,"sbma","transporte não regular","voo doméstico",111,112,223,262,274,536,0,0,0,0
"13456",2018-01-01,"sbma","transporte não regular","voo internacional",0,0,0,0,0,0,0,0,0,0
"13457",2018-01-01,"sbmk","transporte regular","voo doméstico",122,123,245,9932,8847,18779,0,0,0,0
"13458",2018-01-01,"sbmk","transporte regular","voo internacional",0,0,0,0,0,0,0,0,0,0
"13459",2018-01-01,"sbmk","transporte não regular","voo doméstico",206,204,410,1458,1074,2532,0,0,0,0
"13460",2018-01-01,"sbmk","transporte não regular","voo internacional",0,0,0,0,0,0,0,0,0,0
"13461",2018-01-01,"sbmq","transporte regular","voo doméstico",217,218,435,22955,23546,46501,15000,30202,45202,0
"13462",2018-01-01,"sbmq","transporte regular","voo internacional",0,0,0,0,0,0,0,0,0,0
"13463",2018-01-01,"sbmq","transporte não regular","voo doméstico",124,127,251,555,387,942,0,0,0,0
"13464",2018-01-01,"sbmq","transporte não regular","voo internacional",5,4,9,0,0,0,0,0,0,0
"13465",2018-01-01,"sbmt","transporte regular","voo doméstico",0,0,0,0,0,0,0,0,0,0
"13466",2018-01-01,"sbmt","transporte regular","voo internacional",0,0,0,0,0,0,0,0,0,0
"13467",2018-01-01,"sbmt","transporte não regular","voo doméstico",2729,2718,5447,4597,4727,9324,0,0,0,0
"13468",2018-01-01,"sbmt","transporte não regular","voo internacional",0,0,0,0,0,0,0,0,0,0
"13469",2018-01-01,"sbnf","transporte regular","voo doméstico",774,772,1546,91783,83874,175657,0,0,0,0
"13470",2018-01-01,"sbnf","transporte regular","voo internacional",31,31,62,3216,3499,6715,0,0,0,0
"13471",2018-01-01,"sbnf","transporte não regular","voo doméstico",326,341,667,4769,3585,8354,0,0,0,0
"13472",2018-01-01,"sbnf","transporte não regular","voo internacional",23,24,47,744,1076,1820,0,0,0,0
"13473",2018-01-01,"sbpb","transporte regular","voo doméstico",4,4,8,373,424,797,0,0,0,0
"13474",2018-01-01,"sbpb","transporte regular","voo internacional",0,0,0,0,0,0,0,0,0,0
"13475",2018-01-01,"sbpb","transporte não regular","voo doméstico",52,59,111,148,80,228,0,0,0,0
"13476",2018-01-01,"sbpb","transporte não regular","voo internacional",0,0,0,0,0,0,0,0,0,0
"13477",2018-01-01,"sbpj","transporte regular","voo doméstico",293,291,584,27305,29322,56627,0,0,0,0
"13478",2018-01-01,"sbpj","transporte regular","voo internacional",0,0,0,0,0,0,0,0,0,0
"13479",2018-01-01,"sbpj","transporte não regular","voo doméstico",208,204,412,404,330,734,0,0,0,0
"13480",2018-01-01,"sbpj","transporte não regular","voo internacional",0,0,0,0,0,0,0,0,0,0
"13481",2018-01-01,"sbpk","transporte regular","voo doméstico",25,25,50,1160,1204,2364,0,0,0,0
"13482",2018-01-01,"sbpk","transporte regular","voo internacional",0,0,0,0,0,0,0,0,0,0
"13483",2018-01-01,"sbpk","transporte não regular","voo doméstico",30,30,60,53,47,100,0,0,0,0
"13484",2018-01-01,"sbpk","transporte não regular","voo internacional",3,4,7,5,6,11,0,0,0,0
"13485",2018-01-01,"sbpl","transporte regular","voo doméstico",170,169,339,22168,22340,44508,0,0,0,0
"13486",2018-01-01,"sbpl","transporte regular","voo internacional",0,0,0,0,0,0,0,0,0,0
"13487",2018-01-01,"sbpl","transporte não regular","voo doméstico",65,63,128,192,404,596,0,0,0,0
"13488",2018-01-01,"sbpl","transporte não regular","voo internacional",0,0,0,0,0,0,0,0,0,0
"13489",2018-01-01,"sbpp","transporte regular","voo doméstico",0,0,0,0,0,0,0,0,0,0
"13490",2018-01-01,"sbpp","transporte regular","voo internacional",0,0,0,0,0,0,0,0,0,0
"13491",2018-01-01,"sbpp","transporte não regular","voo doméstico",65,64,129,100,107,207,0,0,0,0
"13492",2018-01-01,"sbpp","transporte não regular","voo internacional",2,3,5,5,5,10,0,0,0,0
"13493",2018-01-01,"sbpr","transporte regular","voo doméstico",0,0,0,0,0,0,0,0,0,0
"13494",2018-01-01,"sbpr","transporte regular","voo internacional",0,0,0,0,0,0,0,0,0,0
"13495",2018-01-01,"sbpr","transporte não regular","voo doméstico",753,743,1496,917,897,1814,0,0,0,0
"13496",2018-01-01,"sbpr","transporte não regular","voo internacional",4,3,7,0,0,0,0,0,0,0
"13497",2018-01-01,"sbpv","transporte regular","voo doméstico",336,335,671,39286,40034,79320,0,0,0,0
"13498",2018-01-01,"sbpv","transporte regular","voo internacional",0,0,0,0,0,0,0,0,0,0
"13499",2018-01-01,"sbpv","transporte não regular","voo doméstico",194,199,393,50,0,50,0,0,0,0
"13500",2018-01-01,"sbpv","transporte não regular","voo internacional",0,0,0,0,0,0,0,0,0,0
"13501",2018-01-01,"sbrb","transporte regular","voo doméstico",119,120,239,11438,10628,22066,0,0,0,0
"13502",2018-01-01,"sbrb","transporte regular","voo internacional",0,0,0,0,0,0,0,0,0,0
"13503",2018-01-01,"sbrb","transporte não regular","voo doméstico",117,120,237,318,187,505,0,0,0,0
"13504",2018-01-01,"sbrb","transporte não regular","voo internacional",1,1,2,0,0,0,0,0,0,0
"13505",2018-01-01,"sbrj","transporte regular","voo doméstico",3721,3725,7446,423459,391817,815276,0,0,0,0
"13506",2018-01-01,"sbrj","transporte regular","voo internacional",0,0,0,0,0,0,0,0,0,0
"13507",2018-01-01,"sbrj","transporte não regular","voo doméstico",584,578,1162,12848,11156,24004,0,0,0,0
"13508",2018-01-01,"sbrj","transporte não regular","voo internacional",3,3,6,1,0,1,0,0,0,0
"13509",2018-01-01,"sbsj","transporte regular","voo doméstico",0,0,0,0,0,0,0,0,0,0
"13510",2018-01-01,"sbsj","transporte regular","voo internacional",0,0,0,0,0,0,0,0,0,0
"13511",2018-01-01,"sbsj","transporte não regular","voo doméstico",356,355,711,834,794,1628,0,0,0,0
"13512",2018-01-01,"sbsj","transporte não regular","voo internacional",2,7,9,23,4,27,0,0,0,0
"13513",2018-01-01,"sbsl","transporte regular","voo doméstico",656,655,1311,80054,75045,155099,405,0,405,0
"13514",2018-01-01,"sbsl","transporte regular","voo internacional",0,0,0,0,0,0,0,0,0,0
"13515",2018-01-01,"sbsl","transporte não regular","voo doméstico",207,206,413,973,982,1955,51011,160618,211629,0
"13516",2018-01-01,"sbsl","transporte não regular","voo internacional",1,2,3,0,0,0,0,0,0,0
"13517",2018-01-01,"sbsn","transporte regular","voo doméstico",268,268,536,21779,18854,40633,0,0,0,0
"13518",2018-01-01,"sbsn","transporte regular","voo internacional",0,0,0,0,0,0,0,0,0,0
"13519",2018-01-01,"sbsn","transporte não regular","voo doméstico",204,203,407,893,814,1707,5550,7070,12620,0
"13520",2018-01-01,"sbsn","transporte não regular","voo internacional",0,0,0,0,0,0,0,0,0,0
"13521",2018-01-01,"sbsp","transporte regular","voo doméstico",7502,7536,15038,917022,987554,1904576,0,0,0,0
"13522",2018-01-01,"sbsp","transporte regular","voo internacional",0,0,0,0,0,0,0,0,0,0
"13523",2018-01-01,"sbsp","transporte não regular","voo doméstico",1871,1818,3689,29353,27529,56882,0,0,0,0
"13524",2018-01-01,"sbsp","transporte não regular","voo internacional",4,4,8,8,8,16,0,0,0,0
"13525",2018-01-01,"sbte","transporte regular","voo doméstico",436,443,879,50657,46255,96912,15642,50979,66621,152151
"13526",2018-01-01,"sbte","transporte regular","voo internacional",0,0,0,0,0,0,0,0,0,0
"13527",2018-01-01,"sbte","transporte não regular","voo doméstico",177,161,338,2022,3030,5052,0,0,0,0
"13528",2018-01-01,"sbte","transporte não regular","voo internacional",0,0,0,0,0,0,0,0,0,0
"13529",2018-01-01,"sbtf","transporte regular","voo doméstico",30,30,60,1181,1288,2469,0,0,0,0
"13530",2018-01-01,"sbtf","transporte regular","voo internacional",0,0,0,0,0,0,0,0,0,0
"13531",2018-01-01,"sbtf","transporte não regular","voo doméstico",85,84,169,246,155,401,0,0,0,0
"13532",2018-01-01,"sbtf","transporte não regular","voo internacional",0,0,0,0,0,0,0,0,0,0
"13533",2018-01-01,"sbtt","transporte regular","voo doméstico",31,31,62,2587,2891,5478,0,0,0,0
"13534",2018-01-01,"sbtt","transporte regular","voo internacional",0,0,0,0,0,0,0,0,0,0
"13535",2018-01-01,"sbtt","transporte não regular","voo doméstico",74,75,149,405,284,689,0,0,0,0
"13536",2018-01-01,"sbtt","transporte não regular","voo internacional",2,0,2,0,16,16,0,0,0,0
"13537",2018-01-01,"sbuf","transporte regular","voo doméstico",9,9,18,608,527,1135,0,0,0,0
"13538",2018-01-01,"sbuf","transporte regular","voo internacional",0,0,0,0,0,0,0,0,0,0
"13539",2018-01-01,"sbuf","transporte não regular","voo doméstico",31,30,61,227,212,439,0,0,0,0
"13540",2018-01-01,"sbuf","transporte não regular","voo internacional",0,0,0,0,0,0,0,0,0,0
"13541",2018-01-01,"sbug","transporte regular","voo doméstico",22,22,44,1305,1148,2453,0,0,0,0
"13542",2018-01-01,"sbug","transporte regular","voo internacional",0,0,0,0,0,0,0,0,0,0
"13543",2018-01-01,"sbug","transporte não regular","voo doméstico",8,8,16,17,16,33,0,0,0,0
"13544",2018-01-01,"sbug","transporte não regular","voo internacional",0,0,0,0,0,0,0,0,0,0
"13545",2018-01-01,"sbul","transporte regular","voo doméstico",420,412,832,42655,41890,84545,0,0,0,0
"13546",2018-01-01,"sbul","transporte regular","voo internacional",0,0,0,0,0,0,0,0,0,0
"13547",2018-01-01,"sbul","transporte não regular","voo doméstico",525,532,1057,4618,4171,8789,0,0,0,0
"13548",2018-01-01,"sbul","transporte não regular","voo internacional",1,1,2,5,4,9,0,0,0,0
"13549",2018-01-01,"sbur","transporte regular","voo doméstico",36,35,71,2016,1941,3957,0,0,0,0
"13550",2018-01-01,"sbur","transporte regular","voo internacional",0,0,0,0,0,0,0,0,0,0
"13551",2018-01-01,"sbur","transporte não regular","voo doméstico",133,136,269,413,426,839,0,0,0,0
"13552",2018-01-01,"sbur","transporte não regular","voo internacional",0,0,0,0,0,0,0,0,0,0
"13553",2018-07-01,"sbbe","transporte regular","voo doméstico",1313,1315,2628,174396,167505,341901,61041,182905,243946,0
"13554",2018-07-01,"sbbe","transporte regular","voo internacional",60,59,119,8685,9279,17964,10,581,591,0
"13555",2018-07-01,"sbbe","transporte não regular","voo doméstico",477,468,945,4871,5419,10290,0,0,0,0
"13556",2018-07-01,"sbbe","transporte não regular","voo internacional",10,11,21,25,14,39,0,0,0,0
"13557",2018-07-01,"sbbg","transporte regular","voo doméstico",0,0,0,0,0,0,0,0,0,0
"13558",2018-07-01,"sbbg","transporte regular","voo internacional",0,0,0,0,0,0,0,0,0,0
"13559",2018-07-01,"sbbg","transporte não regular","voo doméstico",6,6,12,21,21,42,0,0,0,0
"13560",2018-07-01,"sbbg","transporte não regular","voo internacional",0,0,0,0,0,0,0,0,0,0
"13561",2018-07-01,"sbbh","transporte regular","voo doméstico",22,22,44,511,526,1037,0,0,0,0
"13562",2018-07-01,"sbbh","transporte regular","voo internacional",0,0,0,0,0,0,0,0,0,0
"13563",2018-07-01,"sbbh","transporte não regular","voo doméstico",1575,1581,3156,7253,7223,14476,0,0,0,0
"13564",2018-07-01,"sbbh","transporte não regular","voo internacional",0,0,0,0,0,0,0,0,0,0
"13565",2018-07-01,"sbbi","transporte regular","voo doméstico",0,0,0,0,0,0,0,0,0,0
"13566",2018-07-01,"sbbi","transporte regular","voo internacional",0,0,0,0,0,0,0,0,0,0
"13567",2018-07-01,"sbbi","transporte não regular","voo doméstico",1223,1219,2442,640,501,1141,0,0,0,0
"13568",2018-07-01,"sbbi","transporte não regular","voo internacional",2,2,4,0,0,0,0,0,0,0
"13569",2018-07-01,"sbbv","transporte regular","voo doméstico",92,93,185,15153,12854,28007,0,0,0,0
"13570",2018-07-01,"sbbv","transporte regular","voo internacional",0,0,0,0,0,0,0,0,0,0
"13571",2018-07-01,"sbbv","transporte não regular","voo doméstico",97,94,191,105,192,297,0,0,0,0
"13572",2018-07-01,"sbbv","transporte não regular","voo internacional",16,14,30,21,0,21,0,0,0,0
"13573",2018-07-01,"sbcg","transporte regular","voo doméstico",592,603,1195,78240,73229,151469,11946,18202,30148,0
"13574",2018-07-01,"sbcg","transporte regular","voo internacional",9,9,18,119,103,222,0,0,0,0
"13575",2018-07-01,"sbcg","transporte não regular","voo doméstico",356,338,694,3002,4903,7905,49062,66576,115638,0
"13576",2018-07-01,"sbcg","transporte não regular","voo internacional",5,6,11,0,0,0,0,0,0,0
"13577",2018-07-01,"sbcj","transporte regular","voo doméstico",87,87,174,5613,5716,11329,0,0,0,0
"13578",2018-07-01,"sbcj","transporte regular","voo internacional",0,0,0,0,0,0,0,0,0,0
"13579",2018-07-01,"sbcj","transporte não regular","voo doméstico",81,79,160,759,544,1303,0,0,0,0
"13580",2018-07-01,"sbcj","transporte não regular","voo internacional",0,0,0,0,0,0,0,0,0,0
"13581",2018-07-01,"sbcr","transporte regular","voo doméstico",20,20,40,1395,1265,2660,0,0,0,0
"13582",2018-07-01,"sbcr","transporte regular","voo internacional",0,0,0,0,0,0,0,0,0,0
"13583",2018-07-01,"sbcr","transporte não regular","voo doméstico",52,52,104,86,128,214,0,0,0,0
"13584",2018-07-01,"sbcr","transporte não regular","voo internacional",1,1,2,7,7,14,0,0,0,0
"13585",2018-07-01,"sbct","transporte regular","voo doméstico",2398,2406,4804,288506,278379,566885,99417,34362,133779,231642
"13586",2018-07-01,"sbct","transporte regular","voo internacional",77,77,154,3258,3213,6471,0,13100,13100,0
"13587",2018-07-01,"sbct","transporte não regular","voo doméstico",261,250,511,2031,2998,5029,0,61520,61520,10109
"13588",2018-07-01,"sbct","transporte não regular","voo internacional",22,21,43,264,201,465,0,0,0,0
"13589",2018-07-01,"sbcz","transporte regular","voo doméstico",31,31,62,2969,764,3733,0,0,0,0
"13590",2018-07-01,"sbcz","transporte regular","voo internacional",0,0,0,0,0,0,0,0,0,0
"13591",2018-07-01,"sbcz","transporte não regular","voo doméstico",230,229,459,1250,953,2203,0,0,0,0
"13592",2018-07-01,"sbcz","transporte não regular","voo internacional",0,0,0,0,0,0,0,0,0,0
"13593",2018-07-01,"sbeg","transporte regular","voo doméstico",1070,1048,2118,124054,122131,246185,97120,246055,343175,0
"13594",2018-07-01,"sbeg","transporte regular","voo internacional",107,109,216,5123,5955,11078,0,0,0,0
"13595",2018-07-01,"sbeg","transporte não regular","voo doméstico",520,533,1053,8862,7344,16206,0,9813,9813,0
"13596",2018-07-01,"sbeg","transporte não regular","voo internacional",65,73,138,294,177,471,0,0,0,0
"13597",2018-07-01,"sbfi","transporte regular","voo doméstico",614,668,1282,95644,86379,182023,0,0,0,0
"13598",2018-07-01,"sbfi","transporte regular","voo internacional",22,22,44,3009,2516,5525,0,0,0,0
"13599",2018-07-01,"sbfi","transporte não regular","voo doméstico",255,203,458,7710,14296,22006,0,0,0,0
"13600",2018-07-01,"sbfi","transporte não regular","voo internacional",44,44,88,74,86,160,0,0,0,0
"13601",2018-07-01,"sbgo","transporte regular","voo doméstico",1386,1386,2772,153782,148466,302248,186809,268841,455650,0
"13602",2018-07-01,"sbgo","transporte regular","voo internacional",0,0,0,0,0,0,0,0,0,0
"13603",2018-07-01,"sbgo","transporte não regular","voo doméstico",1724,1714,3438,6874,6282,13156,0,0,0,0
"13604",2018-07-01,"sbgo","transporte não regular","voo internacional",1,1,2,0,0,0,0,0,0,0
"13605",2018-07-01,"sbht","transporte regular","voo doméstico",101,101,202,4964,5165,10129,0,0,0,0
"13606",2018-07-01,"sbht","transporte regular","voo internacional",0,0,0,0,0,0,0,0,0,0
"13607",2018-07-01,"sbht","transporte não regular","voo doméstico",52,52,104,64,23,87,0,0,0,0
"13608",2018-07-01,"sbht","transporte não regular","voo internacional",0,0,0,0,0,0,0,0,0,0
"13609",2018-07-01,"sbiz","transporte regular","voo doméstico",114,114,228,13918,13827,27745,0,0,0,0
"13610",2018-07-01,"sbiz","transporte regular","voo internacional",0,0,0,0,0,0,0,0,0,0
"13611",2018-07-01,"sbiz","transporte não regular","voo doméstico",87,92,179,181,128,309,0,0,0,0
"13612",2018-07-01,"sbiz","transporte não regular","voo internacional",2,2,4,0,0,0,0,0,0,0
"13613",2018-07-01,"sbjc","transporte regular","voo doméstico",0,0,0,0,0,0,0,0,0,0
"13614",2018-07-01,"sbjc","transporte regular","voo internacional",0,0,0,0,0,0,0,0,0,0
"13615",2018-07-01,"sbjc","transporte não regular","voo doméstico",321,318,639,640,462,1102,0,0,0,0
"13616",2018-07-01,"sbjc","transporte não regular","voo internacional",0,0,0,0,0,0,0,0,0,0
"13617",2018-07-01,"sbjr","transporte regular","voo doméstico",0,0,0,0,0,0,0,0,0,0
"13618",2018-07-01,"sbjr","transporte regular","voo internacional",0,0,0,0,0,0,0,0,0,0
"13619",2018-07-01,"sbjr","transporte não regular","voo doméstico",2300,2285,4585,10304,5201,15505,0,0,0,0
"13620",2018-07-01,"sbjr","transporte não regular","voo internacional",0,0,0,0,0,0,0,0,0,0
"13621",2018-07-01,"sbjv","transporte regular","voo doméstico",211,209,420,22067,21173,43240,0,0,0,0
"13622",2018-07-01,"sbjv","transporte regular","voo internacional",0,0,0,0,0,0,0,0,0,0
"13623",2018-07-01,"sbjv","transporte não regular","voo doméstico",70,71,141,105,232,337,0,0,0,0
"13624",2018-07-01,"sbjv","transporte não regular","voo internacional",0,0,0,0,0,0,0,0,0,0
"13625",2018-07-01,"sblo","transporte regular","voo doméstico",430,430,860,45555,44295,89850,0,0,0,0
"13626",2018-07-01,"sblo","transporte regular","voo internacional",0,0,0,0,0,0,0,0,0,0
"13627",2018-07-01,"sblo","transporte não regular","voo doméstico",519,529,1048,431,511,942,0,0,0,0
"13628",2018-07-01,"sblo","transporte não regular","voo internacional",5,5,10,0,0,0,0,0,0,0
"13629",2018-07-01,"sbma","transporte regular","voo doméstico",136,137,273,13674,13129,26803,0,0,0,0
"13630",2018-07-01,"sbma","transporte regular","voo internacional",0,0,0,0,0,0,0,0,0,0
"13631",2018-07-01,"sbma","transporte não regular","voo doméstico",166,166,332,424,386,810,0,0,0,0
"13632",2018-07-01,"sbma","transporte não regular","voo internacional",0,0,0,0,0,0,0,0,0,0
"13633",2018-07-01,"sbmk","transporte regular","voo doméstico",141,141,282,10996,9649,20645,0,0,0,0
"13634",2018-07-01,"sbmk","transporte regular","voo internacional",0,0,0,0,0,0,0,0,0,0
"13635",2018-07-01,"sbmk","transporte não regular","voo doméstico",236,236,472,442,0,442,0,0,0,0
"13636",2018-07-01,"sbmk","transporte não regular","voo internacional",0,0,0,0,0,0,0,0,0,0
"13637",2018-07-01,"sbmq","transporte regular","voo doméstico",219,219,438,28949,25634,54583,13360,37950,51310,0
"13638",2018-07-01,"sbmq","transporte regular","voo internacional",0,1,1,0,0,0,0,0,0,0
"13639",2018-07-01,"sbmq","transporte não regular","voo doméstico",172,169,341,306,48,354,0,0,0,0
"13640",2018-07-01,"sbmq","transporte não regular","voo internacional",0,2,2,0,0,0,0,0,0,0
"13641",2018-07-01,"sbmt","transporte regular","voo doméstico",0,0,0,0,0,0,0,0,0,0
"13642",2018-07-01,"sbmt","transporte regular","voo internacional",0,0,0,0,0,0,0,0,0,0
"13643",2018-07-01,"sbmt","transporte não regular","voo doméstico",2911,2923,5834,4879,4927,9806,0,0,0,0
"13644",2018-07-01,"sbmt","transporte não regular","voo internacional",0,0,0,0,0,0,0,0,0,0
"13645",2018-07-01,"sbnf","transporte regular","voo doméstico",645,657,1302,83538,80477,164015,0,0,0,0
"13646",2018-07-01,"sbnf","transporte regular","voo internacional",18,20,38,1672,1901,3573,0,0,0,0
"13647",2018-07-01,"sbnf","transporte não regular","voo doméstico",264,246,510,3104,3533,6637,0,0,0,0
"13648",2018-07-01,"sbnf","transporte não regular","voo internacional",1,1,2,0,8,8,0,0,0,0
"13649",2018-07-01,"sbpb","transporte regular","voo doméstico",4,4,8,327,378,705,0,0,0,0
"13650",2018-07-01,"sbpb","transporte regular","voo internacional",0,0,0,0,0,0,0,0,0,0
"13651",2018-07-01,"sbpb","transporte não regular","voo doméstico",91,96,187,241,198,439,0,0,0,0
"13652",2018-07-01,"sbpb","transporte não regular","voo internacional",0,0,0,0,0,0,0,0,0,0
"13653",2018-07-01,"sbpj","transporte regular","voo doméstico",316,316,632,35141,34604,69745,0,0,0,0
"13654",2018-07-01,"sbpj","transporte regular","voo internacional",0,0,0,0,0,0,0,0,0,0
"13655",2018-07-01,"sbpj","transporte não regular","voo doméstico",311,305,616,900,731,1631,0,0,0,0
"13656",2018-07-01,"sbpj","transporte não regular","voo internacional",1,1,2,0,0,0,0,0,0,0
"13657",2018-07-01,"sbpk","transporte regular","voo doméstico",26,26,52,1361,1285,2646,0,0,0,0
"13658",2018-07-01,"sbpk","transporte regular","voo internacional",0,0,0,0,0,0,0,0,0,0
"13659",2018-07-01,"sbpk","transporte não regular","voo doméstico",47,44,91,112,123,235,0,0,0,0
"13660",2018-07-01,"sbpk","transporte não regular","voo internacional",3,5,8,4,4,8,0,0,0,0
"13661",2018-07-01,"sbpl","transporte regular","voo doméstico",175,175,350,23848,22944,46792,0,0,0,0
"13662",2018-07-01,"sbpl","transporte regular","voo internacional",2,2,4,0,0,0,0,0,0,0
"13663",2018-07-01,"sbpl","transporte não regular","voo doméstico",90,91,181,157,141,298,0,0,0,0
"13664",2018-07-01,"sbpl","transporte não regular","voo internacional",1,1,2,0,0,0,0,0,0,0
"13665",2018-07-01,"sbpp","transporte regular","voo doméstico",0,0,0,0,0,0,0,0,0,0
"13666",2018-07-01,"sbpp","transporte regular","voo internacional",0,0,0,0,0,0,0,0,0,0
"13667",2018-07-01,"sbpp","transporte não regular","voo doméstico",114,117,231,142,146,288,0,0,0,0
"13668",2018-07-01,"sbpp","transporte não regular","voo internacional",9,10,19,11,12,23,0,0,0,0
"13669",2018-07-01,"sbpr","transporte regular","voo doméstico",0,0,0,0,0,0,0,0,0,0
"13670",2018-07-01,"sbpr","transporte regular","voo internacional",0,4,4,0,0,0,0,0,0,0
"13671",2018-07-01,"sbpr","transporte não regular","voo doméstico",942,935,1877,1002,928,1930,0,0,0,0
"13672",2018-07-01,"sbpr","transporte não regular","voo internacional",0,0,0,0,0,0,0,0,0,0
"13673",2018-07-01,"sbpv","transporte regular","voo doméstico",394,396,790,40848,41126,81974,0,0,0,0
"13674",2018-07-01,"sbpv","transporte regular","voo internacional",0,0,0,0,0,0,0,0,0,0
"13675",2018-07-01,"sbpv","transporte não regular","voo doméstico",263,264,527,273,247,520,0,0,0,0
"13676",2018-07-01,"sbpv","transporte não regular","voo internacional",0,0,0,0,0,0,0,0,0,0
"13677",2018-07-01,"sbrb","transporte regular","voo doméstico",175,174,349,17489,12623,30112,0,0,0,0
"13678",2018-07-01,"sbrb","transporte regular","voo internacional",0,0,0,0,0,0,0,0,0,0
"13679",2018-07-01,"sbrb","transporte não regular","voo doméstico",144,144,288,407,367,774,0,0,0,0
"13680",2018-07-01,"sbrb","transporte não regular","voo internacional",3,4,7,0,0,0,0,0,0,0
"13681",2018-07-01,"sbrj","transporte regular","voo doméstico",3650,3658,7308,399410,384764,784174,0,0,0,0
"13682",2018-07-01,"sbrj","transporte regular","voo internacional",0,0,0,0,0,0,0,0,0,0
"13683",2018-07-01,"sbrj","transporte não regular","voo doméstico",500,490,990,5745,5837,11582,0,0,0,0
"13684",2018-07-01,"sbrj","transporte não regular","voo internacional",0,0,0,0,0,0,0,0,0,0
"13685",2018-07-01,"sbsj","transporte regular","voo doméstico",0,0,0,0,0,0,0,0,0,0
"13686",2018-07-01,"sbsj","transporte regular","voo internacional",0,0,0,0,0,0,0,0,0,0
"13687",2018-07-01,"sbsj","transporte não regular","voo doméstico",465,455,920,1435,1572,3007,0,0,0,0
"13688",2018-07-01,"sbsj","transporte não regular","voo internacional",2,9,11,24,11,35,0,0,0,0
"13689",2018-07-01,"sbsl","transporte regular","voo doméstico",614,640,1254,85594,82423,168017,0,0,0,0
"13690",2018-07-01,"sbsl","transporte regular","voo internacional",0,0,0,0,0,0,0,0,0,0
"13691",2018-07-01,"sbsl","transporte não regular","voo doméstico",255,225,480,1628,4327,5955,0,0,0,0
"13692",2018-07-01,"sbsl","transporte não regular","voo internacional",0,0,0,0,0,0,0,0,0,0
"13693",2018-07-01,"sbsn","transporte regular","voo doméstico",289,290,579,25034,21545,46579,0,0,0,0
"13694",2018-07-01,"sbsn","transporte regular","voo internacional",0,0,0,0,0,0,0,0,0,0
"13695",2018-07-01,"sbsn","transporte não regular","voo doméstico",201,204,405,590,522,1112,3730,6200,9930,0
"13696",2018-07-01,"sbsn","transporte não regular","voo internacional",4,4,8,0,0,0,0,0,0,0
"13697",2018-07-01,"sbsp","transporte regular","voo doméstico",7252,7309,14561,958160,966531,1924691,0,0,0,0
"13698",2018-07-01,"sbsp","transporte regular","voo internacional",0,0,0,0,0,0,0,0,0,0
"13699",2018-07-01,"sbsp","transporte não regular","voo doméstico",1884,1805,3689,39055,39031,78086,0,0,0,0
"13700",2018-07-01,"sbsp","transporte não regular","voo internacional",1,1,2,4,2,6,0,0,0,0
"13701",2018-07-01,"sbte","transporte regular","voo doméstico",372,371,743,53639,53400,107039,0,0,0,0
"13702",2018-07-01,"sbte","transporte regular","voo internacional",0,0,0,0,0,0,0,0,0,0
"13703",2018-07-01,"sbte","transporte não regular","voo doméstico",260,259,519,1427,1536,2963,0,0,0,0
"13704",2018-07-01,"sbte","transporte não regular","voo internacional",0,0,0,0,0,0,0,0,0,0
"13705",2018-07-01,"sbtf","transporte regular","voo doméstico",32,32,64,1266,1354,2620,0,0,0,0
"13706",2018-07-01,"sbtf","transporte regular","voo internacional",0,0,0,0,0,0,0,0,0,0
"13707",2018-07-01,"sbtf","transporte não regular","voo doméstico",101,101,202,138,91,229,661,143,804,200
"13708",2018-07-01,"sbtf","transporte não regular","voo internacional",0,0,0,0,0,0,0,0,0,0
"13709",2018-07-01,"sbtt","transporte regular","voo doméstico",31,31,62,2229,2695,4924,0,0,0,0
"13710",2018-07-01,"sbtt","transporte regular","voo internacional",0,0,0,0,0,0,0,0,0,0
"13711",2018-07-01,"sbtt","transporte não regular","voo doméstico",89,89,178,472,475,947,618,325,943,36
"13712",2018-07-01,"sbtt","transporte não regular","voo internacional",4,3,7,17,22,39,0,0,0,0
"13713",2018-07-01,"sbuf","transporte regular","voo doméstico",9,9,18,547,487,1034,0,0,0,0
"13714",2018-07-01,"sbuf","transporte regular","voo internacional",0,0,0,0,0,0,0,0,0,0
"13715",2018-07-01,"sbuf","transporte não regular","voo doméstico",24,25,49,95,75,170,0,0,0,0
"13716",2018-07-01,"sbuf","transporte não regular","voo internacional",0,0,0,0,0,0,0,0,0,0
"13717",2018-07-01,"sbug","transporte regular","voo doméstico",16,16,32,852,803,1655,0,0,0,0
"13718",2018-07-01,"sbug","transporte regular","voo internacional",0,0,0,0,0,0,0,0,0,0
"13719",2018-07-01,"sbug","transporte não regular","voo doméstico",4,4,8,10,11,21,0,0,0,0
"13720",2018-07-01,"sbug","transporte não regular","voo internacional",0,0,0,0,0,0,0,0,0,0
"13721",2018-07-01,"sbul","transporte regular","voo doméstico",541,543,1084,50452,47794,98246,0,0,0,0
"13722",2018-07-01,"sbul","transporte regular","voo internacional",0,0,0,0,0,0,0,0,0,0
"13723",2018-07-01,"sbul","transporte não regular","voo doméstico",649,647,1296,1426,1155,2581,0,0,0,0
"13724",2018-07-01,"sbul","transporte não regular","voo internacional",0,0,0,0,0,0,0,0,0,0
"13725",2018-07-01,"sbur","transporte regular","voo doméstico",61,61,122,3062,2952,6014,0,0,0,0
"13726",2018-07-01,"sbur","transporte regular","voo internacional",0,0,0,0,0,0,0,0,0,0
"13727",2018-07-01,"sbur","transporte não regular","voo doméstico",200,195,395,616,648,1264,0,0,0,0
"13728",2018-07-01,"sbur","transporte não regular","voo internacional",0,0,0,0,0,0,0,0,0,0
"13729",2018-06-01,"sbbe","transporte regular","voo doméstico",1124,1126,2250,135742,128880,264622,94552,304746,399298,0
"13730",2018-06-01,"sbbe","transporte regular","voo internacional",53,55,108,7714,7393,15107,75,1,76,0
"13731",2018-06-01,"sbbe","transporte não regular","voo doméstico",440,445,885,1674,1926,3600,0,0,0,0
"13732",2018-06-01,"sbbe","transporte não regular","voo internacional",9,8,17,114,122,236,0,0,0,0
"13733",2018-06-01,"sbbg","transporte regular","voo doméstico",0,0,0,0,0,0,0,0,0,0
"13734",2018-06-01,"sbbg","transporte regular","voo internacional",0,0,0,0,0,0,0,0,0,0
"13735",2018-06-01,"sbbg","transporte não regular","voo doméstico",15,16,31,105,85,190,0,0,0,0
"13736",2018-06-01,"sbbg","transporte não regular","voo internacional",0,0,0,0,0,0,0,0,0,0
"13737",2018-06-01,"sbbh","transporte regular","voo doméstico",21,21,42,574,604,1178,0,0,0,0
"13738",2018-06-01,"sbbh","transporte regular","voo internacional",0,0,0,0,0,0,0,0,0,0
"13739",2018-06-01,"sbbh","transporte não regular","voo doméstico",1639,1636,3275,7480,7592,15072,0,0,0,0
"13740",2018-06-01,"sbbh","transporte não regular","voo internacional",3,3,6,18,18,36,0,0,0,0
"13741",2018-06-01,"sbbi","transporte regular","voo doméstico",0,0,0,0,0,0,0,0,0,0
"13742",2018-06-01,"sbbi","transporte regular","voo internacional",0,0,0,0,0,0,0,0,0,0
"13743",2018-06-01,"sbbi","transporte não regular","voo doméstico",978,978,1956,701,605,1306,0,0,0,0
"13744",2018-06-01,"sbbi","transporte não regular","voo internacional",0,0,0,0,0,0,0,0,0,0
"13745",2018-06-01,"sbbv","transporte regular","voo doméstico",88,88,176,13518,10547,24065,0,0,0,0
"13746",2018-06-01,"sbbv","transporte regular","voo internacional",0,0,0,0,0,0,0,0,0,0
"13747",2018-06-01,"sbbv","transporte não regular","voo doméstico",103,108,211,83,15,98,0,0,0,0
"13748",2018-06-01,"sbbv","transporte não regular","voo internacional",21,15,36,4,0,4,0,0,0,0
"13749",2018-06-01,"sbcg","transporte regular","voo doméstico",523,526,1049,60611,58015,118626,0,0,0,0
"13750",2018-06-01,"sbcg","transporte regular","voo internacional",7,7,14,0,50,50,0,0,0,0
"13751",2018-06-01,"sbcg","transporte não regular","voo doméstico",254,256,510,463,656,1119,60925,79648,140573,0
"13752",2018-06-01,"sbcg","transporte não regular","voo internacional",8,7,15,0,4,4,0,0,0,0
"13753",2018-06-01,"sbcj","transporte regular","voo doméstico",70,70,140,4730,4378,9108,0,0,0,0
"13754",2018-06-01,"sbcj","transporte regular","voo internacional",0,0,0,0,0,0,0,0,0,0
"13755",2018-06-01,"sbcj","transporte não regular","voo doméstico",115,115,230,991,100,1091,0,0,0,0
"13756",2018-06-01,"sbcj","transporte não regular","voo internacional",0,0,0,0,0,0,0,0,0,0
"13757",2018-06-01,"sbcr","transporte regular","voo doméstico",17,16,33,1207,1256,2463,0,0,0,0
"13758",2018-06-01,"sbcr","transporte regular","voo internacional",0,0,0,0,0,0,0,0,0,0
"13759",2018-06-01,"sbcr","transporte não regular","voo doméstico",45,50,95,117,81,198,0,0,0,0
"13760",2018-06-01,"sbcr","transporte não regular","voo internacional",1,1,2,0,1,1,0,0,0,0
"13761",2018-06-01,"sbct","transporte regular","voo doméstico",2188,2194,4382,233476,231915,465391,114883,59179,174062,250614
"13762",2018-06-01,"sbct","transporte regular","voo internacional",73,73,146,2749,2711,5460,0,1720,1720,0
"13763",2018-06-01,"sbct","transporte não regular","voo doméstico",238,235,473,957,2201,3158,0,39177,39177,0
"13764",2018-06-01,"sbct","transporte não regular","voo internacional",13,11,24,172,159,331,0,0,0,0
"13765",2018-06-01,"sbcz","transporte regular","voo doméstico",29,29,58,2841,716,3557,0,0,0,0
"13766",2018-06-01,"sbcz","transporte regular","voo internacional",0,0,0,0,0,0,0,0,0,0
"13767",2018-06-01,"sbcz","transporte não regular","voo doméstico",189,186,375,756,735,1491,0,0,0,0
"13768",2018-06-01,"sbcz","transporte não regular","voo internacional",0,1,1,0,0,0,0,0,0,0
"13769",2018-06-01,"sbeg","transporte regular","voo doméstico",906,881,1787,106851,95975,202826,83288,274865,358153,0
"13770",2018-06-01,"sbeg","transporte regular","voo internacional",100,116,216,4796,5302,10098,0,1973,1973,0
"13771",2018-06-01,"sbeg","transporte não regular","voo doméstico",545,554,1099,7351,3401,10752,0,3835,3835,0
"13772",2018-06-01,"sbeg","transporte não regular","voo internacional",67,66,133,244,176,420,0,0,0,0
"13773",2018-06-01,"sbfi","transporte regular","voo doméstico",547,594,1141,75401,68765,144166,0,0,0,0
"13774",2018-06-01,"sbfi","transporte regular","voo internacional",22,22,44,2646,2285,4931,0,0,0,0
"13775",2018-06-01,"sbfi","transporte não regular","voo doméstico",195,150,345,1079,6323,7402,0,0,0,0
"13776",2018-06-01,"sbfi","transporte não regular","voo internacional",34,32,66,31,38,69,0,0,0,0
"13777",2018-06-01,"sbgo","transporte regular","voo doméstico",1326,1333,2659,129065,129959,259024,217405,288635,506040,0
"13778",2018-06-01,"sbgo","transporte regular","voo internacional",0,0,0,0,0,0,0,0,0,0
"13779",2018-06-01,"sbgo","transporte não regular","voo doméstico",1628,1598,3226,5464,4261,9725,0,0,0,0
"13780",2018-06-01,"sbgo","transporte não regular","voo internacional",1,1,2,0,0,0,0,0,0,0
"13781",2018-06-01,"sbht","transporte regular","voo doméstico",95,95,190,4110,4362,8472,0,0,0,0
"13782",2018-06-01,"sbht","transporte regular","voo internacional",0,0,0,0,0,0,0,0,0,0
"13783",2018-06-01,"sbht","transporte não regular","voo doméstico",45,45,90,140,44,184,0,0,0,0
"13784",2018-06-01,"sbht","transporte não regular","voo internacional",0,0,0,0,0,0,0,0,0,0
"13785",2018-06-01,"sbiz","transporte regular","voo doméstico",97,97,194,10882,10846,21728,0,0,0,0
"13786",2018-06-01,"sbiz","transporte regular","voo internacional",0,0,0,0,0,0,0,0,0,0
"13787",2018-06-01,"sbiz","transporte não regular","voo doméstico",90,84,174,251,161,412,0,0,0,0
"13788",2018-06-01,"sbiz","transporte não regular","voo internacional",0,0,0,0,0,0,0,0,0,0
"13789",2018-06-01,"sbjc","transporte regular","voo doméstico",0,0,0,0,0,0,0,0,0,0
"13790",2018-06-01,"sbjc","transporte regular","voo internacional",0,0,0,0,0,0,0,0,0,0
"13791",2018-06-01,"sbjc","transporte não regular","voo doméstico",258,259,517,434,316,750,0,0,0,0
"13792",2018-06-01,"sbjc","transporte não regular","voo internacional",0,0,0,0,0,0,0,0,0,0
"13793",2018-06-01,"sbjr","transporte regular","voo doméstico",0,0,0,0,0,0,0,0,0,0
"13794",2018-06-01,"sbjr","transporte regular","voo internacional",0,0,0,0,0,0,0,0,0,0
"13795",2018-06-01,"sbjr","transporte não regular","voo doméstico",2017,2040,4057,9300,4965,14265,0,0,0,0
"13796",2018-06-01,"sbjr","transporte não regular","voo internacional",0,0,0,0,0,0,0,0,0,0
"13797",2018-06-01,"sbjv","transporte regular","voo doméstico",192,191,383,17831,17610,35441,0,0,0,0
"13798",2018-06-01,"sbjv","transporte regular","voo internacional",0,0,0,0,0,0,0,0,0,0
"13799",2018-06-01,"sbjv","transporte não regular","voo doméstico",71,73,144,114,297,411,0,0,0,0
"13800",2018-06-01,"sbjv","transporte não regular","voo internacional",0,0,0,0,0,0,0,0,0,0
"13801",2018-06-01,"sblo","transporte regular","voo doméstico",410,413,823,39694,38642,78336,0,0,0,0
"13802",2018-06-01,"sblo","transporte regular","voo internacional",0,0,0,0,0,0,0,0,0,0
"13803",2018-06-01,"sblo","transporte não regular","voo doméstico",560,543,1103,202,423,625,0,0,0,0
"13804",2018-06-01,"sblo","transporte não regular","voo internacional",0,1,1,0,0,0,0,0,0,0
"13805",2018-06-01,"sbma","transporte regular","voo doméstico",123,122,245,11212,10676,21888,0,0,0,0
"13806",2018-06-01,"sbma","transporte regular","voo internacional",0,0,0,0,0,0,0,0,0,0
"13807",2018-06-01,"sbma","transporte não regular","voo doméstico",186,188,374,644,415,1059,0,0,0,0
"13808",2018-06-01,"sbma","transporte não regular","voo internacional",1,1,2,0,0,0,0,0,0,0
"13809",2018-06-01,"sbmk","transporte regular","voo doméstico",132,130,262,9722,9262,18984,0,0,0,0
"13810",2018-06-01,"sbmk","transporte regular","voo internacional",0,0,0,0,0,0,0,0,0,0
"13811",2018-06-01,"sbmk","transporte não regular","voo doméstico",194,190,384,248,5,253,0,0,0,0
"13812",2018-06-01,"sbmk","transporte não regular","voo internacional",0,0,0,0,0,0,0,0,0,0
"13813",2018-06-01,"sbmq","transporte regular","voo doméstico",186,195,381,23088,20792,43880,13300,28050,41350,0
"13814",2018-06-01,"sbmq","transporte regular","voo internacional",0,0,0,0,0,0,0,0,0,0
"13815",2018-06-01,"sbmq","transporte não regular","voo doméstico",170,162,332,230,225,455,0,0,0,0
"13816",2018-06-01,"sbmq","transporte não regular","voo internacional",3,4,7,0,0,0,0,0,0,0
"13817",2018-06-01,"sbmt","transporte regular","voo doméstico",0,0,0,0,0,0,0,0,0,0
"13818",2018-06-01,"sbmt","transporte regular","voo internacional",0,0,0,0,0,0,0,0,0,0
"13819",2018-06-01,"sbmt","transporte não regular","voo doméstico",2865,2836,5701,4712,4816,9528,0,0,0,0
"13820",2018-06-01,"sbmt","transporte não regular","voo internacional",0,0,0,0,0,0,0,0,0,0
"13821",2018-06-01,"sbnf","transporte regular","voo doméstico",603,624,1227,65072,67346,132418,0,0,0,0
"13822",2018-06-01,"sbnf","transporte regular","voo internacional",16,17,33,1550,1515,3065,0,0,0,0
"13823",2018-06-01,"sbnf","transporte não regular","voo doméstico",233,219,452,588,711,1299,0,0,0,0
"13824",2018-06-01,"sbnf","transporte não regular","voo internacional",2,1,3,4,13,17,0,0,0,0
"13825",2018-06-01,"sbpb","transporte regular","voo doméstico",5,5,10,335,403,738,0,0,0,0
"13826",2018-06-01,"sbpb","transporte regular","voo internacional",0,0,0,0,0,0,0,0,0,0
"13827",2018-06-01,"sbpb","transporte não regular","voo doméstico",60,59,119,157,144,301,0,0,0,0
"13828",2018-06-01,"sbpb","transporte não regular","voo internacional",0,0,0,0,0,0,0,0,0,0
"13829",2018-06-01,"sbpj","transporte regular","voo doméstico",290,289,579,28847,27242,56089,0,0,0,0
"13830",2018-06-01,"sbpj","transporte regular","voo internacional",0,0,0,0,0,0,0,0,0,0
"13831",2018-06-01,"sbpj","transporte não regular","voo doméstico",294,302,596,566,219,785,0,0,0,0
"13832",2018-06-01,"sbpj","transporte não regular","voo internacional",1,1,2,0,0,0,0,0,0,0
"13833",2018-06-01,"sbpk","transporte regular","voo doméstico",23,22,45,1020,999,2019,0,0,0,0
"13834",2018-06-01,"sbpk","transporte regular","voo internacional",0,0,0,0,0,0,0,0,0,0
"13835",2018-06-01,"sbpk","transporte não regular","voo doméstico",23,25,48,53,51,104,0,0,0,0
"13836",2018-06-01,"sbpk","transporte não regular","voo internacional",3,2,5,0,0,0,0,0,0,0
"13837",2018-06-01,"sbpl","transporte regular","voo doméstico",162,161,323,20377,22198,42575,0,0,0,0
"13838",2018-06-01,"sbpl","transporte regular","voo internacional",1,1,2,0,0,0,0,0,0,0
"13839",2018-06-01,"sbpl","transporte não regular","voo doméstico",107,107,214,238,256,494,0,0,0,0
"13840",2018-06-01,"sbpl","transporte não regular","voo internacional",0,0,0,0,0,0,0,0,0,0
"13841",2018-06-01,"sbpp","transporte regular","voo doméstico",0,0,0,0,0,0,0,0,0,0
"13842",2018-06-01,"sbpp","transporte regular","voo internacional",0,0,0,0,0,0,0,0,0,0
"13843",2018-06-01,"sbpp","transporte não regular","voo doméstico",64,68,132,78,82,160,0,0,0,0
"13844",2018-06-01,"sbpp","transporte não regular","voo internacional",6,4,10,6,5,11,0,0,0,0
"13845",2018-06-01,"sbpr","transporte regular","voo doméstico",1,1,2,1,1,2,0,0,0,0
"13846",2018-06-01,"sbpr","transporte regular","voo internacional",0,0,0,0,0,0,0,0,0,0
"13847",2018-06-01,"sbpr","transporte não regular","voo doméstico",914,915,1829,1023,937,1960,0,0,0,0
"13848",2018-06-01,"sbpr","transporte não regular","voo internacional",3,4,7,0,0,0,0,0,0,0
"13849",2018-06-01,"sbpv","transporte regular","voo doméstico",343,339,682,35039,34819,69858,0,0,0,0
"13850",2018-06-01,"sbpv","transporte regular","voo internacional",0,0,0,0,0,0,0,0,0,0
"13851",2018-06-01,"sbpv","transporte não regular","voo doméstico",274,277,551,219,55,274,0,0,0,0
"13852",2018-06-01,"sbpv","transporte não regular","voo internacional",3,3,6,1,0,1,0,0,0,0
"13853",2018-06-01,"sbrb","transporte regular","voo doméstico",146,147,293,14992,11887,26879,0,0,0,0
"13854",2018-06-01,"sbrb","transporte regular","voo internacional",0,0,0,0,0,0,0,0,0,0
"13855",2018-06-01,"sbrb","transporte não regular","voo doméstico",124,121,245,248,182,430,0,0,0,0
"13856",2018-06-01,"sbrb","transporte não regular","voo internacional",2,1,3,0,0,0,0,0,0,0
"13857",2018-06-01,"sbrj","transporte regular","voo doméstico",3483,3491,6974,353155,353350,706505,0,0,0,0
"13858",2018-06-01,"sbrj","transporte regular","voo internacional",0,0,0,0,0,0,0,0,0,0
"13859",2018-06-01,"sbrj","transporte não regular","voo doméstico",477,466,943,1008,1016,2024,0,0,0,0
"13860",2018-06-01,"sbrj","transporte não regular","voo internacional",0,0,0,0,0,0,0,0,0,0
"13861",2018-06-01,"sbsj","transporte regular","voo doméstico",0,0,0,0,0,0,0,0,0,0
"13862",2018-06-01,"sbsj","transporte regular","voo internacional",0,0,0,0,0,0,0,0,0,0
"13863",2018-06-01,"sbsj","transporte não regular","voo doméstico",429,420,849,1304,1317,2621,0,0,0,0
"13864",2018-06-01,"sbsj","transporte não regular","voo internacional",3,16,19,44,4,48,0,0,0,0
"13865",2018-06-01,"sbsl","transporte regular","voo doméstico",531,531,1062,63636,65497,129133,0,0,0,0
"13866",2018-06-01,"sbsl","transporte regular","voo internacional",0,0,0,0,0,0,0,0,0,0
"13867",2018-06-01,"sbsl","transporte não regular","voo doméstico",210,213,423,368,278,646,37614,42278,79892,0
"13868",2018-06-01,"sbsl","transporte não regular","voo internacional",0,0,0,0,0,0,0,0,0,0
"13869",2018-06-01,"sbsn","transporte regular","voo doméstico",248,246,494,18097,16045,34142,0,0,0,0
"13870",2018-06-01,"sbsn","transporte regular","voo internacional",0,0,0,0,0,0,0,0,0,0
"13871",2018-06-01,"sbsn","transporte não regular","voo doméstico",211,208,419,766,696,1462,5570,7200,12770,0
"13872",2018-06-01,"sbsn","transporte não regular","voo internacional",2,5,7,1,0,1,0,0,0,0
"13873",2018-06-01,"sbsp","transporte regular","voo doméstico",6976,7014,13990,856840,820773,1677613,0,0,0,0
"13874",2018-06-01,"sbsp","transporte regular","voo internacional",0,0,0,0,0,0,0,0,0,0
"13875",2018-06-01,"sbsp","transporte não regular","voo doméstico",1690,1644,3334,6326,5555,11881,0,0,0,0
"13876",2018-06-01,"sbsp","transporte não regular","voo internacional",2,4,6,9,4,13,0,0,0,0
"13877",2018-06-01,"sbte","transporte regular","voo doméstico",365,365,730,41590,43567,85157,96527,107268,203795,0
"13878",2018-06-01,"sbte","transporte regular","voo internacional",0,0,0,0,0,0,0,0,0,0
"13879",2018-06-01,"sbte","transporte não regular","voo doméstico",216,224,440,1105,1255,2360,0,0,0,0
"13880",2018-06-01,"sbte","transporte não regular","voo internacional",0,0,0,0,0,0,0,0,0,0
"13881",2018-06-01,"sbtf","transporte regular","voo doméstico",31,31,62,1193,1244,2437,0,0,0,0
"13882",2018-06-01,"sbtf","transporte regular","voo internacional",0,0,0,0,0,0,0,0,0,0
"13883",2018-06-01,"sbtf","transporte não regular","voo doméstico",90,90,180,129,99,228,477,205,682,1840
"13884",2018-06-01,"sbtf","transporte não regular","voo internacional",2,2,4,0,0,0,0,0,0,0
"13885",2018-06-01,"sbtt","transporte regular","voo doméstico",30,30,60,2103,2428,4531,0,0,0,0
"13886",2018-06-01,"sbtt","transporte regular","voo internacional",0,0,0,0,0,0,0,0,0,0
"13887",2018-06-01,"sbtt","transporte não regular","voo doméstico",77,76,153,338,365,703,775,1199,1974,288
"13888",2018-06-01,"sbtt","transporte não regular","voo internacional",1,1,2,6,4,10,0,0,0,0
"13889",2018-06-01,"sbuf","transporte regular","voo doméstico",8,8,16,478,500,978,0,0,0,0
"13890",2018-06-01,"sbuf","transporte regular","voo internacional",0,0,0,0,0,0,0,0,0,0
"13891",2018-06-01,"sbuf","transporte não regular","voo doméstico",16,15,31,45,41,86,0,0,0,0
"13892",2018-06-01,"sbuf","transporte não regular","voo internacional",0,0,0,0,0,0,0,0,0,0
"13893",2018-06-01,"sbug","transporte regular","voo doméstico",16,16,32,814,766,1580,0,0,0,0
"13894",2018-06-01,"sbug","transporte regular","voo internacional",0,0,0,0,0,0,0,0,0,0
"13895",2018-06-01,"sbug","transporte não regular","voo doméstico",6,6,12,22,17,39,0,0,0,0
"13896",2018-06-01,"sbug","transporte não regular","voo internacional",0,0,0,0,0,0,0,0,0,0
"13897",2018-06-01,"sbul","transporte regular","voo doméstico",532,531,1063,42489,42574,85063,0,0,0,0
"13898",2018-06-01,"sbul","transporte regular","voo internacional",0,0,0,0,0,0,0,0,0,0
"13899",2018-06-01,"sbul","transporte não regular","voo doméstico",515,512,1027,1271,992,2263,0,0,0,0
"13900",2018-06-01,"sbul","transporte não regular","voo internacional",0,0,0,0,0,0,0,0,0,0
"13901",2018-06-01,"sbur","transporte regular","voo doméstico",54,54,108,2601,2649,5250,0,0,0,0
"13902",2018-06-01,"sbur","transporte regular","voo internacional",0,0,0,0,0,0,0,0,0,0
"13903",2018-06-01,"sbur","transporte não regular","voo doméstico",206,212,418,702,653,1355,0,0,0,0
"13904",2018-06-01,"sbur","transporte não regular","voo internacional",0,0,0,0,0,0,0,0,0,0
"13905",2018-05-01,"sbbe","transporte regular","voo doméstico",1140,1141,2281,132226,124380,256606,117372,312494,429866,0
"13906",2018-05-01,"sbbe","transporte regular","voo internacional",49,48,97,7171,6673,13844,2,12,14,0
"13907",2018-05-01,"sbbe","transporte não regular","voo doméstico",447,444,891,879,1210,2089,0,0,0,0
"13908",2018-05-01,"sbbe","transporte não regular","voo internacional",14,20,34,22,60,82,0,4,4,0
"13909",2018-05-01,"sbbg","transporte regular","voo doméstico",0,0,0,0,0,0,0,0,0,0
"13910",2018-05-01,"sbbg","transporte regular","voo internacional",0,0,0,0,0,0,0,0,0,0
"13911",2018-05-01,"sbbg","transporte não regular","voo doméstico",13,14,27,42,55,97,0,0,0,0
"13912",2018-05-01,"sbbg","transporte não regular","voo internacional",1,0,1,0,0,0,0,0,0,0
"13913",2018-05-01,"sbbh","transporte regular","voo doméstico",60,60,120,1739,1795,3534,0,0,0,0
"13914",2018-05-01,"sbbh","transporte regular","voo internacional",0,0,0,0,0,0,0,0,0,0
"13915",2018-05-01,"sbbh","transporte não regular","voo doméstico",1699,1699,3398,7878,7970,15848,0,0,0,0
"13916",2018-05-01,"sbbh","transporte não regular","voo internacional",5,5,10,26,26,52,0,0,0,0
"13917",2018-05-01,"sbbi","transporte regular","voo doméstico",0,0,0,0,0,0,0,0,0,0
"13918",2018-05-01,"sbbi","transporte regular","voo internacional",0,0,0,0,0,0,0,0,0,0
"13919",2018-05-01,"sbbi","transporte não regular","voo doméstico",1367,1359,2726,814,631,1445,0,0,0,0
"13920",2018-05-01,"sbbi","transporte não regular","voo internacional",0,0,0,0,0,0,0,0,0,0
"13921",2018-05-01,"sbbv","transporte regular","voo doméstico",92,92,184,12638,8100,20738,0,0,0,0
"13922",2018-05-01,"sbbv","transporte regular","voo internacional",0,0,0,0,0,0,0,0,0,0
"13923",2018-05-01,"sbbv","transporte não regular","voo doméstico",103,101,204,179,48,227,0,0,0,0
"13924",2018-05-01,"sbbv","transporte não regular","voo internacional",14,16,30,2,5,7,0,0,0,0
"13925",2018-05-01,"sbcg","transporte regular","voo doméstico",566,565,1131,64311,61190,125501,0,0,0,0
"13926",2018-05-01,"sbcg","transporte regular","voo internacional",7,7,14,80,76,156,0,0,0,0
"13927",2018-05-01,"sbcg","transporte não regular","voo doméstico",256,257,513,320,247,567,61527,79069,140596,0
"13928",2018-05-01,"sbcg","transporte não regular","voo internacional",5,6,11,0,0,0,0,0,0,0
"13929",2018-05-01,"sbcj","transporte regular","voo doméstico",72,72,144,4623,5021,9644,0,0,0,0
"13930",2018-05-01,"sbcj","transporte regular","voo internacional",0,0,0,0,0,0,0,0,0,0
"13931",2018-05-01,"sbcj","transporte não regular","voo doméstico",90,90,180,775,110,885,0,0,0,0
"13932",2018-05-01,"sbcj","transporte não regular","voo internacional",0,0,0,0,0,0,0,0,0,0
"13933",2018-05-01,"sbcr","transporte regular","voo doméstico",16,16,32,1153,1109,2262,0,0,0,0
"13934",2018-05-01,"sbcr","transporte regular","voo internacional",0,0,0,0,0,0,0,0,0,0
"13935",2018-05-01,"sbcr","transporte não regular","voo doméstico",68,64,132,299,298,597,0,0,0,0
"13936",2018-05-01,"sbcr","transporte não regular","voo internacional",9,9,18,29,23,52,0,0,0,0
"13937",2018-05-01,"sbct","transporte regular","voo doméstico",2354,2362,4716,248038,236903,484941,143464,103443,246907,332505
"13938",2018-05-01,"sbct","transporte regular","voo internacional",80,80,160,2909,2620,5529,0,50514,50514,0
"13939",2018-05-01,"sbct","transporte não regular","voo doméstico",257,251,508,839,1242,2081,0,0,0,0
"13940",2018-05-01,"sbct","transporte não regular","voo internacional",13,11,24,84,151,235,0,0,0,0
"13941",2018-05-01,"sbcz","transporte regular","voo doméstico",30,30,60,2993,3017,6010,0,0,0,0
"13942",2018-05-01,"sbcz","transporte regular","voo internacional",0,0,0,0,0,0,0,0,0,0
"13943",2018-05-01,"sbcz","transporte não regular","voo doméstico",159,158,317,547,591,1138,0,0,0,0
"13944",2018-05-01,"sbcz","transporte não regular","voo internacional",0,0,0,0,0,0,0,0,0,0
"13945",2018-05-01,"sbeg","transporte regular","voo doméstico",888,876,1764,103846,91995,195841,0,275,275,0
"13946",2018-05-01,"sbeg","transporte regular","voo internacional",106,112,218,4904,5761,10665,0,0,0,0
"13947",2018-05-01,"sbeg","transporte não regular","voo doméstico",512,507,1019,5414,3047,8461,0,0,0,0
"13948",2018-05-01,"sbeg","transporte não regular","voo internacional",62,70,132,402,0,402,0,0,0,0
"13949",2018-05-01,"sbfi","transporte regular","voo doméstico",582,630,1212,81080,73708,154788,0,0,0,0
"13950",2018-05-01,"sbfi","transporte regular","voo internacional",144,143,287,16111,14680,30791,0,0,0,0
"13951",2018-05-01,"sbfi","transporte não regular","voo doméstico",205,156,361,1841,8485,10326,0,0,0,0
"13952",2018-05-01,"sbfi","transporte não regular","voo internacional",68,69,137,129,138,267,0,0,0,0
"13953",2018-05-01,"sbgo","transporte regular","voo doméstico",1325,1327,2652,129181,128710,257891,107805,174848,282653,110654
"13954",2018-05-01,"sbgo","transporte regular","voo internacional",0,0,0,0,0,0,0,0,0,0
"13955",2018-05-01,"sbgo","transporte não regular","voo doméstico",1594,1593,3187,4971,4434,9405,0,2563,2563,1592
"13956",2018-05-01,"sbgo","transporte não regular","voo internacional",0,0,0,0,0,0,0,0,0,0
"13957",2018-05-01,"sbht","transporte regular","voo doméstico",100,100,200,4545,4661,9206,0,0,0,0
"13958",2018-05-01,"sbht","transporte regular","voo internacional",0,0,0,0,0,0,0,0,0,0
"13959",2018-05-01,"sbht","transporte não regular","voo doméstico",61,59,120,79,62,141,0,0,0,0
"13960",2018-05-01,"sbht","transporte não regular","voo internacional",0,0,0,0,0,0,0,0,0,0
"13961",2018-05-01,"sbiz","transporte regular","voo doméstico",95,95,190,10883,9518,20401,0,0,0,0
"13962",2018-05-01,"sbiz","transporte regular","voo internacional",0,0,0,0,0,0,0,0,0,0
"13963",2018-05-01,"sbiz","transporte não regular","voo doméstico",106,112,218,195,165,360,0,0,0,0
"13964",2018-05-01,"sbiz","transporte não regular","voo internacional",0,0,0,0,0,0,0,0,0,0
"13965",2018-05-01,"sbjc","transporte regular","voo doméstico",0,0,0,0,0,0,0,0,0,0
"13966",2018-05-01,"sbjc","transporte regular","voo internacional",0,0,0,0,0,0,0,0,0,0
"13967",2018-05-01,"sbjc","transporte não regular","voo doméstico",324,327,651,635,426,1061,0,0,0,0
"13968",2018-05-01,"sbjc","transporte não regular","voo internacional",1,1,2,0,0,0,0,0,0,0
"13969",2018-05-01,"sbjr","transporte regular","voo doméstico",0,0,0,0,0,0,0,0,0,0
"13970",2018-05-01,"sbjr","transporte regular","voo internacional",0,0,0,0,0,0,0,0,0,0
"13971",2018-05-01,"sbjr","transporte não regular","voo doméstico",2629,2616,5245,11162,6167,17329,0,0,0,0
"13972",2018-05-01,"sbjr","transporte não regular","voo internacional",2,2,4,3,0,3,0,0,0,0
"13973",2018-05-01,"sbjv","transporte regular","voo doméstico",206,207,413,21213,18661,39874,0,63,63,0
"13974",2018-05-01,"sbjv","transporte regular","voo internacional",0,0,0,0,0,0,0,0,0,0
"13975",2018-05-01,"sbjv","transporte não regular","voo doméstico",103,100,203,371,336,707,0,0,0,0
"13976",2018-05-01,"sbjv","transporte não regular","voo internacional",0,0,0,0,0,0,0,0,0,0
"13977",2018-05-01,"sblo","transporte regular","voo doméstico",439,439,878,42116,40595,82711,0,0,0,0
"13978",2018-05-01,"sblo","transporte regular","voo internacional",0,0,0,0,0,0,0,0,0,0
"13979",2018-05-01,"sblo","transporte não regular","voo doméstico",579,582,1161,380,110,490,0,0,0,0
"13980",2018-05-01,"sblo","transporte não regular","voo internacional",3,2,5,0,0,0,0,0,0,0
"13981",2018-05-01,"sbma","transporte regular","voo doméstico",123,123,246,11220,10623,21843,0,0,0,0
"13982",2018-05-01,"sbma","transporte regular","voo internacional",0,0,0,0,0,0,0,0,0,0
"13983",2018-05-01,"sbma","transporte não regular","voo doméstico",207,207,414,514,486,1000,0,0,0,0
"13984",2018-05-01,"sbma","transporte não regular","voo internacional",0,0,0,0,0,0,0,0,0,0
"13985",2018-05-01,"sbmk","transporte regular","voo doméstico",134,135,269,9849,9625,19474,0,0,0,0
"13986",2018-05-01,"sbmk","transporte regular","voo internacional",0,0,0,0,0,0,0,0,0,0
"13987",2018-05-01,"sbmk","transporte não regular","voo doméstico",200,205,405,288,9,297,0,0,0,0
"13988",2018-05-01,"sbmk","transporte não regular","voo internacional",1,1,2,9,0,9,0,0,0,0
"13989",2018-05-01,"sbmq","transporte regular","voo doméstico",213,211,424,23191,19109,42300,10940,32029,42969,0
"13990",2018-05-01,"sbmq","transporte regular","voo internacional",0,0,0,0,0,0,0,0,0,0
"13991",2018-05-01,"sbmq","transporte não regular","voo doméstico",189,190,379,602,29,631,0,0,0,0
"13992",2018-05-01,"sbmq","transporte não regular","voo internacional",6,4,10,0,0,0,0,0,0,0
"13993",2018-05-01,"sbmt","transporte regular","voo doméstico",0,0,0,0,0,0,0,0,0,0
"13994",2018-05-01,"sbmt","transporte regular","voo internacional",0,0,0,0,0,0,0,0,0,0
"13995",2018-05-01,"sbmt","transporte não regular","voo doméstico",3536,3528,7064,5683,5851,11534,0,0,0,0
"13996",2018-05-01,"sbmt","transporte não regular","voo internacional",0,0,0,0,0,0,0,0,0,0
"13997",2018-05-01,"sbnf","transporte regular","voo doméstico",636,635,1271,72153,68747,140900,0,0,0,0
"13998",2018-05-01,"sbnf","transporte regular","voo internacional",17,17,34,1819,1687,3506,0,0,0,0
"13999",2018-05-01,"sbnf","transporte não regular","voo doméstico",293,292,585,953,859,1812,0,0,0,0
"14000",2018-05-01,"sbnf","transporte não regular","voo internacional",1,3,4,2,0,2,0,0,0,0
"14001",2018-05-01,"sbpb","transporte regular","voo doméstico",4,4,8,274,285,559,0,0,0,0
"14002",2018-05-01,"sbpb","transporte regular","voo internacional",0,0,0,0,0,0,0,0,0,0
"14003",2018-05-01,"sbpb","transporte não regular","voo doméstico",42,41,83,121,137,258,0,0,0,0
"14004",2018-05-01,"sbpb","transporte não regular","voo internacional",0,0,0,0,0,0,0,0,0,0
"14005",2018-05-01,"sbpj","transporte regular","voo doméstico",297,297,594,27985,27114,55099,0,0,0,0
"14006",2018-05-01,"sbpj","transporte regular","voo internacional",0,0,0,0,0,0,0,0,0,0
"14007",2018-05-01,"sbpj","transporte não regular","voo doméstico",332,328,660,714,298,1012,0,0,0,0
"14008",2018-05-01,"sbpj","transporte não regular","voo internacional",0,0,0,0,0,0,0,0,0,0
"14009",2018-05-01,"sbpk","transporte regular","voo doméstico",27,27,54,1267,1257,2524,0,0,0,0
"14010",2018-05-01,"sbpk","transporte regular","voo internacional",0,0,0,0,0,0,0,0,0,0
"14011",2018-05-01,"sbpk","transporte não regular","voo doméstico",43,42,85,67,81,148,0,0,0,0
"14012",2018-05-01,"sbpk","transporte não regular","voo internacional",2,4,6,6,4,10,0,0,0,0
"14013",2018-05-01,"sbpl","transporte regular","voo doméstico",168,167,335,20337,20687,41024,0,0,0,0
"14014",2018-05-01,"sbpl","transporte regular","voo internacional",3,3,6,0,0,0,0,0,0,0
"14015",2018-05-01,"sbpl","transporte não regular","voo doméstico",67,67,134,128,81,209,0,0,0,0
"14016",2018-05-01,"sbpl","transporte não regular","voo internacional",1,1,2,0,0,0,0,0,0,0
"14017",2018-05-01,"sbpp","transporte regular","voo doméstico",0,0,0,0,0,0,0,0,0,0
"14018",2018-05-01,"sbpp","transporte regular","voo internacional",0,0,0,0,0,0,0,0,0,0
"14019",2018-05-01,"sbpp","transporte não regular","voo doméstico",116,113,229,153,142,295,0,0,0,0
"14020",2018-05-01,"sbpp","transporte não regular","voo internacional",10,10,20,13,18,31,0,0,0,0
"14021",2018-05-01,"sbpr","transporte regular","voo doméstico",0,0,0,0,0,0,0,0,0,0
"14022",2018-05-01,"sbpr","transporte regular","voo internacional",0,0,0,0,0,0,0,0,0,0
"14023",2018-05-01,"sbpr","transporte não regular","voo doméstico",876,877,1753,1027,956,1983,0,0,0,0
"14024",2018-05-01,"sbpr","transporte não regular","voo internacional",6,5,11,0,0,0,0,0,0,0
"14025",2018-05-01,"sbpv","transporte regular","voo doméstico",334,333,667,35577,35212,70789,0,0,0,0
"14026",2018-05-01,"sbpv","transporte regular","voo internacional",0,0,0,0,0,0,0,0,0,0
"14027",2018-05-01,"sbpv","transporte não regular","voo doméstico",316,312,628,425,115,540,0,0,0,0
"14028",2018-05-01,"sbpv","transporte não regular","voo internacional",1,1,2,0,0,0,0,0,0,0
"14029",2018-05-01,"sbrb","transporte regular","voo doméstico",154,153,307,10834,7823,18657,33333,0,33333,0
"14030",2018-05-01,"sbrb","transporte regular","voo internacional",0,0,0,0,0,0,0,0,0,0
"14031",2018-05-01,"sbrb","transporte não regular","voo doméstico",108,109,217,443,526,969,0,0,0,0
"14032",2018-05-01,"sbrb","transporte não regular","voo internacional",0,0,0,0,0,0,0,0,0,0
"14033",2018-05-01,"sbrj","transporte regular","voo doméstico",3835,3835,7670,382418,381905,764323,0,312,312,0
"14034",2018-05-01,"sbrj","transporte regular","voo internacional",0,0,0,0,0,0,0,0,0,0
"14035",2018-05-01,"sbrj","transporte não regular","voo doméstico",586,587,1173,1398,177,1575,0,0,0,0
"14036",2018-05-01,"sbrj","transporte não regular","voo internacional",0,0,0,0,0,0,0,0,0,0
"14037",2018-05-01,"sbsj","transporte regular","voo doméstico",0,0,0,0,0,0,0,0,0,0
"14038",2018-05-01,"sbsj","transporte regular","voo internacional",0,0,0,0,0,0,0,0,0,0
"14039",2018-05-01,"sbsj","transporte não regular","voo doméstico",420,415,835,1553,1556,3109,0,0,0,0
"14040",2018-05-01,"sbsj","transporte não regular","voo internacional",2,10,12,24,9,33,0,0,0,0
"14041",2018-05-01,"sbsl","transporte regular","voo doméstico",502,501,1003,58150,53213,111363,2631,9602,12233,0
"14042",2018-05-01,"sbsl","transporte regular","voo internacional",0,0,0,0,0,0,0,0,0,0
"14043",2018-05-01,"sbsl","transporte não regular","voo doméstico",203,207,410,607,524,1131,47399,147309,194708,0
"14044",2018-05-01,"sbsl","transporte não regular","voo internacional",2,0,2,0,0,0,0,0,0,0
"14045",2018-05-01,"sbsn","transporte regular","voo doméstico",244,246,490,17214,16709,33923,0,0,0,0
"14046",2018-05-01,"sbsn","transporte regular","voo internacional",0,0,0,0,0,0,0,0,0,0
"14047",2018-05-01,"sbsn","transporte não regular","voo doméstico",225,222,447,992,1037,2029,12110,15510,27620,0
"14048",2018-05-01,"sbsn","transporte não regular","voo internacional",0,0,0,0,0,0,0,0,0,0
"14049",2018-05-01,"sbsp","transporte regular","voo doméstico",7459,7490,14949,874842,867215,1742057,0,0,0,0
"14050",2018-05-01,"sbsp","transporte regular","voo internacional",0,0,0,0,0,0,0,0,0,0
"14051",2018-05-01,"sbsp","transporte não regular","voo doméstico",2193,2162,4355,7437,5985,13422,0,0,0,0
"14052",2018-05-01,"sbsp","transporte não regular","voo internacional",11,8,19,16,22,38,0,0,0,0
"14053",2018-05-01,"sbte","transporte regular","voo doméstico",380,377,757,38655,38702,77357,26936,82709,109645,178812
"14054",2018-05-01,"sbte","transporte regular","voo internacional",0,0,0,0,0,0,0,0,0,0
"14055",2018-05-01,"sbte","transporte não regular","voo doméstico",222,221,443,1242,1145,2387,0,0,0,0
"14056",2018-05-01,"sbte","transporte não regular","voo internacional",0,0,0,0,0,0,0,0,0,0
"14057",2018-05-01,"sbtf","transporte regular","voo doméstico",31,31,62,1237,1279,2516,0,0,0,0
"14058",2018-05-01,"sbtf","transporte regular","voo internacional",0,0,0,0,0,0,0,0,0,0
"14059",2018-05-01,"sbtf","transporte não regular","voo doméstico",92,93,185,158,127,285,668,315,983,560
"14060",2018-05-01,"sbtf","transporte não regular","voo internacional",0,0,0,0,0,0,0,0,0,0
"14061",2018-05-01,"sbtt","transporte regular","voo doméstico",30,30,60,1972,2178,4150,0,0,0,0
"14062",2018-05-01,"sbtt","transporte regular","voo internacional",0,0,0,0,0,0,0,0,0,0
"14063",2018-05-01,"sbtt","transporte não regular","voo doméstico",74,75,149,325,322,647,1092,1092,2184,56
"14064",2018-05-01,"sbtt","transporte não regular","voo internacional",1,2,3,6,2,8,0,0,0,0
"14065",2018-05-01,"sbuf","transporte regular","voo doméstico",7,7,14,451,410,861,0,0,0,0
"14066",2018-05-01,"sbuf","transporte regular","voo internacional",0,0,0,0,0,0,0,0,0,0
"14067",2018-05-01,"sbuf","transporte não regular","voo doméstico",28,27,55,124,143,267,0,0,0,0
"14068",2018-05-01,"sbuf","transporte não regular","voo internacional",0,0,0,0,0,0,0,0,0,0
"14069",2018-05-01,"sbug","transporte regular","voo doméstico",17,17,34,897,834,1731,0,0,0,0
"14070",2018-05-01,"sbug","transporte regular","voo internacional",0,0,0,0,0,0,0,0,0,0
"14071",2018-05-01,"sbug","transporte não regular","voo doméstico",5,5,10,7,10,17,0,0,0,0
"14072",2018-05-01,"sbug","transporte não regular","voo internacional",0,0,0,0,0,0,0,0,0,0
"14073",2018-05-01,"sbul","transporte regular","voo doméstico",514,517,1031,45378,44332,89710,59,0,59,0
"14074",2018-05-01,"sbul","transporte regular","voo internacional",0,0,0,0,0,0,0,0,0,0
"14075",2018-05-01,"sbul","transporte não regular","voo doméstico",528,532,1060,1326,1210,2536,0,0,0,0
"14076",2018-05-01,"sbul","transporte não regular","voo internacional",4,4,8,16,16,32,0,0,0,0
"14077",2018-05-01,"sbur","transporte regular","voo doméstico",54,53,107,2728,2534,5262,0,0,0,0
"14078",2018-05-01,"sbur","transporte regular","voo internacional",0,0,0,0,0,0,0,0,0,0
"14079",2018-05-01,"sbur","transporte não regular","voo doméstico",224,244,468,882,737,1619,0,0,0,0
"14080",2018-05-01,"sbur","transporte não regular","voo internacional",1,1,2,0,0,0,0,0,0,0
"14081",2018-03-01,"sbbe","transporte regular","voo doméstico",1042,1045,2087,120734,116890,237624,47115,177991,225106,0
"14082",2018-03-01,"sbbe","transporte regular","voo internacional",56,57,113,6799,6114,12913,2,9,11,6
"14083",2018-03-01,"sbbe","transporte não regular","voo doméstico",442,437,879,2939,3854,6793,0,0,0,0
"14084",2018-03-01,"sbbe","transporte não regular","voo internacional",4,6,10,1,4,5,0,0,0,0
"14085",2018-03-01,"sbbg","transporte regular","voo doméstico",0,0,0,0,0,0,0,0,0,0
"14086",2018-03-01,"sbbg","transporte regular","voo internacional",0,0,0,0,0,0,0,0,0,0
"14087",2018-03-01,"sbbg","transporte não regular","voo doméstico",24,21,45,95,109,204,0,0,0,0
"14088",2018-03-01,"sbbg","transporte não regular","voo internacional",4,5,9,22,19,41,0,0,0,0
"14089",2018-03-01,"sbbh","transporte regular","voo doméstico",91,91,182,2781,2702,5483,0,0,0,0
"14090",2018-03-01,"sbbh","transporte regular","voo internacional",0,0,0,0,0,0,0,0,0,0
"14091",2018-03-01,"sbbh","transporte não regular","voo doméstico",1571,1592,3163,7325,7342,14667,0,0,0,0
"14092",2018-03-01,"sbbh","transporte não regular","voo internacional",9,9,18,44,44,88,0,0,0,0
"14093",2018-03-01,"sbbi","transporte regular","voo doméstico",0,0,0,0,0,0,0,0,0,0
"14094",2018-03-01,"sbbi","transporte regular","voo internacional",0,0,0,0,0,0,0,0,0,0
"14095",2018-03-01,"sbbi","transporte não regular","voo doméstico",1289,1285,2574,4571,4542,9113,0,0,0,0
"14096",2018-03-01,"sbbi","transporte não regular","voo internacional",3,3,6,0,0,0,0,0,0,0
"14097",2018-03-01,"sbbv","transporte regular","voo doméstico",100,100,200,12978,11108,24086,0,0,0,0
"14098",2018-03-01,"sbbv","transporte regular","voo internacional",0,0,0,0,0,0,0,0,0,0
"14099",2018-03-01,"sbbv","transporte não regular","voo doméstico",133,138,271,273,116,389,0,0,0,0
"14100",2018-03-01,"sbbv","transporte não regular","voo internacional",14,10,24,3,8,11,0,0,0,0
"14101",2018-03-01,"sbcg","transporte regular","voo doméstico",550,553,1103,62537,63885,126422,2846,0,2846,0
"14102",2018-03-01,"sbcg","transporte regular","voo internacional",10,10,20,86,93,179,0,0,0,0
"14103",2018-03-01,"sbcg","transporte não regular","voo doméstico",254,253,507,474,317,791,67912,88694,156606,0
"14104",2018-03-01,"sbcg","transporte não regular","voo internacional",15,12,27,3,10,13,0,0,0,0
"14105",2018-03-01,"sbcj","transporte regular","voo doméstico",78,78,156,4610,4060,8670,0,0,0,0
"14106",2018-03-01,"sbcj","transporte regular","voo internacional",0,0,0,0,0,0,0,0,0,0
"14107",2018-03-01,"sbcj","transporte não regular","voo doméstico",76,76,152,401,198,599,0,0,0,0
"14108",2018-03-01,"sbcj","transporte não regular","voo internacional",0,0,0,0,0,0,0,0,0,0
"14109",2018-03-01,"sbcr","transporte regular","voo doméstico",17,17,34,1079,1212,2291,0,0,0,0
"14110",2018-03-01,"sbcr","transporte regular","voo internacional",0,0,0,0,0,0,0,0,0,0
"14111",2018-03-01,"sbcr","transporte não regular","voo doméstico",53,53,106,162,118,280,0,0,0,0
"14112",2018-03-01,"sbcr","transporte não regular","voo internacional",0,0,0,0,0,0,0,0,0,0
"14113",2018-03-01,"sbct","transporte regular","voo doméstico",2351,2353,4704,254383,256784,511167,143274,31803,175077,323819
"14114",2018-03-01,"sbct","transporte regular","voo internacional",80,80,160,3740,3468,7208,0,40549,40549,0
"14115",2018-03-01,"sbct","transporte não regular","voo doméstico",327,322,649,3828,3431,7259,0,0,0,0
"14116",2018-03-01,"sbct","transporte não regular","voo internacional",18,24,42,110,58,168,0,0,0,0
"14117",2018-03-01,"sbcz","transporte regular","voo doméstico",42,43,85,3158,3159,6317,0,0,0,0
"14118",2018-03-01,"sbcz","transporte regular","voo internacional",0,0,0,0,0,0,0,0,0,0
"14119",2018-03-01,"sbcz","transporte não regular","voo doméstico",136,135,271,444,447,891,0,0,0,0
"14120",2018-03-01,"sbcz","transporte não regular","voo internacional",0,0,0,0,0,0,0,0,0,0
"14121",2018-03-01,"sbeg","transporte regular","voo doméstico",829,826,1655,98132,92787,190919,0,0,0,0
"14122",2018-03-01,"sbeg","transporte regular","voo internacional",105,113,218,5052,5205,10257,0,0,0,0
"14123",2018-03-01,"sbeg","transporte não regular","voo doméstico",509,494,1003,6261,5771,12032,0,0,0,0
"14124",2018-03-01,"sbeg","transporte não regular","voo internacional",66,71,137,179,91,270,0,0,0,0
"14125",2018-03-01,"sbfi","transporte regular","voo doméstico",589,637,1226,88415,83839,172254,0,0,0,0
"14126",2018-03-01,"sbfi","transporte regular","voo internacional",23,23,46,3100,2683,5783,0,0,0,0
"14127",2018-03-01,"sbfi","transporte não regular","voo doméstico",199,150,349,1649,8113,9762,0,0,0,0
"14128",2018-03-01,"sbfi","transporte não regular","voo internacional",58,60,118,105,126,231,0,0,0,0
"14129",2018-03-01,"sbgo","transporte regular","voo doméstico",1282,1281,2563,129658,127451,257109,107964,166784,274748,121016
"14130",2018-03-01,"sbgo","transporte regular","voo internacional",0,0,0,0,0,0,0,0,0,0
"14131",2018-03-01,"sbgo","transporte não regular","voo doméstico",1578,1616,3194,7430,6595,14025,0,0,0,0
"14132",2018-03-01,"sbgo","transporte não regular","voo internacional",3,3,6,0,0,0,0,0,0,0
"14133",2018-03-01,"sbht","transporte regular","voo doméstico",95,95,190,4044,3967,8011,0,0,0,0
"14134",2018-03-01,"sbht","transporte regular","voo internacional",0,0,0,0,0,0,0,0,0,0
"14135",2018-03-01,"sbht","transporte não regular","voo doméstico",47,48,95,157,31,188,0,0,0,0
"14136",2018-03-01,"sbht","transporte não regular","voo internacional",0,0,0,0,0,0,0,0,0,0
"14137",2018-03-01,"sbiz","transporte regular","voo doméstico",103,103,206,11434,10851,22285,0,0,0,0
"14138",2018-03-01,"sbiz","transporte regular","voo internacional",0,0,0,0,0,0,0,0,0,0
"14139",2018-03-01,"sbiz","transporte não regular","voo doméstico",126,126,252,333,271,604,0,0,0,0
"14140",2018-03-01,"sbiz","transporte não regular","voo internacional",0,0,0,0,0,0,0,0,0,0
"14141",2018-03-01,"sbjc","transporte regular","voo doméstico",0,0,0,0,0,0,0,0,0,0
"14142",2018-03-01,"sbjc","transporte regular","voo internacional",0,0,0,0,0,0,0,0,0,0
"14143",2018-03-01,"sbjc","transporte não regular","voo doméstico",278,278,556,497,283,780,0,0,0,0
"14144",2018-03-01,"sbjc","transporte não regular","voo internacional",0,0,0,0,0,0,0,0,0,0
"14145",2018-03-01,"sbjr","transporte regular","voo doméstico",0,0,0,0,0,0,0,0,0,0
"14146",2018-03-01,"sbjr","transporte regular","voo internacional",0,0,0,0,0,0,0,0,0,0
"14147",2018-03-01,"sbjr","transporte não regular","voo doméstico",2695,2705,5400,11658,6201,17859,0,0,0,0
"14148",2018-03-01,"sbjr","transporte não regular","voo internacional",2,2,4,3,0,3,0,0,0,0
"14149",2018-03-01,"sbjv","transporte regular","voo doméstico",216,216,432,19835,20208,40043,0,0,0,0
"14150",2018-03-01,"sbjv","transporte regular","voo internacional",0,0,0,0,0,0,0,0,0,0
"14151",2018-03-01,"sbjv","transporte não regular","voo doméstico",85,88,173,151,115,266,0,0,0,0
"14152",2018-03-01,"sbjv","transporte não regular","voo internacional",0,0,0,0,0,0,0,0,0,0
"14153",2018-03-01,"sblo","transporte regular","voo doméstico",402,400,802,37522,38296,75818,0,0,0,0
"14154",2018-03-01,"sblo","transporte regular","voo internacional",0,0,0,0,0,0,0,0,0,0
"14155",2018-03-01,"sblo","transporte não regular","voo doméstico",625,638,1263,194,318,512,0,0,0,0
"14156",2018-03-01,"sblo","transporte não regular","voo internacional",4,4,8,0,0,0,0,0,0,0
"14157",2018-03-01,"sbma","transporte regular","voo doméstico",128,128,256,11173,10300,21473,0,0,0,0
"14158",2018-03-01,"sbma","transporte regular","voo internacional",0,0,0,0,0,0,0,0,0,0
"14159",2018-03-01,"sbma","transporte não regular","voo doméstico",133,133,266,417,438,855,0,0,0,0
"14160",2018-03-01,"sbma","transporte não regular","voo internacional",0,0,0,0,0,0,0,0,0,0
"14161",2018-03-01,"sbmk","transporte regular","voo doméstico",127,128,255,9302,8999,18301,0,0,0,0
"14162",2018-03-01,"sbmk","transporte regular","voo internacional",0,0,0,0,0,0,0,0,0,0
"14163",2018-03-01,"sbmk","transporte não regular","voo doméstico",209,211,420,551,188,739,0,0,0,0
"14164",2018-03-01,"sbmk","transporte não regular","voo internacional",0,0,0,0,0,0,0,0,0,0
"14165",2018-03-01,"sbmq","transporte regular","voo doméstico",199,196,395,21771,20870,42641,14800,38878,53678,0
"14166",2018-03-01,"sbmq","transporte regular","voo internacional",0,1,1,0,0,0,0,0,0,0
"14167",2018-03-01,"sbmq","transporte não regular","voo doméstico",145,146,291,489,108,597,0,0,0,0
"14168",2018-03-01,"sbmq","transporte não regular","voo internacional",1,3,4,0,0,0,0,0,0,0
"14169",2018-03-01,"sbmt","transporte regular","voo doméstico",0,0,0,0,0,0,0,0,0,0
"14170",2018-03-01,"sbmt","transporte regular","voo internacional",0,0,0,0,0,0,0,0,0,0
"14171",2018-03-01,"sbmt","transporte não regular","voo doméstico",3475,3488,6963,5665,5639,11304,0,0,0,0
"14172",2018-03-01,"sbmt","transporte não regular","voo internacional",0,0,0,0,0,0,0,0,0,0
"14173",2018-03-01,"sbnf","transporte regular","voo doméstico",663,663,1326,74502,76971,151473,0,1021,1021,0
"14174",2018-03-01,"sbnf","transporte regular","voo internacional",18,18,36,2021,1910,3931,0,0,0,0
"14175",2018-03-01,"sbnf","transporte não regular","voo doméstico",282,272,554,986,680,1666,0,0,0,0
"14176",2018-03-01,"sbnf","transporte não regular","voo internacional",6,4,10,71,199,270,0,0,0,0
"14177",2018-03-01,"sbpb","transporte regular","voo doméstico",5,5,10,209,388,597,0,0,0,0
"14178",2018-03-01,"sbpb","transporte regular","voo internacional",0,0,0,0,0,0,0,0,0,0
"14179",2018-03-01,"sbpb","transporte não regular","voo doméstico",47,44,91,120,118,238,0,0,0,0
"14180",2018-03-01,"sbpb","transporte não regular","voo internacional",0,0,0,0,0,0,0,0,0,0
"14181",2018-03-01,"sbpj","transporte regular","voo doméstico",296,299,595,28102,26848,54950,0,0,0,0
"14182",2018-03-01,"sbpj","transporte regular","voo internacional",0,0,0,0,0,0,0,0,0,0
"14183",2018-03-01,"sbpj","transporte não regular","voo doméstico",216,210,426,351,181,532,0,0,0,0
"14184",2018-03-01,"sbpj","transporte não regular","voo internacional",0,0,0,0,0,0,0,0,0,0
"14185",2018-03-01,"sbpk","transporte regular","voo doméstico",25,25,50,1130,1295,2425,0,0,0,0
"14186",2018-03-01,"sbpk","transporte regular","voo internacional",0,0,0,0,0,0,0,0,0,0
"14187",2018-03-01,"sbpk","transporte não regular","voo doméstico",38,37,75,97,100,197,0,0,0,0
"14188",2018-03-01,"sbpk","transporte não regular","voo internacional",4,3,7,0,7,7,0,0,0,0
"14189",2018-03-01,"sbpl","transporte regular","voo doméstico",142,145,287,17859,18045,35904,0,0,0,0
"14190",2018-03-01,"sbpl","transporte regular","voo internacional",4,4,8,0,0,0,0,0,0,0
"14191",2018-03-01,"sbpl","transporte não regular","voo doméstico",99,96,195,1736,1176,2912,0,0,0,0
"14192",2018-03-01,"sbpl","transporte não regular","voo internacional",0,0,0,0,0,0,0,0,0,0
"14193",2018-03-01,"sbpp","transporte regular","voo doméstico",0,0,0,0,0,0,0,0,0,0
"14194",2018-03-01,"sbpp","transporte regular","voo internacional",0,0,0,0,0,0,0,0,0,0
"14195",2018-03-01,"sbpp","transporte não regular","voo doméstico",110,117,227,173,155,328,0,0,0,0
"14196",2018-03-01,"sbpp","transporte não regular","voo internacional",10,6,16,4,8,12,0,0,0,0
"14197",2018-03-01,"sbpr","transporte regular","voo doméstico",0,0,0,0,0,0,0,0,0,0
"14198",2018-03-01,"sbpr","transporte regular","voo internacional",0,0,0,0,0,0,0,0,0,0
"14199",2018-03-01,"sbpr","transporte não regular","voo doméstico",849,868,1717,905,810,1715,0,0,0,0
"14200",2018-03-01,"sbpr","transporte não regular","voo internacional",9,9,18,0,0,0,0,0,0,0
"14201",2018-03-01,"sbpv","transporte regular","voo doméstico",291,288,579,31119,31730,62849,0,1593,1593,0
"14202",2018-03-01,"sbpv","transporte regular","voo internacional",0,0,0,0,0,0,0,0,0,0
"14203",2018-03-01,"sbpv","transporte não regular","voo doméstico",253,258,511,288,0,288,0,0,0,0
"14204",2018-03-01,"sbpv","transporte não regular","voo internacional",0,0,0,0,0,0,0,0,0,0
"14205",2018-03-01,"sbrb","transporte regular","voo doméstico",120,120,240,8119,7950,16069,0,0,0,0
"14206",2018-03-01,"sbrb","transporte regular","voo internacional",0,0,0,0,0,0,0,0,0,0
"14207",2018-03-01,"sbrb","transporte não regular","voo doméstico",115,115,230,367,223,590,0,0,0,0
"14208",2018-03-01,"sbrb","transporte não regular","voo internacional",2,2,4,0,0,0,0,0,0,0
"14209",2018-03-01,"sbrj","transporte regular","voo doméstico",3774,3798,7572,375696,382408,758104,0,0,0,0
"14210",2018-03-01,"sbrj","transporte regular","voo internacional",0,0,0,0,0,0,0,0,0,0
"14211",2018-03-01,"sbrj","transporte não regular","voo doméstico",649,633,1282,4026,3789,7815,0,0,0,0
"14212",2018-03-01,"sbrj","transporte não regular","voo internacional",2,2,4,2,0,2,0,0,0,0
"14213",2018-03-01,"sbsj","transporte regular","voo doméstico",0,0,0,0,0,0,0,0,0,0
"14214",2018-03-01,"sbsj","transporte regular","voo internacional",0,0,0,0,0,0,0,0,0,0
"14215",2018-03-01,"sbsj","transporte não regular","voo doméstico",455,444,899,1124,1121,2245,0,0,0,0
"14216",2018-03-01,"sbsj","transporte não regular","voo internacional",2,13,15,47,8,55,0,0,0,0
"14217",2018-03-01,"sbsl","transporte regular","voo doméstico",529,529,1058,58944,56735,115679,0,0,0,0
"14218",2018-03-01,"sbsl","transporte regular","voo internacional",0,0,0,0,0,0,0,0,0,0
"14219",2018-03-01,"sbsl","transporte não regular","voo doméstico",223,230,453,1055,740,1795,47843,185514,233357,0
"14220",2018-03-01,"sbsl","transporte não regular","voo internacional",2,2,4,0,5,5,0,0,0,0
"14221",2018-03-01,"sbsn","transporte regular","voo doméstico",220,220,440,16522,15553,32075,0,0,0,0
"14222",2018-03-01,"sbsn","transporte regular","voo internacional",0,0,0,0,0,0,0,0,0,0
"14223",2018-03-01,"sbsn","transporte não regular","voo doméstico",224,223,447,1404,1463,2867,10570,15050,25620,0
"14224",2018-03-01,"sbsn","transporte não regular","voo internacional",0,0,0,0,0,0,0,0,0,0
"14225",2018-03-01,"sbsp","transporte regular","voo doméstico",7396,7459,14855,901854,902135,1803989,0,0,0,0
"14226",2018-03-01,"sbsp","transporte regular","voo internacional",0,0,0,0,0,0,0,0,0,0
"14227",2018-03-01,"sbsp","transporte não regular","voo doméstico",2152,2129,4281,7420,6398,13818,0,0,0,0
"14228",2018-03-01,"sbsp","transporte não regular","voo internacional",24,24,48,48,48,96,0,0,0,0
"14229",2018-03-01,"sbte","transporte regular","voo doméstico",380,382,762,35566,36117,71683,22034,106528,128562,212732
"14230",2018-03-01,"sbte","transporte regular","voo internacional",0,0,0,0,0,0,0,0,0,0
"14231",2018-03-01,"sbte","transporte não regular","voo doméstico",204,204,408,1771,2287,4058,0,0,0,0
"14232",2018-03-01,"sbte","transporte não regular","voo internacional",1,1,2,0,0,0,0,0,0,0
"14233",2018-03-01,"sbtf","transporte regular","voo doméstico",30,30,60,1085,1113,2198,0,0,0,0
"14234",2018-03-01,"sbtf","transporte regular","voo internacional",0,0,0,0,0,0,0,0,0,0
"14235",2018-03-01,"sbtf","transporte não regular","voo doméstico",87,88,175,208,184,392,0,175,175,132
"14236",2018-03-01,"sbtf","transporte não regular","voo internacional",0,0,0,0,0,0,0,0,0,0
"14237",2018-03-01,"sbtt","transporte regular","voo doméstico",30,30,60,1997,2347,4344,0,0,0,0
"14238",2018-03-01,"sbtt","transporte regular","voo internacional",0,0,0,0,0,0,0,0,0,0
"14239",2018-03-01,"sbtt","transporte não regular","voo doméstico",69,67,136,256,272,528,0,0,0,0
"14240",2018-03-01,"sbtt","transporte não regular","voo internacional",1,2,3,3,3,6,0,0,0,0
"14241",2018-03-01,"sbuf","transporte regular","voo doméstico",9,9,18,428,391,819,0,0,0,0
"14242",2018-03-01,"sbuf","transporte regular","voo internacional",0,0,0,0,0,0,0,0,0,0
"14243",2018-03-01,"sbuf","transporte não regular","voo doméstico",21,19,40,41,56,97,0,0,0,0
"14244",2018-03-01,"sbuf","transporte não regular","voo internacional",0,0,0,0,0,0,0,0,0,0
"14245",2018-03-01,"sbug","transporte regular","voo doméstico",16,16,32,879,887,1766,0,0,0,0
"14246",2018-03-01,"sbug","transporte regular","voo internacional",0,0,0,0,0,0,0,0,0,0
"14247",2018-03-01,"sbug","transporte não regular","voo doméstico",25,25,50,87,73,160,0,0,0,0
"14248",2018-03-01,"sbug","transporte não regular","voo internacional",0,0,0,0,0,0,0,0,0,0
"14249",2018-03-01,"sbul","transporte regular","voo doméstico",485,482,967,43398,44417,87815,0,0,0,0
"14250",2018-03-01,"sbul","transporte regular","voo internacional",0,0,0,0,0,0,0,0,0,0
"14251",2018-03-01,"sbul","transporte não regular","voo doméstico",557,556,1113,1600,1157,2757,0,0,0,0
"14252",2018-03-01,"sbul","transporte não regular","voo internacional",1,1,2,2,4,6,0,0,0,0
"14253",2018-03-01,"sbur","transporte regular","voo doméstico",31,32,63,1633,1479,3112,0,0,0,0
"14254",2018-03-01,"sbur","transporte regular","voo internacional",0,0,0,0,0,0,0,0,0,0
"14255",2018-03-01,"sbur","transporte não regular","voo doméstico",220,215,435,696,717,1413,0,0,0,0
"14256",2018-03-01,"sbur","transporte não regular","voo internacional",3,3,6,0,0,0,0,0,0,0
"14257",2018-11-01,"sbbe","transporte regular","voo doméstico",1024,1025,2049,137995,131005,269000,0,0,0,0
"14258",2018-11-01,"sbbe","transporte regular","voo internacional",45,47,92,5818,5158,10976,53,3,56,0
"14259",2018-11-01,"sbbe","transporte não regular","voo doméstico",424,420,844,551,1371,1922,0,0,0,0
"14260",2018-11-01,"sbbe","transporte não regular","voo internacional",9,7,16,21,12,33,0,0,0,0
"14261",2018-11-01,"sbbg","transporte regular","voo doméstico",0,0,0,0,0,0,0,0,0,0
"14262",2018-11-01,"sbbg","transporte regular","voo internacional",0,0,0,0,0,0,0,0,0,0
"14263",2018-11-01,"sbbg","transporte não regular","voo doméstico",9,11,20,49,42,91,0,0,0,0
"14264",2018-11-01,"sbbg","transporte não regular","voo internacional",4,1,5,5,16,21,0,0,0,0
"14265",2018-11-01,"sbbh","transporte regular","voo doméstico",0,0,0,0,0,0,0,0,0,0
"14266",2018-11-01,"sbbh","transporte regular","voo internacional",0,0,0,0,0,0,0,0,0,0
"14267",2018-11-01,"sbbh","transporte não regular","voo doméstico",1424,1409,2833,7289,7332,14621,0,0,0,0
"14268",2018-11-01,"sbbh","transporte não regular","voo internacional",1,1,2,4,4,8,0,0,0,0
"14269",2018-11-01,"sbbi","transporte regular","voo doméstico",0,0,0,0,0,0,0,0,0,0
"14270",2018-11-01,"sbbi","transporte regular","voo internacional",0,0,0,0,0,0,0,0,0,0
"14271",2018-11-01,"sbbi","transporte não regular","voo doméstico",1114,1104,2218,732,623,1355,0,0,0,0
"14272",2018-11-01,"sbbi","transporte não regular","voo internacional",2,2,4,0,0,0,0,0,0,0
"14273",2018-11-01,"sbbv","transporte regular","voo doméstico",89,89,178,15140,12402,27542,0,0,0,0
"14274",2018-11-01,"sbbv","transporte regular","voo internacional",0,0,0,0,0,0,0,0,0,0
"14275",2018-11-01,"sbbv","transporte não regular","voo doméstico",121,125,246,155,93,248,0,0,0,0
"14276",2018-11-01,"sbbv","transporte não regular","voo internacional",23,18,41,4,0,4,0,0,0,0
"14277",2018-11-01,"sbcg","transporte regular","voo doméstico",530,530,1060,64674,61463,126137,0,0,0,0
"14278",2018-11-01,"sbcg","transporte regular","voo internacional",0,0,0,0,0,0,0,0,0,0
"14279",2018-11-01,"sbcg","transporte não regular","voo doméstico",207,216,423,292,261,553,0,0,0,0
"14280",2018-11-01,"sbcg","transporte não regular","voo internacional",13,9,22,0,6,6,0,0,0,0
"14281",2018-11-01,"sbcj","transporte regular","voo doméstico",76,75,151,4655,4114,8769,0,0,0,0
"14282",2018-11-01,"sbcj","transporte regular","voo internacional",0,0,0,0,0,0,0,0,0,0
"14283",2018-11-01,"sbcj","transporte não regular","voo doméstico",84,86,170,1209,417,1626,0,0,0,0
"14284",2018-11-01,"sbcj","transporte não regular","voo internacional",0,0,0,0,0,0,0,0,0,0
"14285",2018-11-01,"sbcr","transporte regular","voo doméstico",19,19,38,1124,653,1777,0,0,0,0
"14286",2018-11-01,"sbcr","transporte regular","voo internacional",0,0,0,0,0,0,0,0,0,0
"14287",2018-11-01,"sbcr","transporte não regular","voo doméstico",47,47,94,73,57,130,0,0,0,0
"14288",2018-11-01,"sbcr","transporte não regular","voo internacional",1,1,2,0,1,1,0,0,0,0
"14289",2018-11-01,"sbct","transporte regular","voo doméstico",2320,2310,4630,267477,263462,530939,204765,66915,271680,216722
"14290",2018-11-01,"sbct","transporte regular","voo internacional",74,74,148,2675,2755,5430,0,36826,36826,30210
"14291",2018-11-01,"sbct","transporte não regular","voo doméstico",283,287,570,3484,2053,5537,0,39092,39092,0
"14292",2018-11-01,"sbct","transporte não regular","voo internacional",19,22,41,46,11,57,0,0,0,0
"14293",2018-11-01,"sbcz","transporte regular","voo doméstico",31,30,61,2790,1343,4133,0,0,0,0
"14294",2018-11-01,"sbcz","transporte regular","voo internacional",0,0,0,0,0,0,0,0,0,0
"14295",2018-11-01,"sbcz","transporte não regular","voo doméstico",123,123,246,461,449,910,0,0,0,0
"14296",2018-11-01,"sbcz","transporte não regular","voo internacional",0,1,1,0,0,0,0,0,0,0
"14297",2018-11-01,"sbeg","transporte regular","voo doméstico",939,930,1869,109912,101052,210964,206936,252191,459127,0
"14298",2018-11-01,"sbeg","transporte regular","voo internacional",107,114,221,5345,5009,10354,0,0,0,0
"14299",2018-11-01,"sbeg","transporte não regular","voo doméstico",513,511,1024,5054,3587,8641,0,0,0,0
"14300",2018-11-01,"sbeg","transporte não regular","voo internacional",59,60,119,219,0,219,0,0,0,0
"14301",2018-11-01,"sbfi","transporte regular","voo doméstico",602,612,1214,92497,85835,178332,0,0,0,0
"14302",2018-11-01,"sbfi","transporte regular","voo internacional",22,22,44,2217,1999,4216,0,0,0,0
"14303",2018-11-01,"sbfi","transporte não regular","voo doméstico",170,165,335,1153,2797,3950,0,0,0,0
"14304",2018-11-01,"sbfi","transporte não regular","voo internacional",49,47,96,63,65,128,0,0,0,0
"14305",2018-11-01,"sbgo","transporte regular","voo doméstico",1170,1174,2344,125033,120999,246032,267699,309509,577208,0
"14306",2018-11-01,"sbgo","transporte regular","voo internacional",0,0,0,0,0,0,0,0,0,0
"14307",2018-11-01,"sbgo","transporte não regular","voo doméstico",1315,1363,2678,4853,3624,8477,0,0,0,0
"14308",2018-11-01,"sbgo","transporte não regular","voo internacional",0,0,0,0,0,0,0,0,0,0
"14309",2018-11-01,"sbht","transporte regular","voo doméstico",78,79,157,3853,3623,7476,0,0,0,0
"14310",2018-11-01,"sbht","transporte regular","voo internacional",0,0,0,0,0,0,0,0,0,0
"14311",2018-11-01,"sbht","transporte não regular","voo doméstico",42,40,82,104,43,147,0,0,0,0
"14312",2018-11-01,"sbht","transporte não regular","voo internacional",0,1,1,0,0,0,0,0,0,0
"14313",2018-11-01,"sbiz","transporte regular","voo doméstico",108,107,215,12075,11344,23419,0,0,0,0
"14314",2018-11-01,"sbiz","transporte regular","voo internacional",0,0,0,0,0,0,0,0,0,0
"14315",2018-11-01,"sbiz","transporte não regular","voo doméstico",67,72,139,364,148,512,0,0,0,0
"14316",2018-11-01,"sbiz","transporte não regular","voo internacional",0,0,0,0,0,0,0,0,0,0
"14317",2018-11-01,"sbjc","transporte regular","voo doméstico",0,0,0,0,0,0,0,0,0,0
"14318",2018-11-01,"sbjc","transporte regular","voo internacional",0,0,0,0,0,0,0,0,0,0
"14319",2018-11-01,"sbjc","transporte não regular","voo doméstico",267,269,536,491,266,757,0,0,0,0
"14320",2018-11-01,"sbjc","transporte não regular","voo internacional",0,0,0,0,0,0,0,0,0,0
"14321",2018-11-01,"sbjr","transporte regular","voo doméstico",0,0,0,0,0,0,0,0,0,0
"14322",2018-11-01,"sbjr","transporte regular","voo internacional",0,0,0,0,0,0,0,0,0,0
"14323",2018-11-01,"sbjr","transporte não regular","voo doméstico",2778,2768,5546,11553,5420,16973,0,0,0,0
"14324",2018-11-01,"sbjr","transporte não regular","voo internacional",1,1,2,0,0,0,0,0,0,0
"14325",2018-11-01,"sbjv","transporte regular","voo doméstico",204,204,408,21303,21244,42547,0,0,0,0
"14326",2018-11-01,"sbjv","transporte regular","voo internacional",0,0,0,0,0,0,0,0,0,0
"14327",2018-11-01,"sbjv","transporte não regular","voo doméstico",82,82,164,113,86,199,0,0,0,0
"14328",2018-11-01,"sbjv","transporte não regular","voo internacional",0,0,0,0,0,0,0,0,0,0
"14329",2018-11-01,"sblo","transporte regular","voo doméstico",412,415,827,43811,40610,84421,0,0,0,0
"14330",2018-11-01,"sblo","transporte regular","voo internacional",0,0,0,0,0,0,0,0,0,0
"14331",2018-11-01,"sblo","transporte não regular","voo doméstico",451,450,901,538,352,890,0,0,0,0
"14332",2018-11-01,"sblo","transporte não regular","voo internacional",1,1,2,0,0,0,0,0,0,0
"14333",2018-11-01,"sbma","transporte regular","voo doméstico",122,122,244,10995,10297,21292,0,0,0,0
"14334",2018-11-01,"sbma","transporte regular","voo internacional",0,0,0,0,0,0,0,0,0,0
"14335",2018-11-01,"sbma","transporte não regular","voo doméstico",123,122,245,396,410,806,0,0,0,0
"14336",2018-11-01,"sbma","transporte não regular","voo internacional",0,0,0,0,0,0,0,0,0,0
"14337",2018-11-01,"sbmk","transporte regular","voo doméstico",112,111,223,8037,7388,15425,0,0,0,0
"14338",2018-11-01,"sbmk","transporte regular","voo internacional",0,0,0,0,0,0,0,0,0,0
"14339",2018-11-01,"sbmk","transporte não regular","voo doméstico",193,197,390,390,51,441,0,0,0,0
"14340",2018-11-01,"sbmk","transporte não regular","voo internacional",1,1,2,2,0,2,0,0,0,0
"14341",2018-11-01,"sbmq","transporte regular","voo doméstico",179,178,357,22518,19733,42251,16025,33700,49725,0
"14342",2018-11-01,"sbmq","transporte regular","voo internacional",0,0,0,0,0,0,0,0,0,0
"14343",2018-11-01,"sbmq","transporte não regular","voo doméstico",136,138,274,344,152,496,0,0,0,0
"14344",2018-11-01,"sbmq","transporte não regular","voo internacional",7,6,13,0,0,0,0,0,0,0
"14345",2018-11-01,"sbmt","transporte regular","voo doméstico",0,0,0,0,0,0,0,0,0,0
"14346",2018-11-01,"sbmt","transporte regular","voo internacional",0,0,0,0,0,0,0,0,0,0
"14347",2018-11-01,"sbmt","transporte não regular","voo doméstico",2931,2943,5874,4821,4754,9575,0,0,0,0
"14348",2018-11-01,"sbmt","transporte não regular","voo internacional",0,0,0,0,0,0,0,0,0,0
"14349",2018-11-01,"sbnf","transporte regular","voo doméstico",594,600,1194,77571,77594,155165,0,0,0,0
"14350",2018-11-01,"sbnf","transporte regular","voo internacional",13,11,24,1143,1335,2478,0,0,0,0
"14351",2018-11-01,"sbnf","transporte não regular","voo doméstico",291,287,578,751,1110,1861,0,0,0,0
"14352",2018-11-01,"sbnf","transporte não regular","voo internacional",2,1,3,0,9,9,0,0,0,0
"14353",2018-11-01,"sbpb","transporte regular","voo doméstico",4,4,8,261,295,556,0,0,0,0
"14354",2018-11-01,"sbpb","transporte regular","voo internacional",0,0,0,0,0,0,0,0,0,0
"14355",2018-11-01,"sbpb","transporte não regular","voo doméstico",50,51,101,115,114,229,0,0,0,0
"14356",2018-11-01,"sbpb","transporte não regular","voo internacional",0,0,0,0,0,0,0,0,0,0
"14357",2018-11-01,"sbpj","transporte regular","voo doméstico",249,250,499,27271,25091,52362,0,0,0,0
"14358",2018-11-01,"sbpj","transporte regular","voo internacional",0,0,0,0,0,0,0,0,0,0
"14359",2018-11-01,"sbpj","transporte não regular","voo doméstico",173,176,349,347,297,644,0,0,0,0
"14360",2018-11-01,"sbpj","transporte não regular","voo internacional",2,2,4,0,0,0,0,0,0,0
"14361",2018-11-01,"sbpk","transporte regular","voo doméstico",24,24,48,1360,1366,2726,0,0,0,0
"14362",2018-11-01,"sbpk","transporte regular","voo internacional",0,0,0,0,0,0,0,0,0,0
"14363",2018-11-01,"sbpk","transporte não regular","voo doméstico",30,26,56,100,97,197,0,0,0,0
"14364",2018-11-01,"sbpk","transporte não regular","voo internacional",1,3,4,0,9,9,0,0,0,0
"14365",2018-11-01,"sbpl","transporte regular","voo doméstico",155,153,308,18973,18312,37285,0,0,0,0
"14366",2018-11-01,"sbpl","transporte regular","voo internacional",6,6,12,0,0,0,0,0,0,0
"14367",2018-11-01,"sbpl","transporte não regular","voo doméstico",65,67,132,246,77,323,0,0,0,0
"14368",2018-11-01,"sbpl","transporte não regular","voo internacional",0,0,0,0,0,0,0,0,0,0
"14369",2018-11-01,"sbpp","transporte regular","voo doméstico",0,0,0,0,0,0,0,0,0,0
"14370",2018-11-01,"sbpp","transporte regular","voo internacional",0,0,0,0,0,0,0,0,0,0
"14371",2018-11-01,"sbpp","transporte não regular","voo doméstico",89,89,178,148,141,289,0,0,0,0
"14372",2018-11-01,"sbpp","transporte não regular","voo internacional",3,4,7,3,3,6,0,0,0,0
"14373",2018-11-01,"sbpr","transporte regular","voo doméstico",0,0,0,0,0,0,0,0,0,0
"14374",2018-11-01,"sbpr","transporte regular","voo internacional",0,0,0,0,0,0,0,0,0,0
"14375",2018-11-01,"sbpr","transporte não regular","voo doméstico",609,607,1216,720,691,1411,0,0,0,0
"14376",2018-11-01,"sbpr","transporte não regular","voo internacional",0,0,0,0,0,0,0,0,0,0
"14377",2018-11-01,"sbpv","transporte regular","voo doméstico",288,287,575,32261,30087,62348,0,0,0,0
"14378",2018-11-01,"sbpv","transporte regular","voo internacional",0,0,0,0,0,0,0,0,0,0
"14379",2018-11-01,"sbpv","transporte não regular","voo doméstico",219,217,436,30,0,30,0,0,0,0
"14380",2018-11-01,"sbpv","transporte não regular","voo internacional",0,0,0,0,0,0,0,0,0,0
"14381",2018-11-01,"sbrb","transporte regular","voo doméstico",127,127,254,13783,10613,24396,0,0,0,0
"14382",2018-11-01,"sbrb","transporte regular","voo internacional",0,0,0,0,0,0,0,0,0,0
"14383",2018-11-01,"sbrb","transporte não regular","voo doméstico",125,126,251,495,364,859,0,0,0,0
"14384",2018-11-01,"sbrb","transporte não regular","voo internacional",0,1,1,0,0,0,0,0,0,0
"14385",2018-11-01,"sbrj","transporte regular","voo doméstico",3362,3380,6742,374228,369449,743677,0,0,0,0
"14386",2018-11-01,"sbrj","transporte regular","voo internacional",0,0,0,0,0,0,0,0,0,0
"14387",2018-11-01,"sbrj","transporte não regular","voo doméstico",530,508,1038,1812,914,2726,0,0,0,0
"14388",2018-11-01,"sbrj","transporte não regular","voo internacional",3,4,7,0,0,0,0,0,0,0
"14389",2018-11-01,"sbsj","transporte regular","voo doméstico",22,22,44,1083,1074,2157,0,0,0,0
"14390",2018-11-01,"sbsj","transporte regular","voo internacional",0,0,0,0,0,0,0,0,0,0
"14391",2018-11-01,"sbsj","transporte não regular","voo doméstico",393,378,771,909,907,1816,0,0,0,0
"14392",2018-11-01,"sbsj","transporte não regular","voo internacional",4,16,20,32,10,42,0,0,0,0
"14393",2018-11-01,"sbsl","transporte regular","voo doméstico",537,537,1074,65722,62159,127881,0,0,0,0
"14394",2018-11-01,"sbsl","transporte regular","voo internacional",0,0,0,0,0,0,0,0,0,0
"14395",2018-11-01,"sbsl","transporte não regular","voo doméstico",177,180,357,347,377,724,0,0,0,0
"14396",2018-11-01,"sbsl","transporte não regular","voo internacional",2,1,3,0,0,0,0,0,0,0
"14397",2018-11-01,"sbsn","transporte regular","voo doméstico",193,194,387,19282,15702,34984,0,0,0,0
"14398",2018-11-01,"sbsn","transporte regular","voo internacional",0,0,0,0,0,0,0,0,0,0
"14399",2018-11-01,"sbsn","transporte não regular","voo doméstico",175,175,350,2576,2543,5119,1000,1300,2300,0
"14400",2018-11-01,"sbsn","transporte não regular","voo internacional",0,0,0,0,0,0,0,0,0,0
"14401",2018-11-01,"sbsp","transporte regular","voo doméstico",7049,7152,14201,951063,935183,1886246,0,0,0,0
"14402",2018-11-01,"sbsp","transporte regular","voo internacional",0,0,0,0,0,0,0,0,0,0
"14403",2018-11-01,"sbsp","transporte não regular","voo doméstico",2164,2109,4273,6662,7177,13839,0,0,0,0
"14404",2018-11-01,"sbsp","transporte não regular","voo internacional",5,8,13,14,10,24,0,0,0,0
"14405",2018-11-01,"sbte","transporte regular","voo doméstico",340,336,676,43543,42041,85584,0,6140,6140,0
"14406",2018-11-01,"sbte","transporte regular","voo internacional",0,0,0,0,0,0,0,0,0,0
"14407",2018-11-01,"sbte","transporte não regular","voo doméstico",133,131,264,907,830,1737,0,0,0,0
"14408",2018-11-01,"sbte","transporte não regular","voo internacional",0,0,0,0,0,0,0,0,0,0
"14409",2018-11-01,"sbtf","transporte regular","voo doméstico",29,29,58,1204,1180,2384,0,0,0,0
"14410",2018-11-01,"sbtf","transporte regular","voo internacional",0,0,0,0,0,0,0,0,0,0
"14411",2018-11-01,"sbtf","transporte não regular","voo doméstico",98,97,195,133,117,250,1227,7,1234,2055
"14412",2018-11-01,"sbtf","transporte não regular","voo internacional",1,1,2,0,0,0,0,0,0,0
"14413",2018-11-01,"sbtt","transporte regular","voo doméstico",29,29,58,2426,2726,5152,0,0,0,0
"14414",2018-11-01,"sbtt","transporte regular","voo internacional",0,0,0,0,0,0,0,0,0,0
"14415",2018-11-01,"sbtt","transporte não regular","voo doméstico",67,68,135,281,283,564,502,386,888,0
"14416",2018-11-01,"sbtt","transporte não regular","voo internacional",3,2,5,2,7,9,0,0,0,0
"14417",2018-11-01,"sbuf","transporte regular","voo doméstico",10,10,20,413,399,812,0,0,0,0
"14418",2018-11-01,"sbuf","transporte regular","voo internacional",0,0,0,0,0,0,0,0,0,0
"14419",2018-11-01,"sbuf","transporte não regular","voo doméstico",19,19,38,42,37,79,0,0,0,0
"14420",2018-11-01,"sbuf","transporte não regular","voo internacional",0,0,0,0,0,0,0,0,0,0
"14421",2018-11-01,"sbug","transporte regular","voo doméstico",12,12,24,632,605,1237,0,0,0,0
"14422",2018-11-01,"sbug","transporte regular","voo internacional",0,0,0,0,0,0,0,0,0,0
"14423",2018-11-01,"sbug","transporte não regular","voo doméstico",10,9,19,52,53,105,0,0,0,0
"14424",2018-11-01,"sbug","transporte não regular","voo internacional",0,0,0,0,0,0,0,0,0,0
"14425",2018-11-01,"sbul","transporte regular","voo doméstico",495,495,990,48017,45562,93579,0,0,0,0
"14426",2018-11-01,"sbul","transporte regular","voo internacional",0,0,0,0,0,0,0,0,0,0
"14427",2018-11-01,"sbul","transporte não regular","voo doméstico",344,341,685,1024,834,1858,0,0,0,0
"14428",2018-11-01,"sbul","transporte não regular","voo internacional",1,1,2,5,3,8,0,0,0,0
"14429",2018-11-01,"sbur","transporte regular","voo doméstico",54,53,107,2677,2581,5258,0,0,0,0
"14430",2018-11-01,"sbur","transporte regular","voo internacional",0,0,0,0,0,0,0,0,0,0
"14431",2018-11-01,"sbur","transporte não regular","voo doméstico",158,155,313,611,573,1184,0,0,0,0
"14432",2018-11-01,"sbur","transporte não regular","voo internacional",1,1,2,0,0,0,0,0,0,0
"14433",2018-10-01,"sbbe","transporte regular","voo doméstico",1133,1135,2268,145560,141550,287110,0,0,0,0
"14434",2018-10-01,"sbbe","transporte regular","voo internacional",50,49,99,6140,6049,12189,32,529,561,0
"14435",2018-10-01,"sbbe","transporte não regular","voo doméstico",474,477,951,901,1429,2330,0,0,0,0
"14436",2018-10-01,"sbbe","transporte não regular","voo internacional",6,5,11,7,10,17,0,0,0,0
"14437",2018-10-01,"sbbg","transporte regular","voo doméstico",0,0,0,0,0,0,0,0,0,0
"14438",2018-10-01,"sbbg","transporte regular","voo internacional",0,0,0,0,0,0,0,0,0,0
"14439",2018-10-01,"sbbg","transporte não regular","voo doméstico",13,13,26,65,54,119,0,0,0,0
"14440",2018-10-01,"sbbg","transporte não regular","voo internacional",1,1,2,4,4,8,0,0,0,0
"14441",2018-10-01,"sbbh","transporte regular","voo doméstico",0,0,0,0,0,0,0,0,0,0
"14442",2018-10-01,"sbbh","transporte regular","voo internacional",0,0,0,0,0,0,0,0,0,0
"14443",2018-10-01,"sbbh","transporte não regular","voo doméstico",1663,1663,3326,8034,8108,16142,0,0,0,0
"14444",2018-10-01,"sbbh","transporte não regular","voo internacional",0,0,0,0,0,0,0,0,0,0
"14445",2018-10-01,"sbbi","transporte regular","voo doméstico",0,0,0,0,0,0,0,0,0,0
"14446",2018-10-01,"sbbi","transporte regular","voo internacional",0,0,0,0,0,0,0,0,0,0
"14447",2018-10-01,"sbbi","transporte não regular","voo doméstico",866,865,1731,606,520,1126,0,0,0,0
"14448",2018-10-01,"sbbi","transporte não regular","voo internacional",4,4,8,0,0,0,0,0,0,0
"14449",2018-10-01,"sbbv","transporte regular","voo doméstico",97,97,194,15943,12006,27949,0,0,0,0
"14450",2018-10-01,"sbbv","transporte regular","voo internacional",0,0,0,0,0,0,0,0,0,0
"14451",2018-10-01,"sbbv","transporte não regular","voo doméstico",89,95,184,98,12,110,0,0,0,0
"14452",2018-10-01,"sbbv","transporte não regular","voo internacional",20,20,40,12,0,12,0,0,0,0
"14453",2018-10-01,"sbcg","transporte regular","voo doméstico",552,553,1105,68118,65638,133756,0,0,0,0
"14454",2018-10-01,"sbcg","transporte regular","voo internacional",0,0,0,0,0,0,0,0,0,0
"14455",2018-10-01,"sbcg","transporte não regular","voo doméstico",255,260,515,259,325,584,0,0,0,0
"14456",2018-10-01,"sbcg","transporte não regular","voo internacional",13,7,20,0,0,0,0,0,0,0
"14457",2018-10-01,"sbcj","transporte regular","voo doméstico",85,85,170,4895,4698,9593,0,0,0,0
"14458",2018-10-01,"sbcj","transporte regular","voo internacional",0,0,0,0,0,0,0,0,0,0
"14459",2018-10-01,"sbcj","transporte não regular","voo doméstico",80,79,159,953,165,1118,0,0,0,0
"14460",2018-10-01,"sbcj","transporte não regular","voo internacional",0,0,0,0,0,0,0,0,0,0
"14461",2018-10-01,"sbcr","transporte regular","voo doméstico",21,21,42,1212,1212,2424,0,0,0,0
"14462",2018-10-01,"sbcr","transporte regular","voo internacional",0,0,0,0,0,0,0,0,0,0
"14463",2018-10-01,"sbcr","transporte não regular","voo doméstico",32,32,64,68,82,150,0,0,0,0
"14464",2018-10-01,"sbcr","transporte não regular","voo internacional",4,5,9,27,19,46,0,0,0,0
"14465",2018-10-01,"sbct","transporte regular","voo doméstico",2482,2478,4960,277018,275327,552345,96754,61906,158660,238313
"14466",2018-10-01,"sbct","transporte regular","voo internacional",81,81,162,3096,2773,5869,0,21302,21302,40105
"14467",2018-10-01,"sbct","transporte não regular","voo doméstico",294,297,591,1508,2554,4062,0,58672,58672,0
"14468",2018-10-01,"sbct","transporte não regular","voo internacional",13,14,27,33,19,52,0,0,0,0
"14469",2018-10-01,"sbcz","transporte regular","voo doméstico",29,29,58,2827,1298,4125,0,0,0,0
"14470",2018-10-01,"sbcz","transporte regular","voo internacional",0,0,0,0,0,0,0,0,0,0
"14471",2018-10-01,"sbcz","transporte não regular","voo doméstico",282,283,565,1164,1064,2228,0,0,0,0
"14472",2018-10-01,"sbcz","transporte não regular","voo internacional",0,0,0,0,0,0,0,0,0,0
"14473",2018-10-01,"sbeg","transporte regular","voo doméstico",979,966,1945,113980,108618,222598,123814,266269,390083,0
"14474",2018-10-01,"sbeg","transporte regular","voo internacional",104,113,217,4697,4780,9477,0,0,0,0
"14475",2018-10-01,"sbeg","transporte não regular","voo doméstico",635,633,1268,5694,3590,9284,0,5922,5922,0
"14476",2018-10-01,"sbeg","transporte não regular","voo internacional",70,76,146,108,0,108,0,0,0,0
"14477",2018-10-01,"sbfi","transporte regular","voo doméstico",591,628,1219,92062,84209,176271,0,0,0,0
"14478",2018-10-01,"sbfi","transporte regular","voo internacional",21,21,42,1782,1446,3228,0,0,0,0
"14479",2018-10-01,"sbfi","transporte não regular","voo doméstico",168,128,296,909,7393,8302,0,0,0,0
"14480",2018-10-01,"sbfi","transporte não regular","voo internacional",52,54,106,82,93,175,0,0,0,0
"14481",2018-10-01,"sbgo","transporte regular","voo doméstico",1247,1244,2491,129685,122658,252343,259878,297754,557632,0
"14482",2018-10-01,"sbgo","transporte regular","voo internacional",0,0,0,0,0,0,0,0,0,0
"14483",2018-10-01,"sbgo","transporte não regular","voo doméstico",1638,1641,3279,5225,4211,9436,0,0,0,0
"14484",2018-10-01,"sbgo","transporte não regular","voo internacional",5,4,9,0,0,0,0,0,0,0
"14485",2018-10-01,"sbht","transporte regular","voo doméstico",81,81,162,3961,3897,7858,0,0,0,0
"14486",2018-10-01,"sbht","transporte regular","voo internacional",0,0,0,0,0,0,0,0,0,0
"14487",2018-10-01,"sbht","transporte não regular","voo doméstico",57,57,114,152,138,290,0,0,0,0
"14488",2018-10-01,"sbht","transporte não regular","voo internacional",0,0,0,0,0,0,0,0,0,0
"14489",2018-10-01,"sbiz","transporte regular","voo doméstico",104,104,208,12771,11960,24731,0,0,0,0
"14490",2018-10-01,"sbiz","transporte regular","voo internacional",0,0,0,0,0,0,0,0,0,0
"14491",2018-10-01,"sbiz","transporte não regular","voo doméstico",95,90,185,185,196,381,0,0,0,0
"14492",2018-10-01,"sbiz","transporte não regular","voo internacional",0,0,0,0,0,0,0,0,0,0
"14493",2018-10-01,"sbjc","transporte regular","voo doméstico",1,0,1,0,0,0,0,0,0,0
"14494",2018-10-01,"sbjc","transporte regular","voo internacional",0,0,0,0,0,0,0,0,0,0
"14495",2018-10-01,"sbjc","transporte não regular","voo doméstico",304,306,610,661,306,967,0,0,0,0
"14496",2018-10-01,"sbjc","transporte não regular","voo internacional",0,0,0,0,0,0,0,0,0,0
"14497",2018-10-01,"sbjr","transporte regular","voo doméstico",0,0,0,0,0,0,0,0,0,0
"14498",2018-10-01,"sbjr","transporte regular","voo internacional",0,0,0,0,0,0,0,0,0,0
"14499",2018-10-01,"sbjr","transporte não regular","voo doméstico",2648,2654,5302,11391,4633,16024,0,0,0,0
"14500",2018-10-01,"sbjr","transporte não regular","voo internacional",0,1,1,3,0,3,0,0,0,0
"14501",2018-10-01,"sbjv","transporte regular","voo doméstico",217,217,434,22378,21542,43920,0,0,0,0
"14502",2018-10-01,"sbjv","transporte regular","voo internacional",0,0,0,0,0,0,0,0,0,0
"14503",2018-10-01,"sbjv","transporte não regular","voo doméstico",88,88,176,156,96,252,0,0,0,0
"14504",2018-10-01,"sbjv","transporte não regular","voo internacional",0,0,0,0,0,0,0,0,0,0
"14505",2018-10-01,"sblo","transporte regular","voo doméstico",459,459,918,46755,45763,92518,0,0,0,0
"14506",2018-10-01,"sblo","transporte regular","voo internacional",0,0,0,0,0,0,0,0,0,0
"14507",2018-10-01,"sblo","transporte não regular","voo doméstico",481,481,962,490,660,1150,0,0,0,0
"14508",2018-10-01,"sblo","transporte não regular","voo internacional",2,2,4,0,0,0,0,0,0,0
"14509",2018-10-01,"sbma","transporte regular","voo doméstico",134,134,268,12020,11695,23715,0,0,0,0
"14510",2018-10-01,"sbma","transporte regular","voo internacional",0,0,0,0,0,0,0,0,0,0
"14511",2018-10-01,"sbma","transporte não regular","voo doméstico",185,186,371,389,481,870,0,0,0,0
"14512",2018-10-01,"sbma","transporte não regular","voo internacional",0,0,0,0,0,0,0,0,0,0
"14513",2018-10-01,"sbmk","transporte regular","voo doméstico",132,134,266,9434,8303,17737,0,0,0,0
"14514",2018-10-01,"sbmk","transporte regular","voo internacional",0,0,0,0,0,0,0,0,0,0
"14515",2018-10-01,"sbmk","transporte não regular","voo doméstico",232,231,463,490,171,661,0,0,0,0
"14516",2018-10-01,"sbmk","transporte não regular","voo internacional",1,1,2,3,0,3,0,0,0,0
"14517",2018-10-01,"sbmq","transporte regular","voo doméstico",193,196,389,23745,21338,45083,13460,34900,48360,0
"14518",2018-10-01,"sbmq","transporte regular","voo internacional",0,0,0,0,0,0,0,0,0,0
"14519",2018-10-01,"sbmq","transporte não regular","voo doméstico",170,168,338,618,327,945,0,0,0,0
"14520",2018-10-01,"sbmq","transporte não regular","voo internacional",5,4,9,0,0,0,0,0,0,0
"14521",2018-10-01,"sbmt","transporte regular","voo doméstico",0,0,0,0,0,0,0,0,0,0
"14522",2018-10-01,"sbmt","transporte regular","voo internacional",0,0,0,0,0,0,0,0,0,0
"14523",2018-10-01,"sbmt","transporte não regular","voo doméstico",2506,2484,4990,4066,4038,8104,0,0,0,0
"14524",2018-10-01,"sbmt","transporte não regular","voo internacional",0,0,0,0,0,0,0,0,0,0
"14525",2018-10-01,"sbnf","transporte regular","voo doméstico",636,639,1275,81722,81957,163679,0,0,0,0
"14526",2018-10-01,"sbnf","transporte regular","voo internacional",15,18,33,1648,1403,3051,0,0,0,0
"14527",2018-10-01,"sbnf","transporte não regular","voo doméstico",301,296,597,3217,3408,6625,0,0,0,0
"14528",2018-10-01,"sbnf","transporte não regular","voo internacional",2,2,4,5,6,11,0,0,0,0
"14529",2018-10-01,"sbpb","transporte regular","voo doméstico",4,4,8,303,333,636,0,0,0,0
"14530",2018-10-01,"sbpb","transporte regular","voo internacional",0,0,0,0,0,0,0,0,0,0
"14531",2018-10-01,"sbpb","transporte não regular","voo doméstico",67,65,132,181,184,365,0,0,0,0
"14532",2018-10-01,"sbpb","transporte não regular","voo internacional",0,0,0,0,0,0,0,0,0,0
"14533",2018-10-01,"sbpj","transporte regular","voo doméstico",270,270,540,28055,27382,55437,0,0,0,382
"14534",2018-10-01,"sbpj","transporte regular","voo internacional",0,0,0,0,0,0,0,0,0,0
"14535",2018-10-01,"sbpj","transporte não regular","voo doméstico",256,261,517,527,211,738,0,0,0,0
"14536",2018-10-01,"sbpj","transporte não regular","voo internacional",3,3,6,1,0,1,0,0,0,0
"14537",2018-10-01,"sbpk","transporte regular","voo doméstico",26,26,52,1516,1549,3065,0,0,0,0
"14538",2018-10-01,"sbpk","transporte regular","voo internacional",0,0,0,0,0,0,0,0,0,0
"14539",2018-10-01,"sbpk","transporte não regular","voo doméstico",35,33,68,80,131,211,0,0,0,0
"14540",2018-10-01,"sbpk","transporte não regular","voo internacional",1,3,4,9,0,9,0,0,0,0
"14541",2018-10-01,"sbpl","transporte regular","voo doméstico",165,164,329,19452,19305,38757,0,0,0,0
"14542",2018-10-01,"sbpl","transporte regular","voo internacional",7,7,14,0,0,0,0,1,1,0
"14543",2018-10-01,"sbpl","transporte não regular","voo doméstico",96,97,193,123,131,254,0,0,0,0
"14544",2018-10-01,"sbpl","transporte não regular","voo internacional",0,0,0,0,0,0,0,0,0,0
"14545",2018-10-01,"sbpp","transporte regular","voo doméstico",0,0,0,0,0,0,0,0,0,0
"14546",2018-10-01,"sbpp","transporte regular","voo internacional",0,0,0,0,0,0,0,0,0,0
"14547",2018-10-01,"sbpp","transporte não regular","voo doméstico",79,82,161,117,106,223,0,0,0,0
"14548",2018-10-01,"sbpp","transporte não regular","voo internacional",7,7,14,6,7,13,0,0,0,0
"14549",2018-10-01,"sbpr","transporte regular","voo doméstico",0,0,0,0,0,0,0,0,0,0
"14550",2018-10-01,"sbpr","transporte regular","voo internacional",0,0,0,0,0,0,0,0,0,0
"14551",2018-10-01,"sbpr","transporte não regular","voo doméstico",736,737,1473,862,804,1666,0,0,0,0
"14552",2018-10-01,"sbpr","transporte não regular","voo internacional",2,2,4,0,0,0,0,0,0,0
"14553",2018-10-01,"sbpv","transporte regular","voo doméstico",293,293,586,32613,31828,64441,0,0,0,0
"14554",2018-10-01,"sbpv","transporte regular","voo internacional",0,1,1,2,0,2,0,0,0,0
"14555",2018-10-01,"sbpv","transporte não regular","voo doméstico",306,311,617,77,0,77,0,0,0,0
"14556",2018-10-01,"sbpv","transporte não regular","voo internacional",0,0,0,0,0,0,0,0,0,0
"14557",2018-10-01,"sbrb","transporte regular","voo doméstico",157,158,315,16295,13121,29416,0,0,0,0
"14558",2018-10-01,"sbrb","transporte regular","voo internacional",0,0,0,0,0,0,0,0,0,0
"14559",2018-10-01,"sbrb","transporte não regular","voo doméstico",219,213,432,450,349,799,0,0,0,0
"14560",2018-10-01,"sbrb","transporte não regular","voo internacional",1,0,1,0,0,0,0,0,0,0
"14561",2018-10-01,"sbrj","transporte regular","voo doméstico",3529,3545,7074,374287,370890,745177,0,0,0,0
"14562",2018-10-01,"sbrj","transporte regular","voo internacional",0,0,0,0,0,0,0,0,0,0
"14563",2018-10-01,"sbrj","transporte não regular","voo doméstico",513,494,1007,1866,1250,3116,0,0,0,0
"14564",2018-10-01,"sbrj","transporte não regular","voo internacional",2,1,3,1,0,1,0,0,0,0
"14565",2018-10-01,"sbsj","transporte regular","voo doméstico",22,22,44,1232,1193,2425,0,0,0,0
"14566",2018-10-01,"sbsj","transporte regular","voo internacional",0,0,0,0,0,0,0,0,0,0
"14567",2018-10-01,"sbsj","transporte não regular","voo doméstico",370,366,736,1243,1206,2449,0,0,0,0
"14568",2018-10-01,"sbsj","transporte não regular","voo internacional",5,17,22,26,6,32,0,0,0,0
"14569",2018-10-01,"sbsl","transporte regular","voo doméstico",538,538,1076,64733,61628,126361,0,0,0,0
"14570",2018-10-01,"sbsl","transporte regular","voo internacional",0,0,0,0,0,0,0,0,0,0
"14571",2018-10-01,"sbsl","transporte não regular","voo doméstico",295,292,587,344,394,738,0,40852,40852,0
"14572",2018-10-01,"sbsl","transporte não regular","voo internacional",2,3,5,16,4,20,0,0,0,0
"14573",2018-10-01,"sbsn","transporte regular","voo doméstico",225,224,449,21773,19008,40781,0,0,0,0
"14574",2018-10-01,"sbsn","transporte regular","voo internacional",0,0,0,0,0,0,0,0,0,0
"14575",2018-10-01,"sbsn","transporte não regular","voo doméstico",215,211,426,2347,2452,4799,6010,8300,14310,0
"14576",2018-10-01,"sbsn","transporte não regular","voo internacional",0,0,0,0,0,0,0,0,0,0
"14577",2018-10-01,"sbsp","transporte regular","voo doméstico",7431,7493,14924,975182,955722,1930904,0,0,0,0
"14578",2018-10-01,"sbsp","transporte regular","voo internacional",0,0,0,0,0,0,0,0,0,0
"14579",2018-10-01,"sbsp","transporte não regular","voo doméstico",2044,1986,4030,8082,8640,16722,0,0,0,0
"14580",2018-10-01,"sbsp","transporte não regular","voo internacional",7,6,13,10,12,22,0,0,0,0
"14581",2018-10-01,"sbte","transporte regular","voo doméstico",356,356,712,45037,43766,88803,0,0,0,0
"14582",2018-10-01,"sbte","transporte regular","voo internacional",0,0,0,0,0,0,0,0,0,0
"14583",2018-10-01,"sbte","transporte não regular","voo doméstico",203,210,413,1123,1109,2232,0,25835,25835,0
"14584",2018-10-01,"sbte","transporte não regular","voo internacional",2,2,4,0,0,0,0,0,0,0
"14585",2018-10-01,"sbtf","transporte regular","voo doméstico",32,32,64,1317,1438,2755,0,0,0,0
"14586",2018-10-01,"sbtf","transporte regular","voo internacional",0,0,0,0,0,0,0,0,0,0
"14587",2018-10-01,"sbtf","transporte não regular","voo doméstico",118,118,236,219,185,404,1023,54,1077,1110
"14588",2018-10-01,"sbtf","transporte não regular","voo internacional",0,0,0,0,0,0,0,0,0,0
"14589",2018-10-01,"sbtt","transporte regular","voo doméstico",29,29,58,2269,2551,4820,0,0,0,0
"14590",2018-10-01,"sbtt","transporte regular","voo internacional",0,0,0,0,0,0,0,0,0,0
"14591",2018-10-01,"sbtt","transporte não regular","voo doméstico",99,98,197,466,493,959,466,60,526,0
"14592",2018-10-01,"sbtt","transporte não regular","voo internacional",1,2,3,2,2,4,0,0,0,0
"14593",2018-10-01,"sbuf","transporte regular","voo doméstico",9,9,18,503,487,990,0,0,0,0
"14594",2018-10-01,"sbuf","transporte regular","voo internacional",0,0,0,0,0,0,0,0,0,0
"14595",2018-10-01,"sbuf","transporte não regular","voo doméstico",13,13,26,35,23,58,0,0,0,0
"14596",2018-10-01,"sbuf","transporte não regular","voo internacional",0,0,0,0,0,0,0,0,0,0
"14597",2018-10-01,"sbug","transporte regular","voo doméstico",16,16,32,927,886,1813,0,0,0,0
"14598",2018-10-01,"sbug","transporte regular","voo internacional",0,0,0,0,0,0,0,0,0,0
"14599",2018-10-01,"sbug","transporte não regular","voo doméstico",11,11,22,13,20,33,0,0,0,0
"14600",2018-10-01,"sbug","transporte não regular","voo internacional",0,0,0,0,0,0,0,0,0,0
"14601",2018-10-01,"sbul","transporte regular","voo doméstico",562,564,1126,51576,49341,100917,0,245,245,0
"14602",2018-10-01,"sbul","transporte regular","voo internacional",0,0,0,0,0,0,0,0,0,0
"14603",2018-10-01,"sbul","transporte não regular","voo doméstico",577,573,1150,1463,1299,2762,0,0,0,0
"14604",2018-10-01,"sbul","transporte não regular","voo internacional",0,0,0,0,0,0,0,0,0,0
"14605",2018-10-01,"sbur","transporte regular","voo doméstico",57,58,115,3063,3046,6109,0,0,0,0
"14606",2018-10-01,"sbur","transporte regular","voo internacional",0,0,0,0,0,0,0,0,0,0
"14607",2018-10-01,"sbur","transporte não regular","voo doméstico",174,176,350,554,557,1111,0,0,0,0
"14608",2018-10-01,"sbur","transporte não regular","voo internacional",0,0,0,0,0,0,0,0,0,0
"14609",2018-09-01,"sbbe","transporte regular","voo doméstico",1081,1081,2162,138073,135139,273212,0,0,0,0
"14610",2018-09-01,"sbbe","transporte regular","voo internacional",54,54,108,7583,6958,14541,2,286,288,0
"14611",2018-09-01,"sbbe","transporte não regular","voo doméstico",528,522,1050,924,1375,2299,0,0,0,0
"14612",2018-09-01,"sbbe","transporte não regular","voo internacional",6,4,10,0,12,12,0,0,0,0
"14613",2018-09-01,"sbbg","transporte regular","voo doméstico",0,0,0,0,0,0,0,0,0,0
"14614",2018-09-01,"sbbg","transporte regular","voo internacional",0,0,0,0,0,0,0,0,0,0
"14615",2018-09-01,"sbbg","transporte não regular","voo doméstico",11,12,23,56,52,108,0,0,0,0
"14616",2018-09-01,"sbbg","transporte não regular","voo internacional",2,1,3,8,2,10,0,0,0,0
"14617",2018-09-01,"sbbh","transporte regular","voo doméstico",0,0,0,0,0,0,0,0,0,0
"14618",2018-09-01,"sbbh","transporte regular","voo internacional",0,0,0,0,0,0,0,0,0,0
"14619",2018-09-01,"sbbh","transporte não regular","voo doméstico",1785,1782,3567,8053,8037,16090,0,0,0,0
"14620",2018-09-01,"sbbh","transporte não regular","voo internacional",6,6,12,43,43,86,0,0,0,0
"14621",2018-09-01,"sbbi","transporte regular","voo doméstico",0,0,0,0,0,0,0,0,0,0
"14622",2018-09-01,"sbbi","transporte regular","voo internacional",0,0,0,0,0,0,0,0,0,0
"14623",2018-09-01,"sbbi","transporte não regular","voo doméstico",1163,1162,2325,877,785,1662,0,0,0,0
"14624",2018-09-01,"sbbi","transporte não regular","voo internacional",1,1,2,0,0,0,0,0,0,0
"14625",2018-09-01,"sbbv","transporte regular","voo doméstico",93,93,186,14865,11844,26709,0,0,0,0
"14626",2018-09-01,"sbbv","transporte regular","voo internacional",0,0,0,0,0,0,0,0,0,0
"14627",2018-09-01,"sbbv","transporte não regular","voo doméstico",108,111,219,87,5,92,0,0,0,0
"14628",2018-09-01,"sbbv","transporte não regular","voo internacional",20,14,34,5,0,5,0,0,0,0
"14629",2018-09-01,"sbcg","transporte regular","voo doméstico",517,513,1030,61871,60454,122325,67162,79988,147150,0
"14630",2018-09-01,"sbcg","transporte regular","voo internacional",0,0,0,0,0,0,0,0,0,0
"14631",2018-09-01,"sbcg","transporte não regular","voo doméstico",265,266,531,542,744,1286,0,0,0,0
"14632",2018-09-01,"sbcg","transporte não regular","voo internacional",8,6,14,0,139,139,0,0,0,0
"14633",2018-09-01,"sbcj","transporte regular","voo doméstico",72,72,144,4699,4534,9233,0,0,0,0
"14634",2018-09-01,"sbcj","transporte regular","voo internacional",0,0,0,0,0,0,0,0,0,0
"14635",2018-09-01,"sbcj","transporte não regular","voo doméstico",91,91,182,425,84,509,0,0,0,0
"14636",2018-09-01,"sbcj","transporte não regular","voo internacional",0,0,0,0,0,0,0,0,0,0
"14637",2018-09-01,"sbcr","transporte regular","voo doméstico",19,19,38,1093,1140,2233,0,0,0,0
"14638",2018-09-01,"sbcr","transporte regular","voo internacional",0,0,0,0,0,0,0,0,0,0
"14639",2018-09-01,"sbcr","transporte não regular","voo doméstico",61,61,122,149,150,299,0,0,0,0
"14640",2018-09-01,"sbcr","transporte não regular","voo internacional",2,2,4,4,4,8,0,0,0,0
"14641",2018-09-01,"sbct","transporte regular","voo doméstico",2383,2401,4784,262533,257981,520514,108023,52843,160866,274073
"14642",2018-09-01,"sbct","transporte regular","voo internacional",75,74,149,2973,2960,5933,0,7425,7425,0
"14643",2018-09-01,"sbct","transporte não regular","voo doméstico",258,242,500,1536,2122,3658,0,39376,39376,0
"14644",2018-09-01,"sbct","transporte não regular","voo internacional",18,19,37,328,249,577,0,0,0,0
"14645",2018-09-01,"sbcz","transporte regular","voo doméstico",29,31,60,2788,1289,4077,0,0,0,0
"14646",2018-09-01,"sbcz","transporte regular","voo internacional",0,0,0,0,0,0,0,0,0,0
"14647",2018-09-01,"sbcz","transporte não regular","voo doméstico",281,276,557,1182,1119,2301,0,0,0,0
"14648",2018-09-01,"sbcz","transporte não regular","voo internacional",0,0,0,0,0,0,0,0,0,0
"14649",2018-09-01,"sbeg","transporte regular","voo doméstico",982,973,1955,113607,109835,223442,85781,280184,365965,0
"14650",2018-09-01,"sbeg","transporte regular","voo internacional",105,113,218,5044,5282,10326,0,0,0,0
"14651",2018-09-01,"sbeg","transporte não regular","voo doméstico",706,705,1411,6180,3849,10029,0,1058,1058,0
"14652",2018-09-01,"sbeg","transporte não regular","voo internacional",61,63,124,57,59,116,0,0,0,0
"14653",2018-09-01,"sbfi","transporte regular","voo doméstico",571,607,1178,84103,78808,162911,0,0,0,0
"14654",2018-09-01,"sbfi","transporte regular","voo internacional",23,22,45,3007,2615,5622,0,0,0,0
"14655",2018-09-01,"sbfi","transporte não regular","voo doméstico",191,153,344,565,6819,7384,0,0,0,0
"14656",2018-09-01,"sbfi","transporte não regular","voo internacional",43,44,87,210,60,270,0,0,0,0
"14657",2018-09-01,"sbgo","transporte regular","voo doméstico",1203,1201,2404,123692,121689,245381,195571,262954,458525,0
"14658",2018-09-01,"sbgo","transporte regular","voo internacional",0,0,0,0,0,0,0,0,0,0
"14659",2018-09-01,"sbgo","transporte não regular","voo doméstico",1797,1742,3539,5494,4412,9906,0,0,0,0
"14660",2018-09-01,"sbgo","transporte não regular","voo internacional",2,3,5,0,0,0,0,0,0,0
"14661",2018-09-01,"sbht","transporte regular","voo doméstico",75,75,150,3786,3725,7511,0,0,0,0
"14662",2018-09-01,"sbht","transporte regular","voo internacional",0,0,0,0,0,0,0,0,0,0
"14663",2018-09-01,"sbht","transporte não regular","voo doméstico",72,73,145,147,88,235,0,0,0,0
"14664",2018-09-01,"sbht","transporte não regular","voo internacional",0,0,0,0,0,0,0,0,0,0
"14665",2018-09-01,"sbiz","transporte regular","voo doméstico",96,96,192,10935,11277,22212,0,0,0,0
"14666",2018-09-01,"sbiz","transporte regular","voo internacional",0,0,0,0,0,0,0,0,0,0
"14667",2018-09-01,"sbiz","transporte não regular","voo doméstico",119,119,238,322,258,580,0,0,0,0
"14668",2018-09-01,"sbiz","transporte não regular","voo internacional",0,0,0,0,0,0,0,0,0,0
"14669",2018-09-01,"sbjc","transporte regular","voo doméstico",0,0,0,0,0,0,0,0,0,0
"14670",2018-09-01,"sbjc","transporte regular","voo internacional",0,0,0,0,0,0,0,0,0,0
"14671",2018-09-01,"sbjc","transporte não regular","voo doméstico",398,401,799,774,493,1267,0,0,0,0
"14672",2018-09-01,"sbjc","transporte não regular","voo internacional",0,0,0,0,0,0,0,0,0,0
"14673",2018-09-01,"sbjr","transporte regular","voo doméstico",0,0,0,0,0,0,0,0,0,0
"14674",2018-09-01,"sbjr","transporte regular","voo internacional",0,0,0,0,0,0,0,0,0,0
"14675",2018-09-01,"sbjr","transporte não regular","voo doméstico",2905,2906,5811,12502,6830,19332,0,0,0,0
"14676",2018-09-01,"sbjr","transporte não regular","voo internacional",1,2,3,0,0,0,0,0,0,0
"14677",2018-09-01,"sbjv","transporte regular","voo doméstico",203,205,408,21303,20409,41712,0,0,0,0
"14678",2018-09-01,"sbjv","transporte regular","voo internacional",0,0,0,0,0,0,0,0,0,0
"14679",2018-09-01,"sbjv","transporte não regular","voo doméstico",97,94,191,160,251,411,0,0,0,0
"14680",2018-09-01,"sbjv","transporte não regular","voo internacional",0,0,0,0,0,0,0,0,0,0
"14681",2018-09-01,"sblo","transporte regular","voo doméstico",439,443,882,43339,41767,85106,0,0,0,0
"14682",2018-09-01,"sblo","transporte regular","voo internacional",0,0,0,0,0,0,0,0,0,0
"14683",2018-09-01,"sblo","transporte não regular","voo doméstico",540,532,1072,260,893,1153,0,0,0,0
"14684",2018-09-01,"sblo","transporte não regular","voo internacional",4,4,8,0,0,0,0,0,0,0
"14685",2018-09-01,"sbma","transporte regular","voo doméstico",126,125,251,11673,10943,22616,0,0,0,0
"14686",2018-09-01,"sbma","transporte regular","voo internacional",0,0,0,0,0,0,0,0,0,0
"14687",2018-09-01,"sbma","transporte não regular","voo doméstico",195,197,392,577,529,1106,0,0,0,0
"14688",2018-09-01,"sbma","transporte não regular","voo internacional",2,1,3,0,0,0,0,0,0,0
"14689",2018-09-01,"sbmk","transporte regular","voo doméstico",133,133,266,9427,8290,17717,0,0,0,0
"14690",2018-09-01,"sbmk","transporte regular","voo internacional",0,0,0,0,0,0,0,0,0,0
"14691",2018-09-01,"sbmk","transporte não regular","voo doméstico",287,288,575,484,3,487,0,0,0,0
"14692",2018-09-01,"sbmk","transporte não regular","voo internacional",0,0,0,0,0,0,0,0,0,0
"14693",2018-09-01,"sbmq","transporte regular","voo doméstico",187,183,370,22315,21308,43623,14520,30940,45460,0
"14694",2018-09-01,"sbmq","transporte regular","voo internacional",0,0,0,0,0,0,0,0,0,0
"14695",2018-09-01,"sbmq","transporte não regular","voo doméstico",154,158,312,660,284,944,0,0,0,0
"14696",2018-09-01,"sbmq","transporte não regular","voo internacional",1,1,2,0,0,0,0,0,0,0
"14697",2018-09-01,"sbmt","transporte regular","voo doméstico",0,0,0,0,0,0,0,0,0,0
"14698",2018-09-01,"sbmt","transporte regular","voo internacional",0,0,0,0,0,0,0,0,0,0
"14699",2018-09-01,"sbmt","transporte não regular","voo doméstico",2881,2886,5767,4792,4828,9620,0,0,0,0
"14700",2018-09-01,"sbmt","transporte não regular","voo internacional",0,0,0,0,0,0,0,0,0,0
"14701",2018-09-01,"sbnf","transporte regular","voo doméstico",595,594,1189,69994,70657,140651,0,0,0,0
"14702",2018-09-01,"sbnf","transporte regular","voo internacional",13,12,25,1212,1338,2550,0,0,0,0
"14703",2018-09-01,"sbnf","transporte não regular","voo doméstico",240,239,479,537,1080,1617,0,0,0,0
"14704",2018-09-01,"sbnf","transporte não regular","voo internacional",1,2,3,7,3,10,0,0,0,0
"14705",2018-09-01,"sbpb","transporte regular","voo doméstico",5,5,10,362,406,768,0,0,0,0
"14706",2018-09-01,"sbpb","transporte regular","voo internacional",0,0,0,0,0,0,0,0,0,0
"14707",2018-09-01,"sbpb","transporte não regular","voo doméstico",96,96,192,243,242,485,0,0,0,0
"14708",2018-09-01,"sbpb","transporte não regular","voo internacional",0,0,0,0,0,0,0,0,0,0
"14709",2018-09-01,"sbpj","transporte regular","voo doméstico",255,255,510,26989,26300,53289,0,0,0,0
"14710",2018-09-01,"sbpj","transporte regular","voo internacional",0,0,0,0,0,0,0,0,0,0
"14711",2018-09-01,"sbpj","transporte não regular","voo doméstico",377,379,756,634,265,899,0,0,0,0
"14712",2018-09-01,"sbpj","transporte não regular","voo internacional",0,0,0,0,0,0,0,0,0,0
"14713",2018-09-01,"sbpk","transporte regular","voo doméstico",22,22,44,1346,1258,2604,0,0,0,0
"14714",2018-09-01,"sbpk","transporte regular","voo internacional",0,0,0,0,0,0,0,0,0,0
"14715",2018-09-01,"sbpk","transporte não regular","voo doméstico",31,31,62,157,135,292,0,0,0,0
"14716",2018-09-01,"sbpk","transporte não regular","voo internacional",1,3,4,9,8,17,0,0,0,0
"14717",2018-09-01,"sbpl","transporte regular","voo doméstico",157,156,313,18750,17674,36424,0,0,0,0
"14718",2018-09-01,"sbpl","transporte regular","voo internacional",3,3,6,0,0,0,0,0,0,0
"14719",2018-09-01,"sbpl","transporte não regular","voo doméstico",140,139,279,389,374,763,0,0,0,0
"14720",2018-09-01,"sbpl","transporte não regular","voo internacional",0,0,0,0,0,0,0,0,0,0
"14721",2018-09-01,"sbpp","transporte regular","voo doméstico",0,0,0,0,0,0,0,0,0,0
"14722",2018-09-01,"sbpp","transporte regular","voo internacional",0,0,0,0,0,0,0,0,0,0
"14723",2018-09-01,"sbpp","transporte não regular","voo doméstico",93,93,186,139,151,290,0,0,0,0
"14724",2018-09-01,"sbpp","transporte não regular","voo internacional",5,5,10,9,5,14,0,0,0,0
"14725",2018-09-01,"sbpr","transporte regular","voo doméstico",0,0,0,0,0,0,0,0,0,0
"14726",2018-09-01,"sbpr","transporte regular","voo internacional",0,0,0,0,0,0,0,0,0,0
"14727",2018-09-01,"sbpr","transporte não regular","voo doméstico",891,882,1773,1126,1049,2175,0,0,0,0
"14728",2018-09-01,"sbpr","transporte não regular","voo internacional",0,0,0,0,0,0,0,0,0,0
"14729",2018-09-01,"sbpv","transporte regular","voo doméstico",312,310,622,32700,31086,63786,0,12076,12076,0
"14730",2018-09-01,"sbpv","transporte regular","voo internacional",0,0,0,0,0,0,0,0,0,0
"14731",2018-09-01,"sbpv","transporte não regular","voo doméstico",341,344,685,145,0,145,0,4217,4217,0
"14732",2018-09-01,"sbpv","transporte não regular","voo internacional",0,0,0,0,0,0,0,0,0,0
"14733",2018-09-01,"sbrb","transporte regular","voo doméstico",169,169,338,16510,13653,30163,0,0,0,0
"14734",2018-09-01,"sbrb","transporte regular","voo internacional",0,0,0,0,0,0,0,0,0,0
"14735",2018-09-01,"sbrb","transporte não regular","voo doméstico",177,179,356,378,222,600,0,0,0,0
"14736",2018-09-01,"sbrb","transporte não regular","voo internacional",0,0,0,0,0,0,0,0,0,0
"14737",2018-09-01,"sbrj","transporte regular","voo doméstico",3506,3520,7026,378367,380758,759125,0,0,0,0
"14738",2018-09-01,"sbrj","transporte regular","voo internacional",0,0,0,0,0,0,0,0,0,0
"14739",2018-09-01,"sbrj","transporte não regular","voo doméstico",562,553,1115,970,651,1621,0,0,0,0
"14740",2018-09-01,"sbrj","transporte não regular","voo internacional",0,0,0,0,0,0,0,0,0,0
"14741",2018-09-01,"sbsj","transporte regular","voo doméstico",18,18,36,1053,983,2036,0,0,0,0
"14742",2018-09-01,"sbsj","transporte regular","voo internacional",0,0,0,0,0,0,0,0,0,0
"14743",2018-09-01,"sbsj","transporte não regular","voo doméstico",488,474,962,1877,1621,3498,0,0,0,0
"14744",2018-09-01,"sbsj","transporte não regular","voo internacional",4,12,16,25,17,42,0,0,0,0
"14745",2018-09-01,"sbsl","transporte regular","voo doméstico",524,522,1046,64611,62429,127040,0,0,0,0
"14746",2018-09-01,"sbsl","transporte regular","voo internacional",0,0,0,0,0,0,0,0,0,0
"14747",2018-09-01,"sbsl","transporte não regular","voo doméstico",352,351,703,275,183,458,0,0,0,0
"14748",2018-09-01,"sbsl","transporte não regular","voo internacional",1,1,2,0,0,0,0,0,0,0
"14749",2018-09-01,"sbsn","transporte regular","voo doméstico",227,225,452,21314,18935,40249,0,0,0,0
"14750",2018-09-01,"sbsn","transporte regular","voo internacional",0,0,0,0,0,0,0,0,0,0
"14751",2018-09-01,"sbsn","transporte não regular","voo doméstico",201,207,408,702,449,1151,4010,6700,10710,0
"14752",2018-09-01,"sbsn","transporte não regular","voo internacional",0,0,0,0,0,0,0,0,0,0
"14753",2018-09-01,"sbsp","transporte regular","voo doméstico",7089,7137,14226,893699,880855,1774554,0,0,0,0
"14754",2018-09-01,"sbsp","transporte regular","voo internacional",0,0,0,0,0,0,0,0,0,0
"14755",2018-09-01,"sbsp","transporte não regular","voo doméstico",2117,2038,4155,7663,7347,15010,0,0,0,0
"14756",2018-09-01,"sbsp","transporte não regular","voo internacional",4,6,10,15,8,23,0,0,0,0
"14757",2018-09-01,"sbte","transporte regular","voo doméstico",349,349,698,43620,42525,86145,0,0,0,0
"14758",2018-09-01,"sbte","transporte regular","voo internacional",0,0,0,0,0,0,0,0,0,0
"14759",2018-09-01,"sbte","transporte não regular","voo doméstico",286,282,568,1558,1589,3147,0,0,0,0
"14760",2018-09-01,"sbte","transporte não regular","voo internacional",0,0,0,0,0,0,0,0,0,0
"14761",2018-09-01,"sbtf","transporte regular","voo doméstico",33,33,66,1154,1244,2398,0,0,0,0
"14762",2018-09-01,"sbtf","transporte regular","voo internacional",0,0,0,0,0,0,0,0,0,0
"14763",2018-09-01,"sbtf","transporte não regular","voo doméstico",132,132,264,274,271,545,700,305,1005,615
"14764",2018-09-01,"sbtf","transporte não regular","voo internacional",0,0,0,0,0,0,0,0,0,0
"14765",2018-09-01,"sbtt","transporte regular","voo doméstico",29,29,58,2316,2727,5043,0,0,0,0
"14766",2018-09-01,"sbtt","transporte regular","voo internacional",0,0,0,0,0,0,0,0,0,0
"14767",2018-09-01,"sbtt","transporte não regular","voo doméstico",116,117,233,643,623,1266,587,534,1121,0
"14768",2018-09-01,"sbtt","transporte não regular","voo internacional",0,0,0,0,0,0,0,0,0,0
"14769",2018-09-01,"sbuf","transporte regular","voo doméstico",8,7,15,426,464,890,0,0,0,0
"14770",2018-09-01,"sbuf","transporte regular","voo internacional",0,0,0,0,0,0,0,0,0,0
"14771",2018-09-01,"sbuf","transporte não regular","voo doméstico",34,35,69,165,103,268,0,0,0,0
"14772",2018-09-01,"sbuf","transporte não regular","voo internacional",0,0,0,0,0,0,0,0,0,0
"14773",2018-09-01,"sbug","transporte regular","voo doméstico",17,17,34,857,835,1692,0,0,0,0
"14774",2018-09-01,"sbug","transporte regular","voo internacional",0,0,0,0,0,0,0,0,0,0
"14775",2018-09-01,"sbug","transporte não regular","voo doméstico",11,11,22,20,25,45,0,0,0,0
"14776",2018-09-01,"sbug","transporte não regular","voo internacional",0,0,0,0,0,0,0,0,0,0
"14777",2018-09-01,"sbul","transporte regular","voo doméstico",532,531,1063,47406,46985,94391,0,146,146,0
"14778",2018-09-01,"sbul","transporte regular","voo internacional",0,0,0,0,0,0,0,0,0,0
"14779",2018-09-01,"sbul","transporte não regular","voo doméstico",519,522,1041,1351,1148,2499,0,0,0,0
"14780",2018-09-01,"sbul","transporte não regular","voo internacional",1,1,2,5,5,10,0,0,0,0
"14781",2018-09-01,"sbur","transporte regular","voo doméstico",57,58,115,3230,3193,6423,0,0,0,0
"14782",2018-09-01,"sbur","transporte regular","voo internacional",0,0,0,0,0,0,0,0,0,0
"14783",2018-09-01,"sbur","transporte não regular","voo doméstico",195,190,385,663,695,1358,0,0,0,0
"14784",2018-09-01,"sbur","transporte não regular","voo internacional",2,2,4,0,0,0,0,0,0,0
"14785",2019-04-01,"sbbe","transporte regular","voo doméstico",996,1011,2007,128940,125103,254043,0,0,0,0
"14786",2019-04-01,"sbbe","transporte regular","voo internacional",52,51,103,6576,5800,12376,2,4,6,0
"14787",2019-04-01,"sbbe","transporte não regular","voo doméstico",377,369,746,724,1886,2610,0,0,0,0
"14788",2019-04-01,"sbbe","transporte não regular","voo internacional",14,15,29,20,18,38,0,0,0,0
"14789",2019-04-01,"sbbg","transporte regular","voo doméstico",0,0,0,0,0,0,0,0,0,0
"14790",2019-04-01,"sbbg","transporte regular","voo internacional",0,0,0,0,0,0,0,0,0,0
"14791",2019-04-01,"sbbg","transporte não regular","voo doméstico",15,15,30,68,68,136,0,0,0,0
"14792",2019-04-01,"sbbg","transporte não regular","voo internacional",1,1,2,4,4,8,0,0,0,0
"14793",2019-04-01,"sbbh","transporte regular","voo doméstico",0,0,0,0,0,0,0,0,0,0
"14794",2019-04-01,"sbbh","transporte regular","voo internacional",0,0,0,0,0,0,0,0,0,0
"14795",2019-04-01,"sbbh","transporte não regular","voo doméstico",1551,1555,3106,7984,7935,15919,0,0,0,0
"14796",2019-04-01,"sbbh","transporte não regular","voo internacional",2,2,4,9,9,18,0,0,0,0
"14797",2019-04-01,"sbbi","transporte regular","voo doméstico",0,0,0,0,0,0,0,0,0,0
"14798",2019-04-01,"sbbi","transporte regular","voo internacional",0,0,0,0,0,0,0,0,0,0
"14799",2019-04-01,"sbbi","transporte não regular","voo doméstico",1125,1125,2250,893,806,1699,0,0,0,0
"14800",2019-04-01,"sbbi","transporte não regular","voo internacional",0,2,2,0,0,0,0,0,0,0
"14801",2019-04-01,"sbbv","transporte regular","voo doméstico",97,97,194,15175,11665,26840,0,0,0,0
"14802",2019-04-01,"sbbv","transporte regular","voo internacional",0,0,0,0,0,0,0,0,0,0
"14803",2019-04-01,"sbbv","transporte não regular","voo doméstico",100,110,210,90,36,126,0,0,0,0
"14804",2019-04-01,"sbbv","transporte não regular","voo internacional",20,12,32,3,0,3,0,0,0,0
"14805",2019-04-01,"sbcg","transporte regular","voo doméstico",500,508,1008,61581,61410,122991,55928,84052,139980,0
"14806",2019-04-01,"sbcg","transporte regular","voo internacional",0,0,0,0,0,0,0,0,0,0
"14807",2019-04-01,"sbcg","transporte não regular","voo doméstico",234,231,465,221,1049,1270,0,0,0,0
"14808",2019-04-01,"sbcg","transporte não regular","voo internacional",8,7,15,0,2,2,0,0,0,0
"14809",2019-04-01,"sbcj","transporte regular","voo doméstico",81,81,162,5453,6956,12409,0,0,0,0
"14810",2019-04-01,"sbcj","transporte regular","voo internacional",0,0,0,0,0,0,0,0,0,0
"14811",2019-04-01,"sbcj","transporte não regular","voo doméstico",89,89,178,1117,309,1426,0,0,0,0
"14812",2019-04-01,"sbcj","transporte não regular","voo internacional",0,0,0,0,0,0,0,0,0,0
"14813",2019-04-01,"sbcr","transporte regular","voo doméstico",20,20,40,1167,1844,3011,0,0,0,0
"14814",2019-04-01,"sbcr","transporte regular","voo internacional",0,0,0,0,0,0,0,0,0,0
"14815",2019-04-01,"sbcr","transporte não regular","voo doméstico",48,48,96,61,51,112,0,0,0,0
"14816",2019-04-01,"sbcr","transporte não regular","voo internacional",1,1,2,1,1,2,0,0,0,0
"14817",2019-04-01,"sbct","transporte regular","voo doméstico",2289,2299,4588,264411,256585,520996,104381,51924,156305,82021
"14818",2019-04-01,"sbct","transporte regular","voo internacional",73,72,145,3134,2907,6041,106511,21782,128293,964
"14819",2019-04-01,"sbct","transporte não regular","voo doméstico",276,266,542,1472,2220,3692,0,0,0,13076
"14820",2019-04-01,"sbct","transporte não regular","voo internacional",24,21,45,67,41,108,0,0,0,0
"14821",2019-04-01,"sbcz","transporte regular","voo doméstico",28,28,56,2127,625,2752,0,0,0,0
"14822",2019-04-01,"sbcz","transporte regular","voo internacional",0,0,0,0,0,0,0,0,0,0
"14823",2019-04-01,"sbcz","transporte não regular","voo doméstico",146,143,289,484,517,1001,0,0,0,0
"14824",2019-04-01,"sbcz","transporte não regular","voo internacional",0,0,0,0,0,0,0,0,0,0
"14825",2019-04-01,"sbeg","transporte regular","voo doméstico",898,887,1785,105327,102250,207577,138764,202674,341438,0
"14826",2019-04-01,"sbeg","transporte regular","voo internacional",90,92,182,4606,4528,9134,0,0,0,0
"14827",2019-04-01,"sbeg","transporte não regular","voo doméstico",409,420,829,3945,2962,6907,6525,12797,19322,0
"14828",2019-04-01,"sbeg","transporte não regular","voo internacional",72,70,142,243,81,324,0,0,0,0
"14829",2019-04-01,"sbfi","transporte regular","voo doméstico",557,556,1113,81320,78815,160135,0,0,0,0
"14830",2019-04-01,"sbfi","transporte regular","voo internacional",21,21,42,2678,2252,4930,0,0,0,0
"14831",2019-04-01,"sbfi","transporte não regular","voo doméstico",122,121,243,1074,1101,2175,0,0,0,0
"14832",2019-04-01,"sbfi","transporte não regular","voo internacional",44,46,90,114,120,234,0,0,0,0
"14833",2019-04-01,"sbgo","transporte regular","voo doméstico",1269,1268,2537,133523,135670,269193,195451,243938,439389,0
"14834",2019-04-01,"sbgo","transporte regular","voo internacional",0,0,0,0,0,0,0,0,0,0
"14835",2019-04-01,"sbgo","transporte não regular","voo doméstico",1356,1383,2739,5032,4717,9749,0,0,0,0
"14836",2019-04-01,"sbgo","transporte não regular","voo internacional",2,2,4,0,0,0,0,0,0,0
"14837",2019-04-01,"sbht","transporte regular","voo doméstico",78,78,156,3851,3779,7630,0,0,0,0
"14838",2019-04-01,"sbht","transporte regular","voo internacional",0,0,0,0,0,0,0,0,0,0
"14839",2019-04-01,"sbht","transporte não regular","voo doméstico",36,36,72,48,17,65,0,0,0,0
"14840",2019-04-01,"sbht","transporte não regular","voo internacional",0,0,0,0,0,0,0,0,0,0
"14841",2019-04-01,"sbiz","transporte regular","voo doméstico",111,111,222,12943,12159,25102,0,0,0,0
"14842",2019-04-01,"sbiz","transporte regular","voo internacional",0,0,0,0,0,0,0,0,0,0
"14843",2019-04-01,"sbiz","transporte não regular","voo doméstico",46,43,89,74,94,168,0,0,0,0
"14844",2019-04-01,"sbiz","transporte não regular","voo internacional",0,0,0,0,0,0,0,0,0,0
"14845",2019-04-01,"sbjc","transporte regular","voo doméstico",0,0,0,0,0,0,0,0,0,0
"14846",2019-04-01,"sbjc","transporte regular","voo internacional",0,0,0,0,0,0,0,0,0,0
"14847",2019-04-01,"sbjc","transporte não regular","voo doméstico",206,200,406,376,200,576,0,0,0,0
"14848",2019-04-01,"sbjc","transporte não regular","voo internacional",0,0,0,0,0,0,0,0,0,0
"14849",2019-04-01,"sbjr","transporte regular","voo doméstico",0,0,0,0,0,0,0,0,0,0
"14850",2019-04-01,"sbjr","transporte regular","voo internacional",0,0,0,0,0,0,0,0,0,0
"14851",2019-04-01,"sbjr","transporte não regular","voo doméstico",2998,2988,5986,10350,21,10371,0,0,0,0
"14852",2019-04-01,"sbjr","transporte não regular","voo internacional",8,10,18,2,0,2,0,0,0,0
"14853",2019-04-01,"sbjv","transporte regular","voo doméstico",207,207,414,21937,21271,43208,0,0,0,0
"14854",2019-04-01,"sbjv","transporte regular","voo internacional",0,0,0,0,0,0,0,0,0,0
"14855",2019-04-01,"sbjv","transporte não regular","voo doméstico",62,63,125,89,69,158,0,0,0,0
"14856",2019-04-01,"sbjv","transporte não regular","voo internacional",0,0,0,0,0,0,0,0,0,0
"14857",2019-04-01,"sblo","transporte regular","voo doméstico",431,428,859,42027,43624,85651,0,0,0,0
"14858",2019-04-01,"sblo","transporte regular","voo internacional",0,0,0,0,0,0,0,0,0,0
"14859",2019-04-01,"sblo","transporte não regular","voo doméstico",373,383,756,310,118,428,0,0,0,0
"14860",2019-04-01,"sblo","transporte não regular","voo internacional",4,4,8,6,0,6,0,0,0,0
"14861",2019-04-01,"sbma","transporte regular","voo doméstico",112,112,224,10051,10887,20938,0,0,0,0
"14862",2019-04-01,"sbma","transporte regular","voo internacional",0,0,0,0,0,0,0,0,0,0
"14863",2019-04-01,"sbma","transporte não regular","voo doméstico",139,137,276,369,353,722,0,0,0,0
"14864",2019-04-01,"sbma","transporte não regular","voo internacional",0,0,0,0,0,0,0,0,0,0
"14865",2019-04-01,"sbmk","transporte regular","voo doméstico",129,129,258,9426,9229,18655,0,0,0,0
"14866",2019-04-01,"sbmk","transporte regular","voo internacional",0,0,0,0,0,0,0,0,0,0
"14867",2019-04-01,"sbmk","transporte não regular","voo doméstico",153,157,310,375,128,503,0,0,0,0
"14868",2019-04-01,"sbmk","transporte não regular","voo internacional",0,0,0,0,0,0,0,0,0,0
"14869",2019-04-01,"sbmq","transporte regular","voo doméstico",154,164,318,19808,16802,36610,16710,34020,50730,0
"14870",2019-04-01,"sbmq","transporte regular","voo internacional",0,0,0,0,0,0,0,0,0,0
"14871",2019-04-01,"sbmq","transporte não regular","voo doméstico",133,123,256,1356,2341,3697,0,0,0,0
"14872",2019-04-01,"sbmq","transporte não regular","voo internacional",2,2,4,0,0,0,0,0,0,0
"14873",2019-04-01,"sbmt","transporte regular","voo doméstico",0,0,0,0,0,0,0,0,0,0
"14874",2019-04-01,"sbmt","transporte regular","voo internacional",0,0,0,0,0,0,0,0,0,0
"14875",2019-04-01,"sbmt","transporte não regular","voo doméstico",2776,2778,5554,4507,4532,9039,0,0,0,0
"14876",2019-04-01,"sbmt","transporte não regular","voo internacional",0,0,0,0,0,0,0,0,0,0
"14877",2019-04-01,"sbnf","transporte regular","voo doméstico",602,598,1200,73049,73030,146079,0,0,0,0
"14878",2019-04-01,"sbnf","transporte regular","voo internacional",6,6,12,641,582,1223,0,0,0,0
"14879",2019-04-01,"sbnf","transporte não regular","voo doméstico",289,296,585,651,793,1444,0,0,0,0
"14880",2019-04-01,"sbnf","transporte não regular","voo internacional",9,9,18,30,16,46,0,0,0,0
"14881",2019-04-01,"sbpb","transporte regular","voo doméstico",4,4,8,252,417,669,0,0,0,0
"14882",2019-04-01,"sbpb","transporte regular","voo internacional",0,0,0,0,0,0,0,0,0,0
"14883",2019-04-01,"sbpb","transporte não regular","voo doméstico",35,35,70,114,102,216,0,0,0,0
"14884",2019-04-01,"sbpb","transporte não regular","voo internacional",0,0,0,0,0,0,0,0,0,0
"14885",2019-04-01,"sbpj","transporte regular","voo doméstico",246,246,492,23351,23081,46432,0,0,0,0
"14886",2019-04-01,"sbpj","transporte regular","voo internacional",0,0,0,0,0,0,0,0,0,0
"14887",2019-04-01,"sbpj","transporte não regular","voo doméstico",217,219,436,478,187,665,0,0,0,0
"14888",2019-04-01,"sbpj","transporte não regular","voo internacional",1,1,2,0,0,0,0,0,0,0
"14889",2019-04-01,"sbpk","transporte regular","voo doméstico",23,23,46,1207,1185,2392,0,0,0,0
"14890",2019-04-01,"sbpk","transporte regular","voo internacional",0,0,0,0,0,0,0,0,0,0
"14891",2019-04-01,"sbpk","transporte não regular","voo doméstico",42,39,81,104,109,213,0,0,0,0
"14892",2019-04-01,"sbpk","transporte não regular","voo internacional",1,5,6,5,0,5,0,0,0,0
"14893",2019-04-01,"sbpl","transporte regular","voo doméstico",100,100,200,12826,12903,25729,0,0,0,0
"14894",2019-04-01,"sbpl","transporte regular","voo internacional",5,5,10,0,0,0,0,0,0,0
"14895",2019-04-01,"sbpl","transporte não regular","voo doméstico",61,59,120,96,97,193,0,0,0,0
"14896",2019-04-01,"sbpl","transporte não regular","voo internacional",0,0,0,0,0,0,0,0,0,0
"14897",2019-04-01,"sbpp","transporte regular","voo doméstico",0,0,0,0,0,0,0,0,0,0
"14898",2019-04-01,"sbpp","transporte regular","voo internacional",0,0,0,0,0,0,0,0,0,0
"14899",2019-04-01,"sbpp","transporte não regular","voo doméstico",93,91,184,129,127,256,0,0,0,0
"14900",2019-04-01,"sbpp","transporte não regular","voo internacional",5,5,10,10,9,19,0,0,0,0
"14901",2019-04-01,"sbpr","transporte regular","voo doméstico",0,0,0,0,0,0,0,0,0,0
"14902",2019-04-01,"sbpr","transporte regular","voo internacional",0,0,0,0,0,0,0,0,0,0
"14903",2019-04-01,"sbpr","transporte não regular","voo doméstico",873,874,1747,957,897,1854,0,0,0,0
"14904",2019-04-01,"sbpr","transporte não regular","voo internacional",0,0,0,0,0,0,0,0,0,0
"14905",2019-04-01,"sbpv","transporte regular","voo doméstico",255,255,510,30021,28213,58234,0,0,0,0
"14906",2019-04-01,"sbpv","transporte regular","voo internacional",0,0,0,0,0,0,0,0,0,0
"14907",2019-04-01,"sbpv","transporte não regular","voo doméstico",177,174,351,255,0,255,0,0,0,0
"14908",2019-04-01,"sbpv","transporte não regular","voo internacional",0,0,0,0,0,0,0,0,0,0
"14909",2019-04-01,"sbrb","transporte regular","voo doméstico",131,133,264,13211,12800,26011,0,0,0,0
"14910",2019-04-01,"sbrb","transporte regular","voo internacional",0,0,0,0,0,0,0,0,0,0
"14911",2019-04-01,"sbrb","transporte não regular","voo doméstico",133,131,264,379,441,820,0,0,0,0
"14912",2019-04-01,"sbrb","transporte não regular","voo internacional",2,3,5,15,0,15,0,0,0,0
"14913",2019-04-01,"sbrj","transporte regular","voo doméstico",3542,3567,7109,395285,388587,783872,0,0,0,0
"14914",2019-04-01,"sbrj","transporte regular","voo internacional",0,0,0,0,0,0,0,0,0,0
"14915",2019-04-01,"sbrj","transporte não regular","voo doméstico",525,497,1022,1419,793,2212,0,0,0,0
"14916",2019-04-01,"sbrj","transporte não regular","voo internacional",2,2,4,5,0,5,0,0,0,0
"14917",2019-04-01,"sbsj","transporte regular","voo doméstico",43,43,86,2193,2004,4197,0,0,0,0
"14918",2019-04-01,"sbsj","transporte regular","voo internacional",0,0,0,0,0,0,0,0,0,0
"14919",2019-04-01,"sbsj","transporte não regular","voo doméstico",412,411,823,1456,1583,3039,0,0,0,0
"14920",2019-04-01,"sbsj","transporte não regular","voo internacional",1,12,13,19,3,22,0,0,0,0
"14921",2019-04-01,"sbsl","transporte regular","voo doméstico",502,502,1004,62510,64592,127102,0,0,0,0
"14922",2019-04-01,"sbsl","transporte regular","voo internacional",0,0,0,0,0,0,0,0,0,0
"14923",2019-04-01,"sbsl","transporte não regular","voo doméstico",190,194,384,237,346,583,0,0,0,0
"14924",2019-04-01,"sbsl","transporte não regular","voo internacional",1,1,2,0,0,0,0,0,0,0
"14925",2019-04-01,"sbsn","transporte regular","voo doméstico",190,182,372,13566,16415,29981,0,0,0,0
"14926",2019-04-01,"sbsn","transporte regular","voo internacional",0,0,0,0,0,0,0,0,0,0
"14927",2019-04-01,"sbsn","transporte não regular","voo doméstico",198,200,398,1633,468,2101,3500,6680,10180,0
"14928",2019-04-01,"sbsn","transporte não regular","voo internacional",0,0,0,0,0,0,0,0,0,0
"14929",2019-04-01,"sbsp","transporte regular","voo doméstico",7009,7092,14101,925689,915440,1841129,0,0,0,0
"14930",2019-04-01,"sbsp","transporte regular","voo internacional",0,0,0,0,0,0,0,0,0,0
"14931",2019-04-01,"sbsp","transporte não regular","voo doméstico",1913,1816,3729,6413,6386,12799,0,0,0,0
"14932",2019-04-01,"sbsp","transporte não regular","voo internacional",9,10,19,12,12,24,0,0,0,0
"14933",2019-04-01,"sbte","transporte regular","voo doméstico",362,360,722,46490,47259,93749,0,0,0,0
"14934",2019-04-01,"sbte","transporte regular","voo internacional",0,0,0,0,0,0,0,0,0,0
"14935",2019-04-01,"sbte","transporte não regular","voo doméstico",120,121,241,797,678,1475,0,0,0,0
"14936",2019-04-01,"sbte","transporte não regular","voo internacional",1,1,2,8,0,8,0,0,0,0
"14937",2019-04-01,"sbtf","transporte regular","voo doméstico",31,31,62,1214,1177,2391,0,0,0,0
"14938",2019-04-01,"sbtf","transporte regular","voo internacional",0,0,0,0,0,0,0,0,0,0
"14939",2019-04-01,"sbtf","transporte não regular","voo doméstico",99,97,196,182,92,274,947,435,1382,1300
"14940",2019-04-01,"sbtf","transporte não regular","voo internacional",0,0,0,0,0,0,0,0,0,0
"14941",2019-04-01,"sbtt","transporte regular","voo doméstico",30,30,60,2376,2507,4883,0,0,0,0
"14942",2019-04-01,"sbtt","transporte regular","voo internacional",0,0,0,0,0,0,0,0,0,0
"14943",2019-04-01,"sbtt","transporte não regular","voo doméstico",72,72,144,329,302,631,712,916,1628,0
"14944",2019-04-01,"sbtt","transporte não regular","voo internacional",0,0,0,0,0,0,0,0,0,0
"14945",2019-04-01,"sbuf","transporte regular","voo doméstico",9,9,18,549,528,1077,0,0,0,0
"14946",2019-04-01,"sbuf","transporte regular","voo internacional",0,0,0,0,0,0,0,0,0,0
"14947",2019-04-01,"sbuf","transporte não regular","voo doméstico",18,17,35,24,13,37,0,0,0,0
"14948",2019-04-01,"sbuf","transporte não regular","voo internacional",0,0,0,0,0,0,0,0,0,0
"14949",2019-04-01,"sbug","transporte regular","voo doméstico",15,15,30,880,625,1505,0,0,0,0
"14950",2019-04-01,"sbug","transporte regular","voo internacional",0,0,0,0,0,0,0,0,0,0
"14951",2019-04-01,"sbug","transporte não regular","voo doméstico",5,6,11,15,7,22,0,0,0,0
"14952",2019-04-01,"sbug","transporte não regular","voo internacional",1,1,2,0,0,0,0,0,0,0
"14953",2019-04-01,"sbul","transporte regular","voo doméstico",491,491,982,47078,45717,92795,0,0,0,0
"14954",2019-04-01,"sbul","transporte regular","voo internacional",0,0,0,0,0,0,0,0,0,0
"14955",2019-04-01,"sbul","transporte não regular","voo doméstico",434,438,872,1093,822,1915,0,0,0,0
"14956",2019-04-01,"sbul","transporte não regular","voo internacional",1,1,2,6,4,10,0,0,0,0
"14957",2019-04-01,"sbur","transporte regular","voo doméstico",56,56,112,3070,3230,6300,0,0,0,0
"14958",2019-04-01,"sbur","transporte regular","voo internacional",0,0,0,0,0,0,0,0,0,0
"14959",2019-04-01,"sbur","transporte não regular","voo doméstico",245,237,482,875,900,1775,0,0,0,0
"14960",2019-04-01,"sbur","transporte não regular","voo internacional",2,1,3,0,0,0,0,0,0,0
"14961",2019-08-01,"sbbe","transporte regular","voo doméstico",1068,1073,2141,143725,144030,287755,0,0,0,0
"14962",2019-08-01,"sbbe","transporte regular","voo internacional",59,61,120,8440,8016,16456,0,3,3,0
"14963",2019-08-01,"sbbe","transporte não regular","voo doméstico",507,503,1010,1730,3118,4848,0,0,0,0
"14964",2019-08-01,"sbbe","transporte não regular","voo internacional",18,13,31,6,24,30,0,0,0,0
"14965",2019-08-01,"sbbg","transporte regular","voo doméstico",0,0,0,0,0,0,0,0,0,0
"14966",2019-08-01,"sbbg","transporte regular","voo internacional",0,0,0,0,0,0,0,0,0,0
"14967",2019-08-01,"sbbg","transporte não regular","voo doméstico",17,17,34,75,90,165,0,0,0,0
"14968",2019-08-01,"sbbg","transporte não regular","voo internacional",2,2,4,9,0,9,0,0,0,0
"14969",2019-08-01,"sbbh","transporte regular","voo doméstico",21,22,43,120,129,249,0,0,0,0
"14970",2019-08-01,"sbbh","transporte regular","voo internacional",0,0,0,0,0,0,0,0,0,0
"14971",2019-08-01,"sbbh","transporte não regular","voo doméstico",1394,1399,2793,7124,7232,14356,0,0,0,0
"14972",2019-08-01,"sbbh","transporte não regular","voo internacional",13,12,25,66,70,136,0,0,0,0
"14973",2019-08-01,"sbbi","transporte regular","voo doméstico",0,0,0,0,0,0,0,0,0,0
"14974",2019-08-01,"sbbi","transporte regular","voo internacional",0,0,0,0,0,0,0,0,0,0
"14975",2019-08-01,"sbbi","transporte não regular","voo doméstico",1196,1202,2398,1082,1026,2108,0,0,0,0
"14976",2019-08-01,"sbbi","transporte não regular","voo internacional",2,2,4,0,0,0,0,0,0,0
"14977",2019-08-01,"sbbv","transporte regular","voo doméstico",103,103,206,17034,13780,30814,0,0,0,0
"14978",2019-08-01,"sbbv","transporte regular","voo internacional",0,0,0,0,0,0,0,0,0,0
"14979",2019-08-01,"sbbv","transporte não regular","voo doméstico",129,122,251,114,36,150,0,0,0,0
"14980",2019-08-01,"sbbv","transporte não regular","voo internacional",10,13,23,0,0,0,0,0,0,0
"14981",2019-08-01,"sbcg","transporte regular","voo doméstico",550,548,1098,62584,62741,125325,60290,80474,140764,0
"14982",2019-08-01,"sbcg","transporte regular","voo internacional",0,0,0,0,0,0,0,0,0,0
"14983",2019-08-01,"sbcg","transporte não regular","voo doméstico",241,244,485,270,273,543,0,0,0,0
"14984",2019-08-01,"sbcg","transporte não regular","voo internacional",13,12,25,13,0,13,0,0,0,0
"14985",2019-08-01,"sbcj","transporte regular","voo doméstico",86,87,173,6620,8075,14695,0,0,0,0
"14986",2019-08-01,"sbcj","transporte regular","voo internacional",0,0,0,0,0,0,0,0,0,0
"14987",2019-08-01,"sbcj","transporte não regular","voo doméstico",97,96,193,838,255,1093,0,0,0,0
"14988",2019-08-01,"sbcj","transporte não regular","voo internacional",0,0,0,0,0,0,0,0,0,0
"14989",2019-08-01,"sbcr","transporte regular","voo doméstico",21,21,42,1156,1865,3021,0,0,0,0
"14990",2019-08-01,"sbcr","transporte regular","voo internacional",0,0,0,0,0,0,0,0,0,0
"14991",2019-08-01,"sbcr","transporte não regular","voo doméstico",34,33,67,79,62,141,0,0,0,0
"14992",2019-08-01,"sbcr","transporte não regular","voo internacional",0,0,0,0,0,0,0,0,0,0
"14993",2019-08-01,"sbct","transporte regular","voo doméstico",2491,2485,4976,271482,270959,542441,131083,63987,195070,167412
"14994",2019-08-01,"sbct","transporte regular","voo internacional",78,78,156,3667,3610,7277,40931,47588,88519,0
"14995",2019-08-01,"sbct","transporte não regular","voo doméstico",277,270,547,581,1002,1583,0,0,0,0
"14996",2019-08-01,"sbct","transporte não regular","voo internacional",18,17,35,66,170,236,0,0,0,0
"14997",2019-08-01,"sbcz","transporte regular","voo doméstico",32,32,64,3220,1632,4852,0,0,0,0
"14998",2019-08-01,"sbcz","transporte regular","voo internacional",0,0,0,0,0,0,0,0,0,0
"14999",2019-08-01,"sbcz","transporte não regular","voo doméstico",208,205,413,892,866,1758,0,0,0,0
"15000",2019-08-01,"sbcz","transporte não regular","voo internacional",0,0,0,0,0,0,0,0,0,0
"15001",2019-08-01,"sbeg","transporte regular","voo doméstico",1072,1053,2125,128766,121646,250412,141650,212487,354137,0
"15002",2019-08-01,"sbeg","transporte regular","voo internacional",97,104,201,5768,4903,10671,0,0,0,0
"15003",2019-08-01,"sbeg","transporte não regular","voo doméstico",492,490,982,4155,2911,7066,0,0,0,0
"15004",2019-08-01,"sbeg","transporte não regular","voo internacional",52,55,107,33,0,33,0,0,0,0
"15005",2019-08-01,"sbfi","transporte regular","voo doméstico",610,604,1214,76599,80259,156858,0,0,0,0
"15006",2019-08-01,"sbfi","transporte regular","voo internacional",27,27,54,2990,2688,5678,0,0,0,0
"15007",2019-08-01,"sbfi","transporte não regular","voo doméstico",202,200,402,6454,6423,12877,0,0,0,0
"15008",2019-08-01,"sbfi","transporte não regular","voo internacional",67,75,142,52,91,143,0,0,0,0
"15009",2019-08-01,"sbgo","transporte regular","voo doméstico",1259,1256,2515,140265,142124,282389,220522,311167,531689,0
"15010",2019-08-01,"sbgo","transporte regular","voo internacional",0,0,0,0,0,0,0,0,0,0
"15011",2019-08-01,"sbgo","transporte não regular","voo doméstico",1146,1156,2302,4729,3973,8702,0,0,0,0
"15012",2019-08-01,"sbgo","transporte não regular","voo internacional",14,15,29,0,0,0,0,0,0,0
"15013",2019-08-01,"sbht","transporte regular","voo doméstico",83,83,166,4298,4202,8500,0,0,0,0
"15014",2019-08-01,"sbht","transporte regular","voo internacional",0,0,0,0,0,0,0,0,0,0
"15015",2019-08-01,"sbht","transporte não regular","voo doméstico",46,49,95,135,116,251,0,0,0,0
"15016",2019-08-01,"sbht","transporte não regular","voo internacional",0,0,0,0,0,0,0,0,0,0
"15017",2019-08-01,"sbiz","transporte regular","voo doméstico",112,112,224,14707,13772,28479,0,0,0,0
"15018",2019-08-01,"sbiz","transporte regular","voo internacional",0,0,0,0,0,0,0,0,0,0
"15019",2019-08-01,"sbiz","transporte não regular","voo doméstico",110,111,221,184,119,303,0,0,0,0
"15020",2019-08-01,"sbiz","transporte não regular","voo internacional",0,0,0,0,0,0,0,0,0,0
"15021",2019-08-01,"sbjc","transporte regular","voo doméstico",0,0,0,0,0,0,0,0,0,0
"15022",2019-08-01,"sbjc","transporte regular","voo internacional",0,0,0,0,0,0,0,0,0,0
"15023",2019-08-01,"sbjc","transporte não regular","voo doméstico",266,269,535,509,236,745,0,0,0,0
"15024",2019-08-01,"sbjc","transporte não regular","voo internacional",0,0,0,0,0,0,0,0,0,0
"15025",2019-08-01,"sbjr","transporte regular","voo doméstico",0,0,0,0,0,0,0,0,0,0
"15026",2019-08-01,"sbjr","transporte regular","voo internacional",0,0,0,0,0,0,0,0,0,0
"15027",2019-08-01,"sbjr","transporte não regular","voo doméstico",2546,2543,5089,11351,5140,16491,0,0,0,0
"15028",2019-08-01,"sbjr","transporte não regular","voo internacional",2,2,4,2,0,2,0,0,0,0
"15029",2019-08-01,"sbjv","transporte regular","voo doméstico",243,242,485,25994,25550,51544,0,0,0,0
"15030",2019-08-01,"sbjv","transporte regular","voo internacional",0,0,0,0,0,0,0,0,0,0
"15031",2019-08-01,"sbjv","transporte não regular","voo doméstico",82,83,165,97,202,299,0,0,0,0
"15032",2019-08-01,"sbjv","transporte não regular","voo internacional",0,0,0,0,0,0,0,0,0,0
"15033",2019-08-01,"sblo","transporte regular","voo doméstico",421,422,843,42860,43287,86147,0,0,0,0
"15034",2019-08-01,"sblo","transporte regular","voo internacional",0,0,0,0,0,0,0,0,0,0
"15035",2019-08-01,"sblo","transporte não regular","voo doméstico",470,467,937,158,28,186,0,0,0,0
"15036",2019-08-01,"sblo","transporte não regular","voo internacional",5,6,11,0,0,0,0,0,0,0
"15037",2019-08-01,"sbma","transporte regular","voo doméstico",137,137,274,13780,14364,28144,0,0,0,0
"15038",2019-08-01,"sbma","transporte regular","voo internacional",0,0,0,0,0,0,0,0,0,0
"15039",2019-08-01,"sbma","transporte não regular","voo doméstico",147,147,294,273,195,468,0,0,0,0
"15040",2019-08-01,"sbma","transporte não regular","voo internacional",0,0,0,0,0,0,0,0,0,0
"15041",2019-08-01,"sbmk","transporte regular","voo doméstico",153,152,305,9732,9401,19133,0,0,0,0
"15042",2019-08-01,"sbmk","transporte regular","voo internacional",0,0,0,0,0,0,0,0,0,0
"15043",2019-08-01,"sbmk","transporte não regular","voo doméstico",159,160,319,249,0,249,0,0,0,0
"15044",2019-08-01,"sbmk","transporte não regular","voo internacional",0,0,0,0,0,0,0,0,0,0
"15045",2019-08-01,"sbmq","transporte regular","voo doméstico",213,209,422,25897,27971,53868,9130,27020,36150,0
"15046",2019-08-01,"sbmq","transporte regular","voo internacional",0,0,0,0,0,0,0,0,0,0
"15047",2019-08-01,"sbmq","transporte não regular","voo doméstico",132,134,266,223,147,370,0,0,0,0
"15048",2019-08-01,"sbmq","transporte não regular","voo internacional",4,4,8,0,0,0,0,0,0,0
"15049",2019-08-01,"sbmt","transporte regular","voo doméstico",0,0,0,0,0,0,0,0,0,0
"15050",2019-08-01,"sbmt","transporte regular","voo internacional",0,0,0,0,0,0,0,0,0,0
"15051",2019-08-01,"sbmt","transporte não regular","voo doméstico",2627,2645,5272,3869,3981,7850,0,0,0,0
"15052",2019-08-01,"sbmt","transporte não regular","voo internacional",0,0,0,0,0,0,0,0,0,0
"15053",2019-08-01,"sbnf","transporte regular","voo doméstico",641,643,1284,79193,77592,156785,0,0,0,0
"15054",2019-08-01,"sbnf","transporte regular","voo internacional",0,0,0,0,0,0,0,0,0,0
"15055",2019-08-01,"sbnf","transporte não regular","voo doméstico",274,277,551,633,761,1394,0,0,0,0
"15056",2019-08-01,"sbnf","transporte não regular","voo internacional",2,1,3,0,2,2,0,0,0,0
"15057",2019-08-01,"sbpb","transporte regular","voo doméstico",5,5,10,325,562,887,0,0,0,0
"15058",2019-08-01,"sbpb","transporte regular","voo internacional",0,0,0,0,0,0,0,0,0,0
"15059",2019-08-01,"sbpb","transporte não regular","voo doméstico",77,72,149,219,217,436,0,0,0,0
"15060",2019-08-01,"sbpb","transporte não regular","voo internacional",0,0,0,0,0,0,0,0,0,0
"15061",2019-08-01,"sbpj","transporte regular","voo doméstico",254,253,507,25108,23682,48790,0,0,0,0
"15062",2019-08-01,"sbpj","transporte regular","voo internacional",0,0,0,0,0,0,0,0,0,0
"15063",2019-08-01,"sbpj","transporte não regular","voo doméstico",239,240,479,477,180,657,0,0,0,0
"15064",2019-08-01,"sbpj","transporte não regular","voo internacional",6,6,12,0,0,0,0,0,0,0
"15065",2019-08-01,"sbpk","transporte regular","voo doméstico",26,26,52,1222,1505,2727,0,0,0,0
"15066",2019-08-01,"sbpk","transporte regular","voo internacional",0,0,0,0,0,0,0,0,0,0
"15067",2019-08-01,"sbpk","transporte não regular","voo doméstico",36,37,73,96,99,195,0,0,0,0
"15068",2019-08-01,"sbpk","transporte não regular","voo internacional",0,0,0,0,0,0,0,0,0,0
"15069",2019-08-01,"sbpl","transporte regular","voo doméstico",150,150,300,16780,15682,32462,0,0,0,0
"15070",2019-08-01,"sbpl","transporte regular","voo internacional",3,3,6,0,0,0,0,0,0,0
"15071",2019-08-01,"sbpl","transporte não regular","voo doméstico",76,76,152,148,285,433,0,0,0,0
"15072",2019-08-01,"sbpl","transporte não regular","voo internacional",0,0,0,0,0,0,0,0,0,0
"15073",2019-08-01,"sbpp","transporte regular","voo doméstico",0,0,0,0,0,0,0,0,0,0
"15074",2019-08-01,"sbpp","transporte regular","voo internacional",0,0,0,0,0,0,0,0,0,0
"15075",2019-08-01,"sbpp","transporte não regular","voo doméstico",107,109,216,186,181,367,0,0,0,0
"15076",2019-08-01,"sbpp","transporte não regular","voo internacional",15,12,27,21,29,50,0,0,0,0
"15077",2019-08-01,"sbpr","transporte regular","voo doméstico",0,0,0,0,0,0,0,0,0,0
"15078",2019-08-01,"sbpr","transporte regular","voo internacional",0,0,0,0,0,0,0,0,0,0
"15079",2019-08-01,"sbpr","transporte não regular","voo doméstico",981,982,1963,1124,1028,2152,0,0,0,0
"15080",2019-08-01,"sbpr","transporte não regular","voo internacional",1,1,2,0,0,0,0,0,0,0
"15081",2019-08-01,"sbpv","transporte regular","voo doméstico",226,225,451,32350,30309,62659,0,0,0,0
"15082",2019-08-01,"sbpv","transporte regular","voo internacional",0,0,0,0,0,0,0,0,0,0
"15083",2019-08-01,"sbpv","transporte não regular","voo doméstico",231,230,461,60,0,60,0,0,0,0
"15084",2019-08-01,"sbpv","transporte não regular","voo internacional",0,1,1,0,0,0,0,0,0,0
"15085",2019-08-01,"sbrb","transporte regular","voo doméstico",152,150,302,16599,15625,32224,0,0,0,0
"15086",2019-08-01,"sbrb","transporte regular","voo internacional",0,0,0,0,0,0,0,0,0,0
"15087",2019-08-01,"sbrb","transporte não regular","voo doméstico",147,150,297,429,294,723,0,0,0,0
"15088",2019-08-01,"sbrb","transporte não regular","voo internacional",0,0,0,0,0,0,0,0,0,0
"15089",2019-08-01,"sbrj","transporte regular","voo doméstico",2812,2826,5638,310738,309427,620165,0,0,0,0
"15090",2019-08-01,"sbrj","transporte regular","voo internacional",0,0,0,0,0,0,0,0,0,0
"15091",2019-08-01,"sbrj","transporte não regular","voo doméstico",557,551,1108,1384,813,2197,0,0,0,0
"15092",2019-08-01,"sbrj","transporte não regular","voo internacional",3,3,6,0,0,0,0,0,0,0
"15093",2019-08-01,"sbsj","transporte regular","voo doméstico",37,37,74,1591,1429,3020,0,0,0,0
"15094",2019-08-01,"sbsj","transporte regular","voo internacional",0,0,0,0,0,0,0,0,0,0
"15095",2019-08-01,"sbsj","transporte não regular","voo doméstico",362,353,715,1268,1065,2333,0,0,0,0
"15096",2019-08-01,"sbsj","transporte não regular","voo internacional",12,17,29,59,64,123,0,0,0,0
"15097",2019-08-01,"sbsl","transporte regular","voo doméstico",505,503,1008,68372,71416,139788,0,0,0,0
"15098",2019-08-01,"sbsl","transporte regular","voo internacional",0,0,0,0,0,0,0,0,0,0
"15099",2019-08-01,"sbsl","transporte não regular","voo doméstico",240,241,481,1884,1090,2974,0,0,0,0
"15100",2019-08-01,"sbsl","transporte não regular","voo internacional",4,6,10,2,9,11,0,0,0,0
"15101",2019-08-01,"sbsn","transporte regular","voo doméstico",231,230,461,22876,21934,44810,0,0,0,0
"15102",2019-08-01,"sbsn","transporte regular","voo internacional",0,0,0,0,0,0,0,0,0,0
"15103",2019-08-01,"sbsn","transporte não regular","voo doméstico",268,270,538,578,458,1036,1100,1200,2300,0
"15104",2019-08-01,"sbsn","transporte não regular","voo internacional",4,4,8,0,0,0,0,0,0,0
"15105",2019-08-01,"sbsp","transporte regular","voo doméstico",6951,7012,13963,936479,934674,1871153,0,0,0,0
"15106",2019-08-01,"sbsp","transporte regular","voo internacional",0,0,0,0,0,0,0,0,0,0
"15107",2019-08-01,"sbsp","transporte não regular","voo doméstico",2179,2139,4318,9589,14599,24188,0,0,0,0
"15108",2019-08-01,"sbsp","transporte não regular","voo internacional",59,60,119,0,0,0,0,0,0,0
"15109",2019-08-01,"sbte","transporte regular","voo doméstico",359,358,717,51020,48486,99506,0,0,0,0
"15110",2019-08-01,"sbte","transporte regular","voo internacional",0,0,0,0,0,0,0,0,0,0
"15111",2019-08-01,"sbte","transporte não regular","voo doméstico",169,170,339,787,887,1674,0,0,0,0
"15112",2019-08-01,"sbte","transporte não regular","voo internacional",1,1,2,13,0,13,0,0,0,0
"15113",2019-08-01,"sbtf","transporte regular","voo doméstico",32,32,64,1347,1360,2707,0,0,0,0
"15114",2019-08-01,"sbtf","transporte regular","voo internacional",0,0,0,0,0,0,0,0,0,0
"15115",2019-08-01,"sbtf","transporte não regular","voo doméstico",111,111,222,210,167,377,674,50,724,1150
"15116",2019-08-01,"sbtf","transporte não regular","voo internacional",1,1,2,0,0,0,0,0,0,0
"15117",2019-08-01,"sbtt","transporte regular","voo doméstico",31,31,62,2473,2707,5180,0,0,0,0
"15118",2019-08-01,"sbtt","transporte regular","voo internacional",0,0,0,0,0,0,0,0,0,0
"15119",2019-08-01,"sbtt","transporte não regular","voo doméstico",132,131,263,603,710,1313,775,769,1544,0
"15120",2019-08-01,"sbtt","transporte não regular","voo internacional",2,1,3,8,5,13,0,0,0,0
"15121",2019-08-01,"sbuf","transporte regular","voo doméstico",8,8,16,447,379,826,0,0,0,0
"15122",2019-08-01,"sbuf","transporte regular","voo internacional",0,0,0,0,0,0,0,0,0,0
"15123",2019-08-01,"sbuf","transporte não regular","voo doméstico",26,24,50,50,57,107,0,0,0,0
"15124",2019-08-01,"sbuf","transporte não regular","voo internacional",0,0,0,0,0,0,0,0,0,0
"15125",2019-08-01,"sbug","transporte regular","voo doméstico",16,16,32,862,905,1767,0,0,0,0
"15126",2019-08-01,"sbug","transporte regular","voo internacional",0,0,0,0,0,0,0,0,0,0
"15127",2019-08-01,"sbug","transporte não regular","voo doméstico",9,9,18,36,31,67,0,0,0,0
"15128",2019-08-01,"sbug","transporte não regular","voo internacional",0,0,0,0,0,0,0,0,0,0
"15129",2019-08-01,"sbul","transporte regular","voo doméstico",545,542,1087,53226,52143,105369,0,0,0,0
"15130",2019-08-01,"sbul","transporte regular","voo internacional",0,0,0,0,0,0,0,0,0,0
"15131",2019-08-01,"sbul","transporte não regular","voo doméstico",568,562,1130,1374,1061,2435,0,0,0,0
"15132",2019-08-01,"sbul","transporte não regular","voo internacional",1,1,2,7,8,15,0,0,0,0
"15133",2019-08-01,"sbur","transporte regular","voo doméstico",61,61,122,3188,3282,6470,0,0,0,0
"15134",2019-08-01,"sbur","transporte regular","voo internacional",0,0,0,0,0,0,0,0,0,0
"15135",2019-08-01,"sbur","transporte não regular","voo doméstico",199,196,395,728,709,1437,0,0,0,0
"15136",2019-08-01,"sbur","transporte não regular","voo internacional",1,1,2,0,0,0,0,0,0,0
"15137",2019-12-01,"sbbe","transporte regular","voo doméstico",1210,1210,2420,158736,161676,320412,0,0,0,0
"15138",2019-12-01,"sbbe","transporte regular","voo internacional",67,67,134,8200,8364,16564,0,7,7,0
"15139",2019-12-01,"sbbe","transporte não regular","voo doméstico",457,451,908,707,982,1689,0,0,0,0
"15140",2019-12-01,"sbbe","transporte não regular","voo internacional",13,12,25,27,16,43,0,0,0,0
"15141",2019-12-01,"sbbg","transporte regular","voo doméstico",25,24,49,124,113,237,0,0,0,0
"15142",2019-12-01,"sbbg","transporte regular","voo internacional",0,0,0,0,0,0,0,0,0,0
"15143",2019-12-01,"sbbg","transporte não regular","voo doméstico",15,16,31,52,49,101,0,0,0,0
"15144",2019-12-01,"sbbg","transporte não regular","voo internacional",4,5,9,12,2,14,0,0,0,0
"15145",2019-12-01,"sbbh","transporte regular","voo doméstico",0,0,0,0,0,0,0,0,0,0
"15146",2019-12-01,"sbbh","transporte regular","voo internacional",0,0,0,0,0,0,0,0,0,0
"15147",2019-12-01,"sbbh","transporte não regular","voo doméstico",1386,1412,2798,7154,7022,14176,0,0,0,0
"15148",2019-12-01,"sbbh","transporte não regular","voo internacional",1,2,3,0,0,0,0,0,0,0
"15149",2019-12-01,"sbbi","transporte regular","voo doméstico",0,0,0,0,0,0,0,0,0,0
"15150",2019-12-01,"sbbi","transporte regular","voo internacional",0,0,0,0,0,0,0,0,0,0
"15151",2019-12-01,"sbbi","transporte não regular","voo doméstico",1010,1024,2034,971,946,1917,0,0,0,0
"15152",2019-12-01,"sbbi","transporte não regular","voo internacional",0,0,0,0,0,0,0,0,0,0
"15153",2019-12-01,"sbbv","transporte regular","voo doméstico",110,110,220,18098,13530,31628,0,0,0,0
"15154",2019-12-01,"sbbv","transporte regular","voo internacional",0,0,0,0,0,0,0,0,0,0
"15155",2019-12-01,"sbbv","transporte não regular","voo doméstico",278,283,561,435,15,450,0,0,0,0
"15156",2019-12-01,"sbbv","transporte não regular","voo internacional",16,10,26,0,2,2,0,0,0,0
"15157",2019-12-01,"sbcg","transporte regular","voo doméstico",511,512,1023,67969,61412,129381,54760,76005,130765,0
"15158",2019-12-01,"sbcg","transporte regular","voo internacional",0,0,0,0,0,0,0,0,0,0
"15159",2019-12-01,"sbcg","transporte não regular","voo doméstico",148,152,300,525,670,1195,0,0,0,0
"15160",2019-12-01,"sbcg","transporte não regular","voo internacional",14,12,26,0,0,0,0,0,0,0
"15161",2019-12-01,"sbcj","transporte regular","voo doméstico",70,70,140,7481,6028,13509,0,0,0,0
"15162",2019-12-01,"sbcj","transporte regular","voo internacional",0,0,0,0,0,0,0,0,0,0
"15163",2019-12-01,"sbcj","transporte não regular","voo doméstico",73,74,147,470,162,632,0,0,0,0
"15164",2019-12-01,"sbcj","transporte não regular","voo internacional",1,1,2,0,0,0,0,0,0,0
"15165",2019-12-01,"sbcr","transporte regular","voo doméstico",21,21,42,1044,1480,2524,0,0,0,0
"15166",2019-12-01,"sbcr","transporte regular","voo internacional",0,0,0,0,0,0,0,0,0,0
"15167",2019-12-01,"sbcr","transporte não regular","voo doméstico",28,30,58,67,65,132,0,0,0,0
"15168",2019-12-01,"sbcr","transporte não regular","voo internacional",3,3,6,5,4,9,0,0,0,0
"15169",2019-12-01,"sbct","transporte regular","voo doméstico",2605,2616,5221,291091,284939,576030,142210,45381,187591,195722
"15170",2019-12-01,"sbct","transporte regular","voo internacional",76,76,152,3749,3335,7084,31025,38569,69594,431
"15171",2019-12-01,"sbct","transporte não regular","voo doméstico",257,255,512,1054,1992,3046,0,0,0,0
"15172",2019-12-01,"sbct","transporte não regular","voo internacional",17,17,34,48,23,71,0,0,0,0
"15173",2019-12-01,"sbcz","transporte regular","voo doméstico",31,29,60,2276,1315,3591,0,0,0,0
"15174",2019-12-01,"sbcz","transporte regular","voo internacional",0,0,0,0,0,0,0,0,0,0
"15175",2019-12-01,"sbcz","transporte não regular","voo doméstico",186,190,376,698,535,1233,0,0,0,0
"15176",2019-12-01,"sbcz","transporte não regular","voo internacional",1,0,1,0,0,0,0,0,0,0
"15177",2019-12-01,"sbeg","transporte regular","voo doméstico",1098,1099,2197,150294,117444,267738,122820,240503,363323,0
"15178",2019-12-01,"sbeg","transporte regular","voo internacional",110,112,222,5892,4894,10786,0,0,0,0
"15179",2019-12-01,"sbeg","transporte não regular","voo doméstico",525,517,1042,4631,2394,7025,0,0,0,0
"15180",2019-12-01,"sbeg","transporte não regular","voo internacional",76,87,163,237,162,399,0,0,0,0
"15181",2019-12-01,"sbfi","transporte regular","voo doméstico",733,737,1470,107563,96644,204207,0,0,0,0
"15182",2019-12-01,"sbfi","transporte regular","voo internacional",37,37,74,3864,2621,6485,0,0,0,0
"15183",2019-12-01,"sbfi","transporte não regular","voo doméstico",137,130,267,164,419,583,0,0,0,0
"15184",2019-12-01,"sbfi","transporte não regular","voo internacional",34,43,77,45,245,290,0,0,0,0
"15185",2019-12-01,"sbgo","transporte regular","voo doméstico",1160,1159,2319,141121,136219,277340,93981,133372,227353,0
"15186",2019-12-01,"sbgo","transporte regular","voo internacional",0,0,0,0,0,0,0,0,0,0
"15187",2019-12-01,"sbgo","transporte não regular","voo doméstico",814,844,1658,4261,3928,8189,0,0,0,0
"15188",2019-12-01,"sbgo","transporte não regular","voo internacional",1,2,3,0,0,0,0,0,0,0
"15189",2019-12-01,"sbht","transporte regular","voo doméstico",68,68,136,4547,4178,8725,0,0,0,0
"15190",2019-12-01,"sbht","transporte regular","voo internacional",0,0,0,0,0,0,0,0,0,0
"15191",2019-12-01,"sbht","transporte não regular","voo doméstico",32,32,64,120,45,165,0,0,0,0
"15192",2019-12-01,"sbht","transporte não regular","voo internacional",2,2,4,0,0,0,0,0,0,0
"15193",2019-12-01,"sbiz","transporte regular","voo doméstico",120,120,240,16609,15263,31872,0,0,0,0
"15194",2019-12-01,"sbiz","transporte regular","voo internacional",0,0,0,0,0,0,0,0,0,0
"15195",2019-12-01,"sbiz","transporte não regular","voo doméstico",119,121,240,169,1,170,0,0,0,0
"15196",2019-12-01,"sbiz","transporte não regular","voo internacional",0,0,0,0,0,0,0,0,0,0
"15197",2019-12-01,"sbjc","transporte regular","voo doméstico",0,0,0,0,0,0,0,0,0,0
"15198",2019-12-01,"sbjc","transporte regular","voo internacional",0,0,0,0,0,0,0,0,0,0
"15199",2019-12-01,"sbjc","transporte não regular","voo doméstico",295,298,593,718,453,1171,0,0,0,0
"15200",2019-12-01,"sbjc","transporte não regular","voo internacional",0,0,0,0,0,0,0,0,0,0
"15201",2019-12-01,"sbjr","transporte regular","voo doméstico",53,53,106,92,100,192,0,0,0,0
"15202",2019-12-01,"sbjr","transporte regular","voo internacional",0,0,0,0,0,0,0,0,0,0
"15203",2019-12-01,"sbjr","transporte não regular","voo doméstico",2846,2833,5679,13256,5560,18816,0,0,0,0
"15204",2019-12-01,"sbjr","transporte não regular","voo internacional",0,0,0,0,0,0,0,0,0,0
"15205",2019-12-01,"sbjv","transporte regular","voo doméstico",232,233,465,24993,26487,51480,0,0,0,0
"15206",2019-12-01,"sbjv","transporte regular","voo internacional",0,0,0,0,0,0,0,0,0,0
"15207",2019-12-01,"sbjv","transporte não regular","voo doméstico",80,81,161,128,44,172,0,0,0,0
"15208",2019-12-01,"sbjv","transporte não regular","voo internacional",0,0,0,0,0,0,0,0,0,0
"15209",2019-12-01,"sblo","transporte regular","voo doméstico",392,393,785,40690,42818,83508,0,0,0,0
"15210",2019-12-01,"sblo","transporte regular","voo internacional",0,0,0,0,0,0,0,0,0,0
"15211",2019-12-01,"sblo","transporte não regular","voo doméstico",361,369,730,982,1297,2279,0,0,0,0
"15212",2019-12-01,"sblo","transporte não regular","voo internacional",2,2,4,0,0,0,0,0,0,0
"15213",2019-12-01,"sbma","transporte regular","voo doméstico",106,106,212,13514,12771,26285,0,0,0,0
"15214",2019-12-01,"sbma","transporte regular","voo internacional",0,0,0,0,0,0,0,0,0,0
"15215",2019-12-01,"sbma","transporte não regular","voo doméstico",120,118,238,139,123,262,0,0,0,0
"15216",2019-12-01,"sbma","transporte não regular","voo internacional",0,0,0,0,0,0,0,0,0,0
"15217",2019-12-01,"sbmk","transporte regular","voo doméstico",145,144,289,9349,10078,19427,0,0,0,0
"15218",2019-12-01,"sbmk","transporte regular","voo internacional",0,0,0,0,0,0,0,0,0,0
"15219",2019-12-01,"sbmk","transporte não regular","voo doméstico",179,177,356,320,0,320,0,0,0,0
"15220",2019-12-01,"sbmk","transporte não regular","voo internacional",0,0,0,0,0,0,0,0,0,0
"15221",2019-12-01,"sbmq","transporte regular","voo doméstico",203,203,406,31040,26805,57845,0,0,0,0
"15222",2019-12-01,"sbmq","transporte regular","voo internacional",0,0,0,0,0,0,0,0,0,0
"15223",2019-12-01,"sbmq","transporte não regular","voo doméstico",147,148,295,575,160,735,9340,32494,41834,0
"15224",2019-12-01,"sbmq","transporte não regular","voo internacional",4,7,11,0,0,0,0,0,0,0
"15225",2019-12-01,"sbmt","transporte regular","voo doméstico",0,0,0,0,0,0,0,0,0,0
"15226",2019-12-01,"sbmt","transporte regular","voo internacional",0,0,0,0,0,0,0,0,0,0
"15227",2019-12-01,"sbmt","transporte não regular","voo doméstico",2366,2384,4750,3589,3650,7239,0,0,0,0
"15228",2019-12-01,"sbmt","transporte não regular","voo internacional",0,0,0,0,0,0,0,0,0,0
"15229",2019-12-01,"sbnf","transporte regular","voo doméstico",688,688,1376,85792,91271,177063,0,0,0,0
"15230",2019-12-01,"sbnf","transporte regular","voo internacional",0,0,0,0,0,0,0,0,0,0
"15231",2019-12-01,"sbnf","transporte não regular","voo doméstico",360,353,713,336,345,681,0,0,0,0
"15232",2019-12-01,"sbnf","transporte não regular","voo internacional",4,2,6,0,0,0,0,0,0,0
"15233",2019-12-01,"sbpb","transporte regular","voo doméstico",4,4,8,204,461,665,0,0,0,0
"15234",2019-12-01,"sbpb","transporte regular","voo internacional",0,0,0,0,0,0,0,0,0,0
"15235",2019-12-01,"sbpb","transporte não regular","voo doméstico",77,76,153,208,415,623,0,0,0,0
"15236",2019-12-01,"sbpb","transporte não regular","voo internacional",0,0,0,0,0,0,0,0,0,0
"15237",2019-12-01,"sbpj","transporte regular","voo doméstico",213,214,427,24075,22703,46778,0,0,0,0
"15238",2019-12-01,"sbpj","transporte regular","voo internacional",0,0,0,0,0,0,0,0,0,0
"15239",2019-12-01,"sbpj","transporte não regular","voo doméstico",182,180,362,253,86,339,0,0,0,0
"15240",2019-12-01,"sbpj","transporte não regular","voo internacional",0,0,0,0,0,0,0,0,0,0
"15241",2019-12-01,"sbpk","transporte regular","voo doméstico",25,25,50,1331,1409,2740,0,0,0,0
"15242",2019-12-01,"sbpk","transporte regular","voo internacional",0,0,0,0,0,0,0,0,0,0
"15243",2019-12-01,"sbpk","transporte não regular","voo doméstico",54,41,95,210,200,410,0,0,0,0
"15244",2019-12-01,"sbpk","transporte não regular","voo internacional",3,13,16,7,0,7,0,0,0,0
"15245",2019-12-01,"sbpl","transporte regular","voo doméstico",201,201,402,19896,22324,42220,0,0,0,0
"15246",2019-12-01,"sbpl","transporte regular","voo internacional",3,3,6,0,0,0,0,0,0,0
"15247",2019-12-01,"sbpl","transporte não regular","voo doméstico",82,81,163,111,98,209,0,0,0,0
"15248",2019-12-01,"sbpl","transporte não regular","voo internacional",1,1,2,2,2,4,0,0,0,0
"15249",2019-12-01,"sbpp","transporte regular","voo doméstico",0,0,0,0,0,0,0,0,0,0
"15250",2019-12-01,"sbpp","transporte regular","voo internacional",0,0,0,0,0,0,0,0,0,0
"15251",2019-12-01,"sbpp","transporte não regular","voo doméstico",63,67,130,156,144,300,0,0,0,0
"15252",2019-12-01,"sbpp","transporte não regular","voo internacional",7,7,14,16,14,30,0,0,0,0
"15253",2019-12-01,"sbpr","transporte regular","voo doméstico",0,0,0,0,0,0,0,0,0,0
"15254",2019-12-01,"sbpr","transporte regular","voo internacional",0,0,0,0,0,0,0,0,0,0
"15255",2019-12-01,"sbpr","transporte não regular","voo doméstico",599,603,1202,691,577,1268,0,0,0,0
"15256",2019-12-01,"sbpr","transporte não regular","voo internacional",0,0,0,0,0,0,0,0,0,0
"15257",2019-12-01,"sbpv","transporte regular","voo doméstico",232,232,464,35673,30167,65840,0,0,0,0
"15258",2019-12-01,"sbpv","transporte regular","voo internacional",0,0,0,0,0,0,0,0,0,0
"15259",2019-12-01,"sbpv","transporte não regular","voo doméstico",136,136,272,313,182,495,0,0,0,0
"15260",2019-12-01,"sbpv","transporte não regular","voo internacional",0,0,0,0,0,0,0,0,0,0
"15261",2019-12-01,"sbrb","transporte regular","voo doméstico",148,150,298,16862,14206,31068,0,0,0,0
"15262",2019-12-01,"sbrb","transporte regular","voo internacional",0,0,0,0,0,0,0,0,0,0
"15263",2019-12-01,"sbrb","transporte não regular","voo doméstico",192,187,379,457,288,745,0,0,0,0
"15264",2019-12-01,"sbrb","transporte não regular","voo internacional",0,2,2,0,0,0,0,0,0,0
"15265",2019-12-01,"sbrj","transporte regular","voo doméstico",4321,4358,8679,470123,497375,967498,0,0,0,0
"15266",2019-12-01,"sbrj","transporte regular","voo internacional",0,0,0,0,0,0,0,0,0,0
"15267",2019-12-01,"sbrj","transporte não regular","voo doméstico",531,494,1025,1126,633,1759,0,0,0,0
"15268",2019-12-01,"sbrj","transporte não regular","voo internacional",1,1,2,0,0,0,0,0,0,0
"15269",2019-12-01,"sbsj","transporte regular","voo doméstico",30,31,61,1442,1374,2816,0,0,0,0
"15270",2019-12-01,"sbsj","transporte regular","voo internacional",0,0,0,0,0,0,0,0,0,0
"15271",2019-12-01,"sbsj","transporte não regular","voo doméstico",389,382,771,1231,1356,2587,0,0,0,0
"15272",2019-12-01,"sbsj","transporte não regular","voo internacional",2,27,29,87,4,91,0,0,0,0
"15273",2019-12-01,"sbsl","transporte regular","voo doméstico",537,539,1076,68805,75559,144364,0,0,0,0
"15274",2019-12-01,"sbsl","transporte regular","voo internacional",0,0,0,0,0,0,0,0,0,0
"15275",2019-12-01,"sbsl","transporte não regular","voo doméstico",232,228,460,837,345,1182,0,0,0,0
"15276",2019-12-01,"sbsl","transporte não regular","voo internacional",14,10,24,0,0,0,0,0,0,0
"15277",2019-12-01,"sbsn","transporte regular","voo doméstico",221,221,442,25251,25292,50543,0,0,0,0
"15278",2019-12-01,"sbsn","transporte regular","voo internacional",0,0,0,0,0,0,0,0,0,0
"15279",2019-12-01,"sbsn","transporte não regular","voo doméstico",176,179,355,247,170,417,1000,1200,2200,0
"15280",2019-12-01,"sbsn","transporte não regular","voo internacional",1,1,2,0,118,118,0,0,0,0
"15281",2019-12-01,"sbsp","transporte regular","voo doméstico",7499,7548,15047,1005496,920500,1925996,0,0,0,0
"15282",2019-12-01,"sbsp","transporte regular","voo internacional",0,0,0,0,0,0,0,0,0,0
"15283",2019-12-01,"sbsp","transporte não regular","voo doméstico",2013,1993,4006,23219,15828,39047,0,0,0,0
"15284",2019-12-01,"sbsp","transporte não regular","voo internacional",3,3,6,0,0,0,0,0,0,0
"15285",2019-12-01,"sbte","transporte regular","voo doméstico",363,363,726,50611,56023,106634,0,0,0,0
"15286",2019-12-01,"sbte","transporte regular","voo internacional",0,0,0,0,0,0,0,0,0,0
"15287",2019-12-01,"sbte","transporte não regular","voo doméstico",167,177,344,835,830,1665,0,0,0,0
"15288",2019-12-01,"sbte","transporte não regular","voo internacional",0,0,0,0,0,0,0,0,0,0
"15289",2019-12-01,"sbtf","transporte regular","voo doméstico",18,18,36,1267,1331,2598,0,0,0,0
"15290",2019-12-01,"sbtf","transporte regular","voo internacional",0,0,0,0,0,0,0,0,0,0
"15291",2019-12-01,"sbtf","transporte não regular","voo doméstico",137,137,274,112,83,195,616,0,616,1155
"15292",2019-12-01,"sbtf","transporte não regular","voo internacional",0,0,0,0,0,0,0,0,0,0
"15293",2019-12-01,"sbtt","transporte regular","voo doméstico",30,30,60,2514,3442,5956,0,0,0,0
"15294",2019-12-01,"sbtt","transporte regular","voo internacional",0,0,0,0,0,0,0,0,0,0
"15295",2019-12-01,"sbtt","transporte não regular","voo doméstico",94,95,189,440,468,908,0,0,0,0
"15296",2019-12-01,"sbtt","transporte não regular","voo internacional",0,0,0,0,0,0,0,0,0,0
"15297",2019-12-01,"sbuf","transporte regular","voo doméstico",9,9,18,409,544,953,0,0,0,0
"15298",2019-12-01,"sbuf","transporte regular","voo internacional",0,0,0,0,0,0,0,0,0,0
"15299",2019-12-01,"sbuf","transporte não regular","voo doméstico",21,22,43,52,49,101,0,0,0,0
"15300",2019-12-01,"sbuf","transporte não regular","voo internacional",0,0,0,0,0,0,0,0,0,0
"15301",2019-12-01,"sbug","transporte regular","voo doméstico",17,17,34,882,921,1803,0,0,0,0
"15302",2019-12-01,"sbug","transporte regular","voo internacional",0,0,0,0,0,0,0,0,0,0
"15303",2019-12-01,"sbug","transporte não regular","voo doméstico",10,10,20,17,14,31,0,0,0,0
"15304",2019-12-01,"sbug","transporte não regular","voo internacional",0,0,0,0,0,0,0,0,0,0
"15305",2019-12-01,"sbul","transporte regular","voo doméstico",458,456,914,44348,41625,85973,0,0,0,0
"15306",2019-12-01,"sbul","transporte regular","voo internacional",0,0,0,0,0,0,0,0,0,0
"15307",2019-12-01,"sbul","transporte não regular","voo doméstico",541,542,1083,2233,1462,3695,0,0,0,0
"15308",2019-12-01,"sbul","transporte não regular","voo internacional",1,1,2,6,6,12,0,0,0,0
"15309",2019-12-01,"sbur","transporte regular","voo doméstico",80,79,159,3633,3703,7336,0,0,0,0
"15310",2019-12-01,"sbur","transporte regular","voo internacional",0,0,0,0,0,0,0,0,0,0
"15311",2019-12-01,"sbur","transporte não regular","voo doméstico",188,188,376,686,870,1556,0,0,0,0
"15312",2019-12-01,"sbur","transporte não regular","voo internacional",0,0,0,0,0,0,0,0,0,0
"15313",2019-02-01,"sbbe","transporte regular","voo doméstico",1025,1023,2048,134223,121186,255409,0,0,0,0
"15314",2019-02-01,"sbbe","transporte regular","voo internacional",52,52,104,5596,6103,11699,0,18,18,0
"15315",2019-02-01,"sbbe","transporte não regular","voo doméstico",385,396,781,615,986,1601,0,0,0,0
"15316",2019-02-01,"sbbe","transporte não regular","voo internacional",7,5,12,0,12,12,0,0,0,0
"15317",2019-02-01,"sbbg","transporte regular","voo doméstico",0,0,0,0,0,0,0,0,0,0
"15318",2019-02-01,"sbbg","transporte regular","voo internacional",0,0,0,0,0,0,0,0,0,0
"15319",2019-02-01,"sbbg","transporte não regular","voo doméstico",7,7,14,22,21,43,0,0,0,0
"15320",2019-02-01,"sbbg","transporte não regular","voo internacional",2,2,4,4,4,8,0,0,0,0
"15321",2019-02-01,"sbbh","transporte regular","voo doméstico",0,0,0,0,0,0,0,0,0,0
"15322",2019-02-01,"sbbh","transporte regular","voo internacional",0,0,0,0,0,0,0,0,0,0
"15323",2019-02-01,"sbbh","transporte não regular","voo doméstico",1602,1616,3218,8084,8022,16106,0,0,0,0
"15324",2019-02-01,"sbbh","transporte não regular","voo internacional",3,3,6,18,10,28,0,0,0,0
"15325",2019-02-01,"sbbi","transporte regular","voo doméstico",0,0,0,0,0,0,0,0,0,0
"15326",2019-02-01,"sbbi","transporte regular","voo internacional",0,0,0,0,0,0,0,0,0,0
"15327",2019-02-01,"sbbi","transporte não regular","voo doméstico",845,845,1690,742,816,1558,0,0,0,0
"15328",2019-02-01,"sbbi","transporte não regular","voo internacional",0,0,0,0,0,0,0,0,0,0
"15329",2019-02-01,"sbbv","transporte regular","voo doméstico",93,94,187,14089,12022,26111,0,0,0,0
"15330",2019-02-01,"sbbv","transporte regular","voo internacional",0,0,0,0,0,0,0,0,0,0
"15331",2019-02-01,"sbbv","transporte não regular","voo doméstico",81,81,162,278,540,818,0,0,0,0
"15332",2019-02-01,"sbbv","transporte não regular","voo internacional",15,14,29,16,2,18,0,0,0,0
"15333",2019-02-01,"sbcg","transporte regular","voo doméstico",532,533,1065,55549,62319,117868,68678,94632,163310,0
"15334",2019-02-01,"sbcg","transporte regular","voo internacional",0,0,0,0,0,0,0,0,0,0
"15335",2019-02-01,"sbcg","transporte não regular","voo doméstico",130,133,263,297,438,735,0,0,0,0
"15336",2019-02-01,"sbcg","transporte não regular","voo internacional",5,5,10,0,0,0,0,0,0,0
"15337",2019-02-01,"sbcj","transporte regular","voo doméstico",75,75,150,4730,5852,10582,0,0,0,0
"15338",2019-02-01,"sbcj","transporte regular","voo internacional",0,0,0,0,0,0,0,0,0,0
"15339",2019-02-01,"sbcj","transporte não regular","voo doméstico",59,58,117,1209,290,1499,0,0,0,0
"15340",2019-02-01,"sbcj","transporte não regular","voo internacional",0,0,0,0,0,0,0,0,0,0
"15341",2019-02-01,"sbcr","transporte regular","voo doméstico",18,18,36,962,1631,2593,0,0,0,0
"15342",2019-02-01,"sbcr","transporte regular","voo internacional",0,0,0,0,0,0,0,0,0,0
"15343",2019-02-01,"sbcr","transporte não regular","voo doméstico",67,68,135,90,72,162,0,0,0,0
"15344",2019-02-01,"sbcr","transporte não regular","voo internacional",1,1,2,6,8,14,0,0,0,0
"15345",2019-02-01,"sbct","transporte regular","voo doméstico",2277,2283,4560,244701,253440,498141,130226,67446,197672,135356
"15346",2019-02-01,"sbct","transporte regular","voo internacional",68,71,139,2661,1954,4615,0,5645,5645,0
"15347",2019-02-01,"sbct","transporte não regular","voo doméstico",278,263,541,3027,3839,6866,0,0,0,0
"15348",2019-02-01,"sbct","transporte não regular","voo internacional",18,18,36,53,32,85,0,0,0,0
"15349",2019-02-01,"sbcz","transporte regular","voo doméstico",25,26,51,2750,1294,4044,0,0,0,0
"15350",2019-02-01,"sbcz","transporte regular","voo internacional",0,0,0,0,0,0,0,0,0,0
"15351",2019-02-01,"sbcz","transporte não regular","voo doméstico",122,124,246,482,421,903,0,0,0,0
"15352",2019-02-01,"sbcz","transporte não regular","voo internacional",0,0,0,0,0,0,0,0,0,0
"15353",2019-02-01,"sbeg","transporte regular","voo doméstico",928,917,1845,103879,109570,213449,136117,219404,355521,0
"15354",2019-02-01,"sbeg","transporte regular","voo internacional",89,98,187,4340,4580,8920,0,0,0,0
"15355",2019-02-01,"sbeg","transporte não regular","voo doméstico",382,396,778,4413,2502,6915,0,0,0,0
"15356",2019-02-01,"sbeg","transporte não regular","voo internacional",54,48,102,44,0,44,0,0,0,0
"15357",2019-02-01,"sbfi","transporte regular","voo doméstico",607,597,1204,85988,88821,174809,0,0,0,0
"15358",2019-02-01,"sbfi","transporte regular","voo internacional",20,20,40,2986,2972,5958,0,0,0,0
"15359",2019-02-01,"sbfi","transporte não regular","voo doméstico",211,216,427,13400,12918,26318,0,0,0,0
"15360",2019-02-01,"sbfi","transporte não regular","voo internacional",44,51,95,103,189,292,0,0,0,0
"15361",2019-02-01,"sbgo","transporte regular","voo doméstico",1261,1261,2522,119442,121409,240851,235849,288436,524285,0
"15362",2019-02-01,"sbgo","transporte regular","voo internacional",0,0,0,0,0,0,0,0,0,0
"15363",2019-02-01,"sbgo","transporte não regular","voo doméstico",1138,1131,2269,3809,3612,7421,4380,214,4594,0
"15364",2019-02-01,"sbgo","transporte não regular","voo internacional",4,5,9,0,0,0,0,0,0,0
"15365",2019-02-01,"sbht","transporte regular","voo doméstico",75,75,150,3509,3211,6720,0,0,0,0
"15366",2019-02-01,"sbht","transporte regular","voo internacional",0,0,0,0,0,0,0,0,0,0
"15367",2019-02-01,"sbht","transporte não regular","voo doméstico",42,45,87,103,49,152,0,0,0,0
"15368",2019-02-01,"sbht","transporte não regular","voo internacional",0,0,0,0,0,0,0,0,0,0
"15369",2019-02-01,"sbiz","transporte regular","voo doméstico",106,106,212,12814,11358,24172,0,0,0,0
"15370",2019-02-01,"sbiz","transporte regular","voo internacional",0,0,0,0,0,0,0,0,0,0
"15371",2019-02-01,"sbiz","transporte não regular","voo doméstico",78,81,159,175,129,304,0,0,0,0
"15372",2019-02-01,"sbiz","transporte não regular","voo internacional",0,0,0,0,0,0,0,0,0,0
"15373",2019-02-01,"sbjc","transporte regular","voo doméstico",0,0,0,0,0,0,0,0,0,0
"15374",2019-02-01,"sbjc","transporte regular","voo internacional",0,0,0,0,0,0,0,0,0,0
"15375",2019-02-01,"sbjc","transporte não regular","voo doméstico",221,216,437,407,180,587,0,0,0,0
"15376",2019-02-01,"sbjc","transporte não regular","voo internacional",0,0,0,0,0,0,0,0,0,0
"15377",2019-02-01,"sbjr","transporte regular","voo doméstico",0,0,0,0,0,0,0,0,0,0
"15378",2019-02-01,"sbjr","transporte regular","voo internacional",0,0,0,0,0,0,0,0,0,0
"15379",2019-02-01,"sbjr","transporte não regular","voo doméstico",2536,2536,5072,9068,999,10067,0,0,0,0
"15380",2019-02-01,"sbjr","transporte não regular","voo internacional",2,1,3,0,0,0,0,0,0,0
"15381",2019-02-01,"sbjv","transporte regular","voo doméstico",194,193,387,19724,20231,39955,0,0,0,0
"15382",2019-02-01,"sbjv","transporte regular","voo internacional",0,0,0,0,0,0,0,0,0,0
"15383",2019-02-01,"sbjv","transporte não regular","voo doméstico",77,78,155,128,595,723,0,0,0,0
"15384",2019-02-01,"sbjv","transporte não regular","voo internacional",1,1,2,3,0,3,0,0,0,0
"15385",2019-02-01,"sblo","transporte regular","voo doméstico",404,403,807,40618,43287,83905,0,0,0,0
"15386",2019-02-01,"sblo","transporte regular","voo internacional",0,1,1,0,0,0,0,0,0,0
"15387",2019-02-01,"sblo","transporte não regular","voo doméstico",359,347,706,170,386,556,0,0,0,0
"15388",2019-02-01,"sblo","transporte não regular","voo internacional",1,1,2,0,0,0,0,0,0,0
"15389",2019-02-01,"sbma","transporte regular","voo doméstico",110,111,221,9449,8571,18020,0,0,0,0
"15390",2019-02-01,"sbma","transporte regular","voo internacional",0,0,0,0,0,0,0,0,0,0
"15391",2019-02-01,"sbma","transporte não regular","voo doméstico",101,102,203,245,224,469,0,0,0,0
"15392",2019-02-01,"sbma","transporte não regular","voo internacional",0,0,0,0,0,0,0,0,0,0
"15393",2019-02-01,"sbmk","transporte regular","voo doméstico",123,124,247,8988,7872,16860,0,0,0,0
"15394",2019-02-01,"sbmk","transporte regular","voo internacional",0,0,0,0,0,0,0,0,0,0
"15395",2019-02-01,"sbmk","transporte não regular","voo doméstico",163,165,328,427,71,498,0,0,0,0
"15396",2019-02-01,"sbmk","transporte não regular","voo internacional",0,0,0,0,0,0,0,0,0,0
"15397",2019-02-01,"sbmq","transporte regular","voo doméstico",203,203,406,23619,22093,45712,12100,31650,43750,0
"15398",2019-02-01,"sbmq","transporte regular","voo internacional",0,0,0,0,0,0,0,0,0,0
"15399",2019-02-01,"sbmq","transporte não regular","voo doméstico",74,75,149,95,57,152,0,0,0,0
"15400",2019-02-01,"sbmq","transporte não regular","voo internacional",1,1,2,0,0,0,0,0,0,0
"15401",2019-02-01,"sbmt","transporte regular","voo doméstico",0,0,0,0,0,0,0,0,0,0
"15402",2019-02-01,"sbmt","transporte regular","voo internacional",0,0,0,0,0,0,0,0,0,0
"15403",2019-02-01,"sbmt","transporte não regular","voo doméstico",2194,2189,4383,3165,3242,6407,0,0,0,0
"15404",2019-02-01,"sbmt","transporte não regular","voo internacional",0,0,0,0,0,0,0,0,0,0
"15405",2019-02-01,"sbnf","transporte regular","voo doméstico",580,577,1157,70650,72998,143648,0,0,0,0
"15406",2019-02-01,"sbnf","transporte regular","voo internacional",17,17,34,1918,1602,3520,0,0,0,0
"15407",2019-02-01,"sbnf","transporte não regular","voo doméstico",213,222,435,372,318,690,0,0,0,0
"15408",2019-02-01,"sbnf","transporte não regular","voo internacional",3,1,4,0,2,2,0,0,0,0
"15409",2019-02-01,"sbpb","transporte regular","voo doméstico",4,4,8,306,403,709,0,0,0,0
"15410",2019-02-01,"sbpb","transporte regular","voo internacional",0,0,0,0,0,0,0,0,0,0
"15411",2019-02-01,"sbpb","transporte não regular","voo doméstico",27,25,52,68,69,137,0,0,0,0
"15412",2019-02-01,"sbpb","transporte não regular","voo internacional",1,1,2,0,0,0,0,0,0,0
"15413",2019-02-01,"sbpj","transporte regular","voo doméstico",230,230,460,22298,20765,43063,0,0,0,0
"15414",2019-02-01,"sbpj","transporte regular","voo internacional",0,0,0,0,0,0,0,0,0,0
"15415",2019-02-01,"sbpj","transporte não regular","voo doméstico",183,185,368,352,244,596,0,0,0,0
"15416",2019-02-01,"sbpj","transporte não regular","voo internacional",0,0,0,0,0,0,0,0,0,0
"15417",2019-02-01,"sbpk","transporte regular","voo doméstico",24,24,48,1358,1501,2859,0,0,0,0
"15418",2019-02-01,"sbpk","transporte regular","voo internacional",0,0,0,0,0,0,0,0,0,0
"15419",2019-02-01,"sbpk","transporte não regular","voo doméstico",38,37,75,94,95,189,0,0,0,0
"15420",2019-02-01,"sbpk","transporte não regular","voo internacional",1,2,3,4,0,4,0,0,0,0
"15421",2019-02-01,"sbpl","transporte regular","voo doméstico",150,152,302,20132,18636,38768,0,0,0,0
"15422",2019-02-01,"sbpl","transporte regular","voo internacional",0,0,0,0,0,0,0,0,0,0
"15423",2019-02-01,"sbpl","transporte não regular","voo doméstico",77,77,154,170,121,291,0,0,0,0
"15424",2019-02-01,"sbpl","transporte não regular","voo internacional",0,0,0,0,0,0,0,0,0,0
"15425",2019-02-01,"sbpp","transporte regular","voo doméstico",0,0,0,0,0,0,0,0,0,0
"15426",2019-02-01,"sbpp","transporte regular","voo internacional",0,0,0,0,0,0,0,0,0,0
"15427",2019-02-01,"sbpp","transporte não regular","voo doméstico",73,76,149,130,126,256,0,0,0,0
"15428",2019-02-01,"sbpp","transporte não regular","voo internacional",7,5,12,4,5,9,0,0,0,0
"15429",2019-02-01,"sbpr","transporte regular","voo doméstico",0,0,0,0,0,0,0,0,0,0
"15430",2019-02-01,"sbpr","transporte regular","voo internacional",0,0,0,0,0,0,0,0,0,0
"15431",2019-02-01,"sbpr","transporte não regular","voo doméstico",697,696,1393,838,835,1673,0,0,0,0
"15432",2019-02-01,"sbpr","transporte não regular","voo internacional",1,1,2,0,0,0,0,0,0,0
"15433",2019-02-01,"sbpv","transporte regular","voo doméstico",283,284,567,31857,32882,64739,0,0,0,0
"15434",2019-02-01,"sbpv","transporte regular","voo internacional",0,0,0,0,0,0,0,0,0,0
"15435",2019-02-01,"sbpv","transporte não regular","voo doméstico",202,201,403,138,329,467,0,0,0,0
"15436",2019-02-01,"sbpv","transporte não regular","voo internacional",0,0,0,0,0,0,0,0,0,0
"15437",2019-02-01,"sbrb","transporte regular","voo doméstico",142,144,286,16293,14611,30904,0,0,0,0
"15438",2019-02-01,"sbrb","transporte regular","voo internacional",0,0,0,0,0,0,0,0,0,0
"15439",2019-02-01,"sbrb","transporte não regular","voo doméstico",123,118,241,480,464,944,0,0,0,0
"15440",2019-02-01,"sbrb","transporte não regular","voo internacional",1,2,3,4,0,4,0,0,0,0
"15441",2019-02-01,"sbrj","transporte regular","voo doméstico",3310,3332,6642,359099,363382,722481,0,0,0,0
"15442",2019-02-01,"sbrj","transporte regular","voo internacional",0,0,0,0,0,0,0,0,0,0
"15443",2019-02-01,"sbrj","transporte não regular","voo doméstico",535,511,1046,1703,845,2548,0,0,0,0
"15444",2019-02-01,"sbrj","transporte não regular","voo internacional",7,7,14,9,0,9,0,0,0,0
"15445",2019-02-01,"sbsj","transporte regular","voo doméstico",39,39,78,1614,1604,3218,0,0,0,0
"15446",2019-02-01,"sbsj","transporte regular","voo internacional",0,0,0,0,0,0,0,0,0,0
"15447",2019-02-01,"sbsj","transporte não regular","voo doméstico",317,312,629,774,869,1643,0,0,0,0
"15448",2019-02-01,"sbsj","transporte não regular","voo internacional",0,6,6,13,0,13,0,0,0,0
"15449",2019-02-01,"sbsl","transporte regular","voo doméstico",480,481,961,62691,59810,122501,0,0,0,0
"15450",2019-02-01,"sbsl","transporte regular","voo internacional",0,0,0,0,0,0,0,0,0,0
"15451",2019-02-01,"sbsl","transporte não regular","voo doméstico",136,140,276,275,150,425,0,0,0,0
"15452",2019-02-01,"sbsl","transporte não regular","voo internacional",1,2,3,0,0,0,0,0,0,0
"15453",2019-02-01,"sbsn","transporte regular","voo doméstico",216,214,430,16666,17834,34500,0,0,0,0
"15454",2019-02-01,"sbsn","transporte regular","voo internacional",0,0,0,0,0,0,0,0,0,0
"15455",2019-02-01,"sbsn","transporte não regular","voo doméstico",172,173,345,734,594,1328,6400,8200,14600,0
"15456",2019-02-01,"sbsn","transporte não regular","voo internacional",1,2,3,11,0,11,0,0,0,0
"15457",2019-02-01,"sbsp","transporte regular","voo doméstico",6693,6785,13478,883861,859147,1743008,0,0,0,0
"15458",2019-02-01,"sbsp","transporte regular","voo internacional",0,0,0,0,0,0,0,0,0,0
"15459",2019-02-01,"sbsp","transporte não regular","voo doméstico",1762,1657,3419,10722,11845,22567,0,0,0,0
"15460",2019-02-01,"sbsp","transporte não regular","voo internacional",2,2,4,2,2,4,0,0,0,0
"15461",2019-02-01,"sbte","transporte regular","voo doméstico",342,342,684,47644,42244,89888,0,0,0,0
"15462",2019-02-01,"sbte","transporte regular","voo internacional",0,0,0,0,0,0,0,0,0,0
"15463",2019-02-01,"sbte","transporte não regular","voo doméstico",109,108,217,668,645,1313,0,0,0,0
"15464",2019-02-01,"sbte","transporte não regular","voo internacional",0,0,0,0,0,0,0,0,0,0
"15465",2019-02-01,"sbtf","transporte regular","voo doméstico",28,28,56,1069,1323,2392,0,0,0,0
"15466",2019-02-01,"sbtf","transporte regular","voo internacional",0,0,0,0,0,0,0,0,0,0
"15467",2019-02-01,"sbtf","transporte não regular","voo doméstico",68,69,137,52,29,81,826,75,901,2125
"15468",2019-02-01,"sbtf","transporte não regular","voo internacional",0,0,0,0,0,0,0,0,0,0
"15469",2019-02-01,"sbtt","transporte regular","voo doméstico",28,28,56,2621,3029,5650,0,0,0,0
"15470",2019-02-01,"sbtt","transporte regular","voo internacional",0,0,0,0,0,0,0,0,0,0
"15471",2019-02-01,"sbtt","transporte não regular","voo doméstico",71,69,140,330,302,632,446,125,571,0
"15472",2019-02-01,"sbtt","transporte não regular","voo internacional",0,3,3,2,0,2,0,0,0,0
"15473",2019-02-01,"sbuf","transporte regular","voo doméstico",8,8,16,519,397,916,0,0,0,0
"15474",2019-02-01,"sbuf","transporte regular","voo internacional",0,0,0,0,0,0,0,0,0,0
"15475",2019-02-01,"sbuf","transporte não regular","voo doméstico",28,29,57,37,22,59,0,0,0,0
"15476",2019-02-01,"sbuf","transporte não regular","voo internacional",0,0,0,0,0,0,0,0,0,0
"15477",2019-02-01,"sbug","transporte regular","voo doméstico",15,15,30,864,880,1744,0,0,0,0
"15478",2019-02-01,"sbug","transporte regular","voo internacional",0,0,0,0,0,0,0,0,0,0
"15479",2019-02-01,"sbug","transporte não regular","voo doméstico",8,8,16,19,19,38,0,0,0,0
"15480",2019-02-01,"sbug","transporte não regular","voo internacional",0,0,0,0,0,0,0,0,0,0
"15481",2019-02-01,"sbul","transporte regular","voo doméstico",500,498,998,43529,44839,88368,0,0,0,0
"15482",2019-02-01,"sbul","transporte regular","voo internacional",0,0,0,0,0,0,0,0,0,0
"15483",2019-02-01,"sbul","transporte não regular","voo doméstico",363,360,723,1177,944,2121,0,0,0,0
"15484",2019-02-01,"sbul","transporte não regular","voo internacional",0,0,0,0,0,0,0,0,0,0
"15485",2019-02-01,"sbur","transporte regular","voo doméstico",55,54,109,2747,2880,5627,0,0,0,0
"15486",2019-02-01,"sbur","transporte regular","voo internacional",0,0,0,0,0,0,0,0,0,0
"15487",2019-02-01,"sbur","transporte não regular","voo doméstico",154,158,312,519,522,1041,0,0,0,0
"15488",2019-02-01,"sbur","transporte não regular","voo internacional",0,0,0,0,0,0,0,0,0,0
"15489",2019-01-01,"sbbe","transporte regular","voo doméstico",1183,1179,2362,156812,153619,310431,0,0,0,0
"15490",2019-01-01,"sbbe","transporte regular","voo internacional",57,57,114,7915,7083,14998,0,1,1,0
"15491",2019-01-01,"sbbe","transporte não regular","voo doméstico",360,365,725,2470,2682,5152,0,0,0,0
"15492",2019-01-01,"sbbe","transporte não regular","voo internacional",4,3,7,8,143,151,0,0,0,0
"15493",2019-01-01,"sbbg","transporte regular","voo doméstico",0,0,0,0,0,0,0,0,0,0
"15494",2019-01-01,"sbbg","transporte regular","voo internacional",0,0,0,0,0,0,0,0,0,0
"15495",2019-01-01,"sbbg","transporte não regular","voo doméstico",15,16,31,44,59,103,0,0,0,0
"15496",2019-01-01,"sbbg","transporte não regular","voo internacional",2,1,3,4,11,15,0,0,0,0
"15497",2019-01-01,"sbbh","transporte regular","voo doméstico",0,0,0,0,0,0,0,0,0,0
"15498",2019-01-01,"sbbh","transporte regular","voo internacional",0,0,0,0,0,0,0,0,0,0
"15499",2019-01-01,"sbbh","transporte não regular","voo doméstico",1616,1587,3203,7878,7980,15858,0,0,0,0
"15500",2019-01-01,"sbbh","transporte não regular","voo internacional",0,0,0,0,0,0,0,0,0,0
"15501",2019-01-01,"sbbi","transporte regular","voo doméstico",0,0,0,0,0,0,0,0,0,0
"15502",2019-01-01,"sbbi","transporte regular","voo internacional",0,0,0,0,0,0,0,0,0,0
"15503",2019-01-01,"sbbi","transporte não regular","voo doméstico",1176,1160,2336,799,764,1563,0,0,0,0
"15504",2019-01-01,"sbbi","transporte não regular","voo internacional",0,0,0,0,0,0,0,0,0,0
"15505",2019-01-01,"sbbv","transporte regular","voo doméstico",96,96,192,15722,14118,29840,0,0,0,0
"15506",2019-01-01,"sbbv","transporte regular","voo internacional",0,0,0,0,0,0,0,0,0,0
"15507",2019-01-01,"sbbv","transporte não regular","voo doméstico",61,62,123,100,40,140,0,0,0,0
"15508",2019-01-01,"sbbv","transporte não regular","voo internacional",14,14,28,9,0,9,0,0,0,0
"15509",2019-01-01,"sbcg","transporte regular","voo doméstico",633,634,1267,74556,74805,149361,84029,99889,183918,0
"15510",2019-01-01,"sbcg","transporte regular","voo internacional",0,0,0,0,0,0,0,0,0,0
"15511",2019-01-01,"sbcg","transporte não regular","voo doméstico",153,155,308,709,1022,1731,0,0,0,0
"15512",2019-01-01,"sbcg","transporte não regular","voo internacional",5,2,7,0,0,0,0,0,0,0
"15513",2019-01-01,"sbcj","transporte regular","voo doméstico",78,78,156,4240,5657,9897,0,0,0,0
"15514",2019-01-01,"sbcj","transporte regular","voo internacional",0,0,0,0,0,0,0,0,0,0
"15515",2019-01-01,"sbcj","transporte não regular","voo doméstico",70,71,141,916,227,1143,0,0,0,0
"15516",2019-01-01,"sbcj","transporte não regular","voo internacional",0,0,0,0,0,0,0,0,0,0
"15517",2019-01-01,"sbcr","transporte regular","voo doméstico",26,26,52,1216,1386,2602,0,0,0,0
"15518",2019-01-01,"sbcr","transporte regular","voo internacional",0,0,0,0,0,0,0,0,0,0
"15519",2019-01-01,"sbcr","transporte não regular","voo doméstico",46,44,90,24,30,54,0,0,0,0
"15520",2019-01-01,"sbcr","transporte não regular","voo internacional",2,3,5,5,1,6,0,0,0,0
"15521",2019-01-01,"sbct","transporte regular","voo doméstico",2208,2215,4423,246570,240717,487287,161872,59842,221714,160732
"15522",2019-01-01,"sbct","transporte regular","voo internacional",77,77,154,2674,2849,5523,0,8820,8820,0
"15523",2019-01-01,"sbct","transporte não regular","voo doméstico",351,349,700,18227,18202,36429,0,0,0,0
"15524",2019-01-01,"sbct","transporte não regular","voo internacional",10,6,16,13,30,43,0,0,0,0
"15525",2019-01-01,"sbcz","transporte regular","voo doméstico",30,29,59,3139,1599,4738,0,0,0,0
"15526",2019-01-01,"sbcz","transporte regular","voo internacional",0,0,0,0,0,0,0,0,0,0
"15527",2019-01-01,"sbcz","transporte não regular","voo doméstico",132,131,263,514,509,1023,0,0,0,0
"15528",2019-01-01,"sbcz","transporte não regular","voo internacional",0,0,0,0,0,0,0,0,0,0
"15529",2019-01-01,"sbeg","transporte regular","voo doméstico",1092,1093,2185,136706,139092,275798,141097,200529,341626,0
"15530",2019-01-01,"sbeg","transporte regular","voo internacional",101,101,202,6258,6297,12555,0,0,0,0
"15531",2019-01-01,"sbeg","transporte não regular","voo doméstico",456,458,914,4594,3041,7635,0,0,0,0
"15532",2019-01-01,"sbeg","transporte não regular","voo internacional",66,60,126,51,336,387,0,0,0,0
"15533",2019-01-01,"sbfi","transporte regular","voo doméstico",657,640,1297,93560,89282,182842,0,0,0,0
"15534",2019-01-01,"sbfi","transporte regular","voo internacional",22,22,44,2504,2274,4778,0,0,0,0
"15535",2019-01-01,"sbfi","transporte não regular","voo doméstico",404,411,815,37773,31822,69595,0,0,0,0
"15536",2019-01-01,"sbfi","transporte não regular","voo internacional",32,38,70,47,47,94,0,0,0,0
"15537",2019-01-01,"sbgo","transporte regular","voo doméstico",1351,1343,2694,138237,144857,283094,270929,329641,600570,0
"15538",2019-01-01,"sbgo","transporte regular","voo internacional",0,0,0,0,0,0,0,0,0,0
"15539",2019-01-01,"sbgo","transporte não regular","voo doméstico",1144,1124,2268,4269,4339,8608,0,0,0,0
"15540",2019-01-01,"sbgo","transporte não regular","voo internacional",1,1,2,0,0,0,0,0,0,0
"15541",2019-01-01,"sbht","transporte regular","voo doméstico",85,85,170,3884,3973,7857,0,0,0,0
"15542",2019-01-01,"sbht","transporte regular","voo internacional",0,0,0,0,0,0,0,0,0,0
"15543",2019-01-01,"sbht","transporte não regular","voo doméstico",41,38,79,122,237,359,0,0,0,0
"15544",2019-01-01,"sbht","transporte não regular","voo internacional",0,0,0,0,0,0,0,0,0,0
"15545",2019-01-01,"sbiz","transporte regular","voo doméstico",124,125,249,14841,14314,29155,0,0,0,0
"15546",2019-01-01,"sbiz","transporte regular","voo internacional",0,0,0,0,0,0,0,0,0,0
"15547",2019-01-01,"sbiz","transporte não regular","voo doméstico",66,64,130,167,138,305,0,0,0,0
"15548",2019-01-01,"sbiz","transporte não regular","voo internacional",0,0,0,0,0,0,0,0,0,0
"15549",2019-01-01,"sbjc","transporte regular","voo doméstico",0,0,0,0,0,0,0,0,0,0
"15550",2019-01-01,"sbjc","transporte regular","voo internacional",0,0,0,0,0,0,0,0,0,0
"15551",2019-01-01,"sbjc","transporte não regular","voo doméstico",202,201,403,358,237,595,0,0,0,0
"15552",2019-01-01,"sbjc","transporte não regular","voo internacional",0,0,0,0,0,0,0,0,0,0
"15553",2019-01-01,"sbjr","transporte regular","voo doméstico",0,0,0,0,0,0,0,0,0,0
"15554",2019-01-01,"sbjr","transporte regular","voo internacional",0,0,0,0,0,0,0,0,0,0
"15555",2019-01-01,"sbjr","transporte não regular","voo doméstico",3638,3636,7274,11231,3039,14270,0,0,0,0
"15556",2019-01-01,"sbjr","transporte não regular","voo internacional",1,1,2,1,0,1,0,0,0,0
"15557",2019-01-01,"sbjv","transporte regular","voo doméstico",197,196,393,21407,19749,41156,0,0,0,0
"15558",2019-01-01,"sbjv","transporte regular","voo internacional",0,0,0,0,0,0,0,0,0,0
"15559",2019-01-01,"sbjv","transporte não regular","voo doméstico",77,78,155,86,33,119,0,0,0,0
"15560",2019-01-01,"sbjv","transporte não regular","voo internacional",0,0,0,0,0,0,0,0,0,0
"15561",2019-01-01,"sblo","transporte regular","voo doméstico",385,384,769,38683,36762,75445,0,0,0,0
"15562",2019-01-01,"sblo","transporte regular","voo internacional",0,0,0,0,0,0,0,0,0,0
"15563",2019-01-01,"sblo","transporte não regular","voo doméstico",431,433,864,766,330,1096,0,0,0,0
"15564",2019-01-01,"sblo","transporte não regular","voo internacional",3,3,6,0,0,0,0,0,0,0
"15565",2019-01-01,"sbma","transporte regular","voo doméstico",130,129,259,11926,11935,23861,0,0,0,0
"15566",2019-01-01,"sbma","transporte regular","voo internacional",0,0,0,0,0,0,0,0,0,0
"15567",2019-01-01,"sbma","transporte não regular","voo doméstico",103,103,206,306,325,631,0,0,0,0
"15568",2019-01-01,"sbma","transporte não regular","voo internacional",0,0,0,0,0,0,0,0,0,0
"15569",2019-01-01,"sbmk","transporte regular","voo doméstico",133,131,264,9615,7992,17607,0,0,0,0
"15570",2019-01-01,"sbmk","transporte regular","voo internacional",0,0,0,0,0,0,0,0,0,0
"15571",2019-01-01,"sbmk","transporte não regular","voo doméstico",201,202,403,369,3,372,0,0,0,0
"15572",2019-01-01,"sbmk","transporte não regular","voo internacional",0,0,0,0,0,0,0,0,0,0
"15573",2019-01-01,"sbmq","transporte regular","voo doméstico",223,224,447,26519,25960,52479,20950,35823,56773,4800
"15574",2019-01-01,"sbmq","transporte regular","voo internacional",0,0,0,0,0,0,0,0,0,0
"15575",2019-01-01,"sbmq","transporte não regular","voo doméstico",83,83,166,152,120,272,0,0,0,0
"15576",2019-01-01,"sbmq","transporte não regular","voo internacional",3,3,6,0,0,0,0,0,0,0
"15577",2019-01-01,"sbmt","transporte regular","voo doméstico",0,0,0,0,0,0,0,0,0,0
"15578",2019-01-01,"sbmt","transporte regular","voo internacional",0,0,0,0,0,0,0,0,0,0
"15579",2019-01-01,"sbmt","transporte não regular","voo doméstico",2940,2911,5851,4251,4421,8672,0,0,0,0
"15580",2019-01-01,"sbmt","transporte não regular","voo internacional",0,0,0,0,0,0,0,0,0,0
"15581",2019-01-01,"sbnf","transporte regular","voo doméstico",769,771,1540,100023,91358,191381,0,0,0,0
"15582",2019-01-01,"sbnf","transporte regular","voo internacional",31,31,62,3197,3265,6462,0,0,0,0
"15583",2019-01-01,"sbnf","transporte não regular","voo doméstico",433,440,873,1745,1161,2906,0,0,0,0
"15584",2019-01-01,"sbnf","transporte não regular","voo internacional",8,11,19,29,7,36,0,0,0,0
"15585",2019-01-01,"sbpb","transporte regular","voo doméstico",4,4,8,344,374,718,0,0,0,0
"15586",2019-01-01,"sbpb","transporte regular","voo internacional",0,0,0,0,0,0,0,0,0,0
"15587",2019-01-01,"sbpb","transporte não regular","voo doméstico",35,40,75,139,87,226,0,0,0,0
"15588",2019-01-01,"sbpb","transporte não regular","voo internacional",0,0,0,0,0,0,0,0,0,0
"15589",2019-01-01,"sbpj","transporte regular","voo doméstico",230,231,461,23769,25334,49103,0,0,0,0
"15590",2019-01-01,"sbpj","transporte regular","voo internacional",0,0,0,0,0,0,0,0,0,0
"15591",2019-01-01,"sbpj","transporte não regular","voo doméstico",203,198,401,526,413,939,0,0,0,0
"15592",2019-01-01,"sbpj","transporte não regular","voo internacional",0,0,0,0,0,0,0,0,0,0
"15593",2019-01-01,"sbpk","transporte regular","voo doméstico",26,26,52,1525,1614,3139,0,0,0,0
"15594",2019-01-01,"sbpk","transporte regular","voo internacional",0,0,0,0,0,0,0,0,0,0
"15595",2019-01-01,"sbpk","transporte não regular","voo doméstico",71,72,143,366,372,738,0,0,0,0
"15596",2019-01-01,"sbpk","transporte não regular","voo internacional",6,5,11,0,2,2,0,0,0,0
"15597",2019-01-01,"sbpl","transporte regular","voo doméstico",173,172,345,22132,22230,44362,0,0,0,0
"15598",2019-01-01,"sbpl","transporte regular","voo internacional",0,0,0,0,0,0,0,0,0,0
"15599",2019-01-01,"sbpl","transporte não regular","voo doméstico",60,61,121,103,91,194,0,0,0,0
"15600",2019-01-01,"sbpl","transporte não regular","voo internacional",0,0,0,0,0,0,0,0,0,0
"15601",2019-01-01,"sbpp","transporte regular","voo doméstico",0,0,0,0,0,0,0,0,0,0
"15602",2019-01-01,"sbpp","transporte regular","voo internacional",0,0,0,0,0,0,0,0,0,0
"15603",2019-01-01,"sbpp","transporte não regular","voo doméstico",80,80,160,128,110,238,0,0,0,0
"15604",2019-01-01,"sbpp","transporte não regular","voo internacional",2,1,3,1,9,10,0,0,0,0
"15605",2019-01-01,"sbpr","transporte regular","voo doméstico",0,0,0,0,0,0,0,0,0,0
"15606",2019-01-01,"sbpr","transporte regular","voo internacional",0,0,0,0,0,0,0,0,0,0
"15607",2019-01-01,"sbpr","transporte não regular","voo doméstico",888,878,1766,1040,1045,2085,0,0,0,0
"15608",2019-01-01,"sbpr","transporte não regular","voo internacional",2,2,4,0,0,0,0,0,0,0
"15609",2019-01-01,"sbpv","transporte regular","voo doméstico",335,334,669,40968,39548,80516,0,0,0,0
"15610",2019-01-01,"sbpv","transporte regular","voo internacional",0,0,0,0,0,0,0,0,0,0
"15611",2019-01-01,"sbpv","transporte não regular","voo doméstico",159,161,320,215,0,215,0,0,0,0
"15612",2019-01-01,"sbpv","transporte não regular","voo internacional",0,0,0,0,0,0,0,0,0,0
"15613",2019-01-01,"sbrb","transporte regular","voo doméstico",164,164,328,18281,16160,34441,0,0,0,0
"15614",2019-01-01,"sbrb","transporte regular","voo internacional",0,0,0,0,0,0,0,0,0,0
"15615",2019-01-01,"sbrb","transporte não regular","voo doméstico",123,123,246,436,544,980,0,0,0,0
"15616",2019-01-01,"sbrb","transporte não regular","voo internacional",0,0,0,0,0,0,0,0,0,0
"15617",2019-01-01,"sbrj","transporte regular","voo doméstico",3683,3704,7387,424118,387743,811861,0,0,0,0
"15618",2019-01-01,"sbrj","transporte regular","voo internacional",0,0,0,0,0,0,0,0,0,0
"15619",2019-01-01,"sbrj","transporte não regular","voo doméstico",483,463,946,1372,740,2112,0,0,0,0
"15620",2019-01-01,"sbrj","transporte não regular","voo internacional",3,4,7,0,0,0,0,0,0,0
"15621",2019-01-01,"sbsj","transporte regular","voo doméstico",17,17,34,861,904,1765,0,0,0,0
"15622",2019-01-01,"sbsj","transporte regular","voo internacional",0,0,0,0,0,0,0,0,0,0
"15623",2019-01-01,"sbsj","transporte não regular","voo doméstico",356,342,698,726,695,1421,0,0,0,0
"15624",2019-01-01,"sbsj","transporte não regular","voo internacional",1,2,3,1,1,2,0,0,0,0
"15625",2019-01-01,"sbsl","transporte regular","voo doméstico",623,620,1243,80754,76673,157427,0,0,0,0
"15626",2019-01-01,"sbsl","transporte regular","voo internacional",0,0,0,0,0,0,0,0,0,0
"15627",2019-01-01,"sbsl","transporte não regular","voo doméstico",172,169,341,695,379,1074,0,0,0,0
"15628",2019-01-01,"sbsl","transporte não regular","voo internacional",2,2,4,0,0,0,0,0,0,0
"15629",2019-01-01,"sbsn","transporte regular","voo doméstico",261,262,523,24486,19547,44033,0,0,0,0
"15630",2019-01-01,"sbsn","transporte regular","voo internacional",0,0,0,0,0,0,0,0,0,0
"15631",2019-01-01,"sbsn","transporte não regular","voo doméstico",178,177,355,2724,2760,5484,3030,4420,7450,0
"15632",2019-01-01,"sbsn","transporte não regular","voo internacional",0,0,0,0,0,0,0,0,0,0
"15633",2019-01-01,"sbsp","transporte regular","voo doméstico",7173,7245,14418,930623,964260,1894883,0,0,0,0
"15634",2019-01-01,"sbsp","transporte regular","voo internacional",0,0,0,0,0,0,0,0,0,0
"15635",2019-01-01,"sbsp","transporte não regular","voo doméstico",2069,1985,4054,66549,71279,137828,0,0,0,0
"15636",2019-01-01,"sbsp","transporte não regular","voo internacional",3,3,6,2,2,4,0,0,0,0
"15637",2019-01-01,"sbte","transporte regular","voo doméstico",448,447,895,62386,56727,119113,0,0,0,0
"15638",2019-01-01,"sbte","transporte regular","voo internacional",0,0,0,0,0,0,0,0,0,0
"15639",2019-01-01,"sbte","transporte não regular","voo doméstico",128,134,262,768,659,1427,0,0,0,0
"15640",2019-01-01,"sbte","transporte não regular","voo internacional",0,0,0,0,0,0,0,0,0,0
"15641",2019-01-01,"sbtf","transporte regular","voo doméstico",40,40,80,1792,1865,3657,0,0,0,0
"15642",2019-01-01,"sbtf","transporte regular","voo internacional",0,0,0,0,0,0,0,0,0,0
"15643",2019-01-01,"sbtf","transporte não regular","voo doméstico",71,70,141,55,25,80,278,120,398,925
"15644",2019-01-01,"sbtf","transporte não regular","voo internacional",0,0,0,0,0,0,0,0,0,0
"15645",2019-01-01,"sbtt","transporte regular","voo doméstico",31,31,62,3124,3403,6527,0,0,0,0
"15646",2019-01-01,"sbtt","transporte regular","voo internacional",0,0,0,0,0,0,0,0,0,0
"15647",2019-01-01,"sbtt","transporte não regular","voo doméstico",79,78,157,318,304,622,1687,286,1973,0
"15648",2019-01-01,"sbtt","transporte não regular","voo internacional",3,3,6,12,12,24,0,0,0,0
"15649",2019-01-01,"sbuf","transporte regular","voo doméstico",8,8,16,477,513,990,0,0,0,0
"15650",2019-01-01,"sbuf","transporte regular","voo internacional",0,0,0,0,0,0,0,0,0,0
"15651",2019-01-01,"sbuf","transporte não regular","voo doméstico",13,12,25,39,40,79,0,0,0,0
"15652",2019-01-01,"sbuf","transporte não regular","voo internacional",0,0,0,0,0,0,0,0,0,0
"15653",2019-01-01,"sbug","transporte regular","voo doméstico",16,16,32,831,751,1582,0,0,0,0
"15654",2019-01-01,"sbug","transporte regular","voo internacional",0,0,0,0,0,0,0,0,0,0
"15655",2019-01-01,"sbug","transporte não regular","voo doméstico",6,6,12,12,12,24,0,0,0,0
"15656",2019-01-01,"sbug","transporte não regular","voo internacional",0,0,0,0,0,0,0,0,0,0
"15657",2019-01-01,"sbul","transporte regular","voo doméstico",510,508,1018,49634,47277,96911,0,0,0,0
"15658",2019-01-01,"sbul","transporte regular","voo internacional",0,0,0,0,0,0,0,0,0,0
"15659",2019-01-01,"sbul","transporte não regular","voo doméstico",488,492,980,1714,1580,3294,0,0,0,0
"15660",2019-01-01,"sbul","transporte não regular","voo internacional",1,1,2,2,2,4,0,0,0,0
"15661",2019-01-01,"sbur","transporte regular","voo doméstico",34,33,67,1821,1825,3646,0,0,0,0
"15662",2019-01-01,"sbur","transporte regular","voo internacional",0,0,0,0,0,0,0,0,0,0
"15663",2019-01-01,"sbur","transporte não regular","voo doméstico",167,170,337,535,504,1039,0,0,0,0
"15664",2019-01-01,"sbur","transporte não regular","voo internacional",0,0,0,0,0,0,0,0,0,0
"15665",2019-07-01,"sbbe","transporte regular","voo doméstico",1228,1235,2463,171304,167835,339139,0,0,0,0
"15666",2019-07-01,"sbbe","transporte regular","voo internacional",59,59,118,8445,8411,16856,0,5,5,0
"15667",2019-07-01,"sbbe","transporte não regular","voo doméstico",458,457,915,951,1388,2339,0,0,0,0
"15668",2019-07-01,"sbbe","transporte não regular","voo internacional",10,8,18,183,16,199,0,0,0,0
"15669",2019-07-01,"sbbg","transporte regular","voo doméstico",0,0,0,0,0,0,0,0,0,0
"15670",2019-07-01,"sbbg","transporte regular","voo internacional",0,0,0,0,0,0,0,0,0,0
"15671",2019-07-01,"sbbg","transporte não regular","voo doméstico",15,14,29,62,51,113,0,0,0,0
"15672",2019-07-01,"sbbg","transporte não regular","voo internacional",1,2,3,0,4,4,0,0,0,0
"15673",2019-07-01,"sbbh","transporte regular","voo doméstico",19,19,38,102,79,181,0,0,0,0
"15674",2019-07-01,"sbbh","transporte regular","voo internacional",0,0,0,0,0,0,0,0,0,0
"15675",2019-07-01,"sbbh","transporte não regular","voo doméstico",1500,1495,2995,7453,7478,14931,0,0,0,0
"15676",2019-07-01,"sbbh","transporte não regular","voo internacional",4,4,8,24,24,48,0,0,0,0
"15677",2019-07-01,"sbbi","transporte regular","voo doméstico",0,0,0,0,0,0,0,0,0,0
"15678",2019-07-01,"sbbi","transporte regular","voo internacional",0,0,0,0,0,0,0,0,0,0
"15679",2019-07-01,"sbbi","transporte não regular","voo doméstico",1266,1256,2522,1068,1065,2133,0,0,0,0
"15680",2019-07-01,"sbbi","transporte não regular","voo internacional",1,1,2,0,0,0,0,0,0,0
"15681",2019-07-01,"sbbv","transporte regular","voo doméstico",102,102,204,16446,13806,30252,0,0,0,0
"15682",2019-07-01,"sbbv","transporte regular","voo internacional",0,0,0,0,0,0,0,0,0,0
"15683",2019-07-01,"sbbv","transporte não regular","voo doméstico",56,62,118,57,32,89,0,0,0,0
"15684",2019-07-01,"sbbv","transporte não regular","voo internacional",19,14,33,1,0,1,0,0,0,0
"15685",2019-07-01,"sbcg","transporte regular","voo doméstico",566,566,1132,66639,67525,134164,61532,68448,129980,0
"15686",2019-07-01,"sbcg","transporte regular","voo internacional",0,0,0,0,0,0,0,0,0,0
"15687",2019-07-01,"sbcg","transporte não regular","voo doméstico",240,249,489,652,337,989,0,0,0,0
"15688",2019-07-01,"sbcg","transporte não regular","voo internacional",9,5,14,0,0,0,0,0,0,0
"15689",2019-07-01,"sbcj","transporte regular","voo doméstico",88,88,176,5987,8170,14157,0,0,0,0
"15690",2019-07-01,"sbcj","transporte regular","voo internacional",0,0,0,0,0,0,0,0,0,0
"15691",2019-07-01,"sbcj","transporte não regular","voo doméstico",100,100,200,1063,707,1770,0,0,0,0
"15692",2019-07-01,"sbcj","transporte não regular","voo internacional",1,1,2,0,0,0,0,0,0,0
"15693",2019-07-01,"sbcr","transporte regular","voo doméstico",21,21,42,1222,1943,3165,0,0,0,0
"15694",2019-07-01,"sbcr","transporte regular","voo internacional",0,0,0,0,0,0,0,0,0,0
"15695",2019-07-01,"sbcr","transporte não regular","voo doméstico",43,42,85,76,59,135,0,0,0,0
"15696",2019-07-01,"sbcr","transporte não regular","voo internacional",0,0,0,0,0,0,0,0,0,0
"15697",2019-07-01,"sbct","transporte regular","voo doméstico",2483,2484,4967,285464,281172,566636,123509,55643,179152,194655
"15698",2019-07-01,"sbct","transporte regular","voo internacional",81,81,162,3943,3886,7829,37223,36346,73569,0
"15699",2019-07-01,"sbct","transporte não regular","voo doméstico",257,262,519,1798,1686,3484,0,0,0,0
"15700",2019-07-01,"sbct","transporte não regular","voo internacional",20,16,36,173,55,228,0,0,0,0
"15701",2019-07-01,"sbcz","transporte regular","voo doméstico",29,29,58,2162,974,3136,0,0,0,0
"15702",2019-07-01,"sbcz","transporte regular","voo internacional",0,0,0,0,0,0,0,0,0,0
"15703",2019-07-01,"sbcz","transporte não regular","voo doméstico",230,233,463,1003,815,1818,0,0,0,0
"15704",2019-07-01,"sbcz","transporte não regular","voo internacional",0,0,0,0,0,0,0,0,0,0
"15705",2019-07-01,"sbeg","transporte regular","voo doméstico",1083,1084,2167,131140,132803,263943,135758,231263,367021,0
"15706",2019-07-01,"sbeg","transporte regular","voo internacional",101,105,206,6233,6376,12609,0,0,0,0
"15707",2019-07-01,"sbeg","transporte não regular","voo doméstico",503,489,992,4723,4554,9277,0,0,0,0
"15708",2019-07-01,"sbeg","transporte não regular","voo internacional",92,102,194,87,0,87,0,0,0,0
"15709",2019-07-01,"sbfi","transporte regular","voo doméstico",629,631,1260,85817,80664,166481,0,0,0,0
"15710",2019-07-01,"sbfi","transporte regular","voo internacional",26,26,52,2628,2057,4685,0,0,0,0
"15711",2019-07-01,"sbfi","transporte não regular","voo doméstico",261,251,512,18651,18868,37519,0,0,0,0
"15712",2019-07-01,"sbfi","transporte não regular","voo internacional",47,52,99,80,93,173,0,0,0,0
"15713",2019-07-01,"sbgo","transporte regular","voo doméstico",1300,1301,2601,150964,148762,299726,212239,279178,491417,0
"15714",2019-07-01,"sbgo","transporte regular","voo internacional",0,0,0,0,0,0,0,0,0,0
"15715",2019-07-01,"sbgo","transporte não regular","voo doméstico",1093,1118,2211,5404,4416,9820,0,0,0,0
"15716",2019-07-01,"sbgo","transporte não regular","voo internacional",2,1,3,0,0,0,0,0,0,0
"15717",2019-07-01,"sbht","transporte regular","voo doméstico",85,85,170,4227,4228,8455,0,0,0,0
"15718",2019-07-01,"sbht","transporte regular","voo internacional",0,0,0,0,0,0,0,0,0,0
"15719",2019-07-01,"sbht","transporte não regular","voo doméstico",56,52,108,143,77,220,0,0,0,0
"15720",2019-07-01,"sbht","transporte não regular","voo internacional",0,0,0,0,0,0,0,0,0,0
"15721",2019-07-01,"sbiz","transporte regular","voo doméstico",129,129,258,18390,17997,36387,0,0,0,0
"15722",2019-07-01,"sbiz","transporte regular","voo internacional",0,0,0,0,0,0,0,0,0,0
"15723",2019-07-01,"sbiz","transporte não regular","voo doméstico",114,109,223,179,158,337,0,0,0,0
"15724",2019-07-01,"sbiz","transporte não regular","voo internacional",0,0,0,0,0,0,0,0,0,0
"15725",2019-07-01,"sbjc","transporte regular","voo doméstico",0,0,0,0,0,0,0,0,0,0
"15726",2019-07-01,"sbjc","transporte regular","voo internacional",0,0,0,0,0,0,0,0,0,0
"15727",2019-07-01,"sbjc","transporte não regular","voo doméstico",253,256,509,592,308,900,0,0,0,0
"15728",2019-07-01,"sbjc","transporte não regular","voo internacional",0,0,0,0,0,0,0,0,0,0
"15729",2019-07-01,"sbjr","transporte regular","voo doméstico",0,0,0,0,0,0,0,0,0,0
"15730",2019-07-01,"sbjr","transporte regular","voo internacional",0,0,0,0,0,0,0,0,0,0
"15731",2019-07-01,"sbjr","transporte não regular","voo doméstico",2674,2680,5354,11113,4783,15896,0,0,0,0
"15732",2019-07-01,"sbjr","transporte não regular","voo internacional",0,0,0,0,0,0,0,0,0,0
"15733",2019-07-01,"sbjv","transporte regular","voo doméstico",249,249,498,27922,27300,55222,0,0,0,0
"15734",2019-07-01,"sbjv","transporte regular","voo internacional",0,0,0,0,0,0,0,0,0,0
"15735",2019-07-01,"sbjv","transporte não regular","voo doméstico",92,92,184,96,292,388,0,0,0,0
"15736",2019-07-01,"sbjv","transporte não regular","voo internacional",0,0,0,0,0,0,0,0,0,0
"15737",2019-07-01,"sblo","transporte regular","voo doméstico",455,455,910,43189,44605,87794,0,0,0,0
"15738",2019-07-01,"sblo","transporte regular","voo internacional",0,0,0,0,0,0,0,0,0,0
"15739",2019-07-01,"sblo","transporte não regular","voo doméstico",415,419,834,313,586,899,0,0,0,0
"15740",2019-07-01,"sblo","transporte não regular","voo internacional",5,4,9,0,0,0,0,0,0,0
"15741",2019-07-01,"sbma","transporte regular","voo doméstico",133,132,265,12885,14189,27074,0,0,0,0
"15742",2019-07-01,"sbma","transporte regular","voo internacional",0,0,0,0,0,0,0,0,0,0
"15743",2019-07-01,"sbma","transporte não regular","voo doméstico",128,128,256,151,139,290,0,0,0,0
"15744",2019-07-01,"sbma","transporte não regular","voo internacional",1,1,2,0,0,0,0,0,0,0
"15745",2019-07-01,"sbmk","transporte regular","voo doméstico",134,135,269,9599,9375,18974,0,0,0,0
"15746",2019-07-01,"sbmk","transporte regular","voo internacional",0,0,0,0,0,0,0,0,0,0
"15747",2019-07-01,"sbmk","transporte não regular","voo doméstico",182,179,361,389,3,392,0,0,0,0
"15748",2019-07-01,"sbmk","transporte não regular","voo internacional",0,0,0,0,0,0,0,0,0,0
"15749",2019-07-01,"sbmq","transporte regular","voo doméstico",235,237,472,33121,28944,62065,16300,26760,43060,0
"15750",2019-07-01,"sbmq","transporte regular","voo internacional",0,0,0,0,0,0,0,0,0,0
"15751",2019-07-01,"sbmq","transporte não regular","voo doméstico",114,111,225,203,72,275,0,2200,2200,0
"15752",2019-07-01,"sbmq","transporte não regular","voo internacional",5,6,11,0,0,0,0,0,0,0
"15753",2019-07-01,"sbmt","transporte regular","voo doméstico",0,0,0,0,0,0,0,0,0,0
"15754",2019-07-01,"sbmt","transporte regular","voo internacional",0,0,0,0,0,0,0,0,0,0
"15755",2019-07-01,"sbmt","transporte não regular","voo doméstico",2704,2690,5394,3906,4201,8107,0,0,0,0
"15756",2019-07-01,"sbmt","transporte não regular","voo internacional",0,0,0,0,0,0,0,0,0,0
"15757",2019-07-01,"sbnf","transporte regular","voo doméstico",679,681,1360,84295,83380,167675,0,0,0,0
"15758",2019-07-01,"sbnf","transporte regular","voo internacional",0,0,0,0,0,0,0,0,0,0
"15759",2019-07-01,"sbnf","transporte não regular","voo doméstico",284,282,566,2664,2583,5247,0,0,0,0
"15760",2019-07-01,"sbnf","transporte não regular","voo internacional",0,1,1,0,0,0,0,0,0,0
"15761",2019-07-01,"sbpb","transporte regular","voo doméstico",4,4,8,308,453,761,0,0,0,0
"15762",2019-07-01,"sbpb","transporte regular","voo internacional",0,0,0,0,0,0,0,0,0,0
"15763",2019-07-01,"sbpb","transporte não regular","voo doméstico",60,60,120,165,136,301,0,0,0,0
"15764",2019-07-01,"sbpb","transporte não regular","voo internacional",0,0,0,0,0,0,0,0,0,0
"15765",2019-07-01,"sbpj","transporte regular","voo doméstico",323,323,646,28540,28264,56804,0,0,0,0
"15766",2019-07-01,"sbpj","transporte regular","voo internacional",0,0,0,0,0,0,0,0,0,0
"15767",2019-07-01,"sbpj","transporte não regular","voo doméstico",226,228,454,696,338,1034,0,0,0,0
"15768",2019-07-01,"sbpj","transporte não regular","voo internacional",2,3,5,0,0,0,0,0,0,0
"15769",2019-07-01,"sbpk","transporte regular","voo doméstico",22,22,44,1087,1039,2126,0,0,0,0
"15770",2019-07-01,"sbpk","transporte regular","voo internacional",0,0,0,0,0,0,0,0,0,0
"15771",2019-07-01,"sbpk","transporte não regular","voo doméstico",32,34,66,93,78,171,0,0,0,0
"15772",2019-07-01,"sbpk","transporte não regular","voo internacional",5,2,7,4,8,12,0,0,0,0
"15773",2019-07-01,"sbpl","transporte regular","voo doméstico",151,151,302,17013,16624,33637,0,0,0,0
"15774",2019-07-01,"sbpl","transporte regular","voo internacional",5,5,10,0,0,0,0,0,0,0
"15775",2019-07-01,"sbpl","transporte não regular","voo doméstico",81,81,162,147,132,279,0,0,0,0
"15776",2019-07-01,"sbpl","transporte não regular","voo internacional",1,1,2,12,12,24,0,0,0,0
"15777",2019-07-01,"sbpp","transporte regular","voo doméstico",0,0,0,0,0,0,0,0,0,0
"15778",2019-07-01,"sbpp","transporte regular","voo internacional",0,0,0,0,0,0,0,0,0,0
"15779",2019-07-01,"sbpp","transporte não regular","voo doméstico",82,84,166,172,156,328,0,0,0,0
"15780",2019-07-01,"sbpp","transporte não regular","voo internacional",8,9,17,14,7,21,0,0,0,0
"15781",2019-07-01,"sbpr","transporte regular","voo doméstico",0,0,0,0,0,0,0,0,0,0
"15782",2019-07-01,"sbpr","transporte regular","voo internacional",0,0,0,0,0,0,0,0,0,0
"15783",2019-07-01,"sbpr","transporte não regular","voo doméstico",1049,1040,2089,1206,1129,2335,0,0,0,0
"15784",2019-07-01,"sbpr","transporte não regular","voo internacional",0,0,0,0,0,0,0,0,0,0
"15785",2019-07-01,"sbpv","transporte regular","voo doméstico",257,257,514,34578,34220,68798,0,0,0,0
"15786",2019-07-01,"sbpv","transporte regular","voo internacional",0,0,0,0,0,0,0,0,0,0
"15787",2019-07-01,"sbpv","transporte não regular","voo doméstico",193,195,388,89,0,89,0,0,0,0
"15788",2019-07-01,"sbpv","transporte não regular","voo internacional",2,1,3,0,0,0,0,0,0,0
"15789",2019-07-01,"sbrb","transporte regular","voo doméstico",148,149,297,15167,13240,28407,0,0,0,0
"15790",2019-07-01,"sbrb","transporte regular","voo internacional",0,0,0,0,0,0,0,0,0,0
"15791",2019-07-01,"sbrb","transporte não regular","voo doméstico",162,163,325,486,152,638,0,0,0,0
"15792",2019-07-01,"sbrb","transporte não regular","voo internacional",1,0,1,0,0,0,0,0,0,0
"15793",2019-07-01,"sbrj","transporte regular","voo doméstico",3565,3590,7155,421430,398979,820409,0,0,0,0
"15794",2019-07-01,"sbrj","transporte regular","voo internacional",0,0,0,0,0,0,0,0,0,0
"15795",2019-07-01,"sbrj","transporte não regular","voo doméstico",519,494,1013,2869,3343,6212,0,0,0,0
"15796",2019-07-01,"sbrj","transporte não regular","voo internacional",3,3,6,7,0,7,0,0,0,0
"15797",2019-07-01,"sbsj","transporte regular","voo doméstico",23,23,46,1325,1277,2602,0,0,0,0
"15798",2019-07-01,"sbsj","transporte regular","voo internacional",0,0,0,0,0,0,0,0,0,0
"15799",2019-07-01,"sbsj","transporte não regular","voo doméstico",384,375,759,922,916,1838,0,0,0,0
"15800",2019-07-01,"sbsj","transporte não regular","voo internacional",0,8,8,19,0,19,0,0,0,0
"15801",2019-07-01,"sbsl","transporte regular","voo doméstico",596,590,1186,81190,84865,166055,0,0,0,0
"15802",2019-07-01,"sbsl","transporte regular","voo internacional",0,0,0,0,0,0,0,0,0,0
"15803",2019-07-01,"sbsl","transporte não regular","voo doméstico",263,270,533,4274,2847,7121,0,0,0,0
"15804",2019-07-01,"sbsl","transporte não regular","voo internacional",0,0,0,0,0,0,0,0,0,0
"15805",2019-07-01,"sbsn","transporte regular","voo doméstico",251,251,502,24446,23269,47715,0,0,0,0
"15806",2019-07-01,"sbsn","transporte regular","voo internacional",0,0,0,0,0,0,0,0,0,0
"15807",2019-07-01,"sbsn","transporte não regular","voo doméstico",251,253,504,360,309,669,6480,7100,13580,0
"15808",2019-07-01,"sbsn","transporte não regular","voo internacional",1,1,2,0,0,0,0,0,0,0
"15809",2019-07-01,"sbsp","transporte regular","voo doméstico",6710,6797,13507,932491,924304,1856795,0,0,0,0
"15810",2019-07-01,"sbsp","transporte regular","voo internacional",0,0,0,0,0,0,0,0,0,0
"15811",2019-07-01,"sbsp","transporte não regular","voo doméstico",2137,2048,4185,53320,62452,115772,0,0,0,0
"15812",2019-07-01,"sbsp","transporte não regular","voo internacional",6,5,11,0,0,0,0,0,0,0
"15813",2019-07-01,"sbte","transporte regular","voo doméstico",423,422,845,56438,56847,113285,0,0,0,0
"15814",2019-07-01,"sbte","transporte regular","voo internacional",0,0,0,0,0,0,0,0,0,0
"15815",2019-07-01,"sbte","transporte não regular","voo doméstico",169,168,337,1207,1036,2243,0,0,0,0
"15816",2019-07-01,"sbte","transporte não regular","voo internacional",0,0,0,0,0,0,0,0,0,0
"15817",2019-07-01,"sbtf","transporte regular","voo doméstico",31,31,62,1240,1469,2709,0,0,0,0
"15818",2019-07-01,"sbtf","transporte regular","voo internacional",0,0,0,0,0,0,0,0,0,0
"15819",2019-07-01,"sbtf","transporte não regular","voo doméstico",107,107,214,189,160,349,985,205,1190,820
"15820",2019-07-01,"sbtf","transporte não regular","voo internacional",0,0,0,0,0,0,0,0,0,0
"15821",2019-07-01,"sbtt","transporte regular","voo doméstico",31,31,62,2298,3166,5464,0,0,0,0
"15822",2019-07-01,"sbtt","transporte regular","voo internacional",0,0,0,0,0,0,0,0,0,0
"15823",2019-07-01,"sbtt","transporte não regular","voo doméstico",93,91,184,447,462,909,388,302,690,0
"15824",2019-07-01,"sbtt","transporte não regular","voo internacional",2,3,5,9,4,13,0,0,0,0
"15825",2019-07-01,"sbuf","transporte regular","voo doméstico",8,8,16,451,430,881,0,0,0,0
"15826",2019-07-01,"sbuf","transporte regular","voo internacional",0,0,0,0,0,0,0,0,0,0
"15827",2019-07-01,"sbuf","transporte não regular","voo doméstico",20,21,41,46,190,236,0,0,0,0
"15828",2019-07-01,"sbuf","transporte não regular","voo internacional",0,0,0,0,0,0,0,0,0,0
"15829",2019-07-01,"sbug","transporte regular","voo doméstico",18,18,36,1032,908,1940,0,0,0,0
"15830",2019-07-01,"sbug","transporte regular","voo internacional",0,0,0,0,0,0,0,0,0,0
"15831",2019-07-01,"sbug","transporte não regular","voo doméstico",9,9,18,17,17,34,0,0,0,0
"15832",2019-07-01,"sbug","transporte não regular","voo internacional",0,0,0,0,0,0,0,0,0,0
"15833",2019-07-01,"sbul","transporte regular","voo doméstico",544,541,1085,52796,49693,102489,0,0,0,0
"15834",2019-07-01,"sbul","transporte regular","voo internacional",0,0,0,0,0,0,0,0,0,0
"15835",2019-07-01,"sbul","transporte não regular","voo doméstico",616,622,1238,2089,2234,4323,0,0,0,0
"15836",2019-07-01,"sbul","transporte não regular","voo internacional",0,0,0,0,0,0,0,0,0,0
"15837",2019-07-01,"sbur","transporte regular","voo doméstico",63,61,124,3308,3236,6544,0,0,0,0
"15838",2019-07-01,"sbur","transporte regular","voo internacional",0,0,0,0,0,0,0,0,0,0
"15839",2019-07-01,"sbur","transporte não regular","voo doméstico",178,185,363,662,634,1296,0,0,0,0
"15840",2019-07-01,"sbur","transporte não regular","voo internacional",0,0,0,0,0,0,0,0,0,0
"15841",2019-06-01,"sbbe","transporte regular","voo doméstico",1022,1022,2044,132256,132457,264713,0,0,0,0
"15842",2019-06-01,"sbbe","transporte regular","voo internacional",52,57,109,7275,6360,13635,0,15,15,0
"15843",2019-06-01,"sbbe","transporte não regular","voo doméstico",453,446,899,2043,1949,3992,0,0,0,0
"15844",2019-06-01,"sbbe","transporte não regular","voo internacional",10,9,19,14,10,24,0,0,0,0
"15845",2019-06-01,"sbbg","transporte regular","voo doméstico",0,0,0,0,0,0,0,0,0,0
"15846",2019-06-01,"sbbg","transporte regular","voo internacional",0,0,0,0,0,0,0,0,0,0
"15847",2019-06-01,"sbbg","transporte não regular","voo doméstico",11,12,23,41,38,79,0,0,0,0
"15848",2019-06-01,"sbbg","transporte não regular","voo internacional",0,0,0,0,0,0,0,0,0,0
"15849",2019-06-01,"sbbh","transporte regular","voo doméstico",0,0,0,0,0,0,0,0,0,0
"15850",2019-06-01,"sbbh","transporte regular","voo internacional",0,0,0,0,0,0,0,0,0,0
"15851",2019-06-01,"sbbh","transporte não regular","voo doméstico",1506,1511,3017,7637,7623,15260,0,0,0,0
"15852",2019-06-01,"sbbh","transporte não regular","voo internacional",2,2,4,0,0,0,0,0,0,0
"15853",2019-06-01,"sbbi","transporte regular","voo doméstico",0,0,0,0,0,0,0,0,0,0
"15854",2019-06-01,"sbbi","transporte regular","voo internacional",0,0,0,0,0,0,0,0,0,0
"15855",2019-06-01,"sbbi","transporte não regular","voo doméstico",1356,1350,2706,906,825,1731,0,0,0,0
"15856",2019-06-01,"sbbi","transporte não regular","voo internacional",0,0,0,0,0,0,0,0,0,0
"15857",2019-06-01,"sbbv","transporte regular","voo doméstico",95,95,190,15566,10991,26557,0,0,0,0
"15858",2019-06-01,"sbbv","transporte regular","voo internacional",0,0,0,0,0,0,0,0,0,0
"15859",2019-06-01,"sbbv","transporte não regular","voo doméstico",55,57,112,210,142,352,0,0,0,0
"15860",2019-06-01,"sbbv","transporte não regular","voo internacional",11,7,18,0,0,0,0,0,0,0
"15861",2019-06-01,"sbcg","transporte regular","voo doméstico",512,518,1030,58147,57232,115379,50264,71707,121971,0
"15862",2019-06-01,"sbcg","transporte regular","voo internacional",0,0,0,0,0,0,0,0,0,0
"15863",2019-06-01,"sbcg","transporte não regular","voo doméstico",230,228,458,256,818,1074,0,0,0,0
"15864",2019-06-01,"sbcg","transporte não regular","voo internacional",11,8,19,0,0,0,0,0,0,0
"15865",2019-06-01,"sbcj","transporte regular","voo doméstico",66,66,132,5264,6162,11426,0,0,0,0
"15866",2019-06-01,"sbcj","transporte regular","voo internacional",0,0,0,0,0,0,0,0,0,0
"15867",2019-06-01,"sbcj","transporte não regular","voo doméstico",83,83,166,1015,419,1434,0,0,0,0
"15868",2019-06-01,"sbcj","transporte não regular","voo internacional",2,2,4,0,0,0,0,0,0,0
"15869",2019-06-01,"sbcr","transporte regular","voo doméstico",17,17,34,1321,1343,2664,0,0,0,0
"15870",2019-06-01,"sbcr","transporte regular","voo internacional",0,0,0,0,0,0,0,0,0,0
"15871",2019-06-01,"sbcr","transporte não regular","voo doméstico",95,97,192,157,136,293,0,0,0,0
"15872",2019-06-01,"sbcr","transporte não regular","voo internacional",0,1,1,0,0,0,0,0,0,0
"15873",2019-06-01,"sbct","transporte regular","voo doméstico",2207,2213,4420,240243,240446,480689,89103,41094,130197,112355
"15874",2019-06-01,"sbct","transporte regular","voo internacional",76,74,150,3008,3104,6112,29510,33850,63360,0
"15875",2019-06-01,"sbct","transporte não regular","voo doméstico",230,232,462,1279,1304,2583,0,0,0,24154
"15876",2019-06-01,"sbct","transporte não regular","voo internacional",12,17,29,223,26,249,0,0,0,0
"15877",2019-06-01,"sbcz","transporte regular","voo doméstico",29,29,58,2415,1329,3744,0,0,0,0
"15878",2019-06-01,"sbcz","transporte regular","voo internacional",0,0,0,0,0,0,0,0,0,0
"15879",2019-06-01,"sbcz","transporte não regular","voo doméstico",234,233,467,988,789,1777,0,0,0,0
"15880",2019-06-01,"sbcz","transporte não regular","voo internacional",0,0,0,0,0,0,0,0,0,0
"15881",2019-06-01,"sbeg","transporte regular","voo doméstico",911,909,1820,111719,102809,214528,135765,182144,317909,0
"15882",2019-06-01,"sbeg","transporte regular","voo internacional",93,95,188,5410,4800,10210,0,0,0,0
"15883",2019-06-01,"sbeg","transporte não regular","voo doméstico",502,497,999,8135,5777,13912,0,0,0,0
"15884",2019-06-01,"sbeg","transporte não regular","voo internacional",50,55,105,213,0,213,0,0,0,0
"15885",2019-06-01,"sbfi","transporte regular","voo doméstico",539,538,1077,69692,68895,138587,0,0,0,0
"15886",2019-06-01,"sbfi","transporte regular","voo internacional",22,22,44,2186,1555,3741,0,0,0,0
"15887",2019-06-01,"sbfi","transporte não regular","voo doméstico",148,155,303,1478,1870,3348,0,0,0,0
"15888",2019-06-01,"sbfi","transporte não regular","voo internacional",44,42,86,73,250,323,0,0,0,0
"15889",2019-06-01,"sbgo","transporte regular","voo doméstico",1115,1120,2235,121086,124552,245638,183933,249862,433795,0
"15890",2019-06-01,"sbgo","transporte regular","voo internacional",0,0,0,0,0,0,0,0,0,0
"15891",2019-06-01,"sbgo","transporte não regular","voo doméstico",1117,1086,2203,5482,5318,10800,0,0,0,0
"15892",2019-06-01,"sbgo","transporte não regular","voo internacional",7,6,13,0,0,0,0,0,0,0
"15893",2019-06-01,"sbht","transporte regular","voo doméstico",80,80,160,4092,3910,8002,0,0,0,0
"15894",2019-06-01,"sbht","transporte regular","voo internacional",0,0,0,0,0,0,0,0,0,0
"15895",2019-06-01,"sbht","transporte não regular","voo doméstico",36,38,74,34,13,47,0,0,0,0
"15896",2019-06-01,"sbht","transporte não regular","voo internacional",0,0,0,0,0,0,0,0,0,0
"15897",2019-06-01,"sbiz","transporte regular","voo doméstico",104,104,208,13416,13145,26561,0,0,0,0
"15898",2019-06-01,"sbiz","transporte regular","voo internacional",0,0,0,0,0,0,0,0,0,0
"15899",2019-06-01,"sbiz","transporte não regular","voo doméstico",69,73,142,162,144,306,0,0,0,0
"15900",2019-06-01,"sbiz","transporte não regular","voo internacional",0,0,0,0,0,0,0,0,0,0
"15901",2019-06-01,"sbjc","transporte regular","voo doméstico",0,0,0,0,0,0,0,0,0,0
"15902",2019-06-01,"sbjc","transporte regular","voo internacional",0,0,0,0,0,0,0,0,0,0
"15903",2019-06-01,"sbjc","transporte não regular","voo doméstico",236,236,472,490,249,739,0,0,0,0
"15904",2019-06-01,"sbjc","transporte não regular","voo internacional",0,0,0,0,0,0,0,0,0,0
"15905",2019-06-01,"sbjr","transporte regular","voo doméstico",0,0,0,0,0,0,0,0,0,0
"15906",2019-06-01,"sbjr","transporte regular","voo internacional",0,0,0,0,0,0,0,0,0,0
"15907",2019-06-01,"sbjr","transporte não regular","voo doméstico",2680,2685,5365,10047,4313,14360,0,0,0,0
"15908",2019-06-01,"sbjr","transporte não regular","voo internacional",0,0,0,0,0,0,0,0,0,0
"15909",2019-06-01,"sbjv","transporte regular","voo doméstico",196,195,391,20063,19951,40014,0,0,0,0
"15910",2019-06-01,"sbjv","transporte regular","voo internacional",0,0,0,0,0,0,0,0,0,0
"15911",2019-06-01,"sbjv","transporte não regular","voo doméstico",74,76,150,92,459,551,0,0,0,0
"15912",2019-06-01,"sbjv","transporte não regular","voo internacional",0,0,0,0,0,0,0,0,0,0
"15913",2019-06-01,"sblo","transporte regular","voo doméstico",397,396,793,38358,40542,78900,0,0,0,0
"15914",2019-06-01,"sblo","transporte regular","voo internacional",0,0,0,0,0,0,0,0,0,0
"15915",2019-06-01,"sblo","transporte não regular","voo doméstico",405,405,810,196,334,530,0,0,0,0
"15916",2019-06-01,"sblo","transporte não regular","voo internacional",4,4,8,0,0,0,0,0,0,0
"15917",2019-06-01,"sbma","transporte regular","voo doméstico",114,114,228,10661,11509,22170,0,0,0,0
"15918",2019-06-01,"sbma","transporte regular","voo internacional",0,0,0,0,0,0,0,0,0,0
"15919",2019-06-01,"sbma","transporte não regular","voo doméstico",119,118,237,194,186,380,0,0,0,0
"15920",2019-06-01,"sbma","transporte não regular","voo internacional",0,0,0,0,0,0,0,0,0,0
"15921",2019-06-01,"sbmk","transporte regular","voo doméstico",132,131,263,9193,9524,18717,0,0,0,0
"15922",2019-06-01,"sbmk","transporte regular","voo internacional",0,0,0,0,0,0,0,0,0,0
"15923",2019-06-01,"sbmk","transporte não regular","voo doméstico",168,172,340,295,5,300,0,0,0,0
"15924",2019-06-01,"sbmk","transporte não regular","voo internacional",0,0,0,0,0,0,0,0,0,0
"15925",2019-06-01,"sbmq","transporte regular","voo doméstico",160,161,321,20685,17847,38532,7520,17070,24590,0
"15926",2019-06-01,"sbmq","transporte regular","voo internacional",0,0,0,0,0,0,0,0,0,0
"15927",2019-06-01,"sbmq","transporte não regular","voo doméstico",138,140,278,2781,2441,5222,0,2930,2930,0
"15928",2019-06-01,"sbmq","transporte não regular","voo internacional",3,1,4,0,0,0,0,0,0,0
"15929",2019-06-01,"sbmt","transporte regular","voo doméstico",0,0,0,0,0,0,0,0,0,0
"15930",2019-06-01,"sbmt","transporte regular","voo internacional",0,0,0,0,0,0,0,0,0,0
"15931",2019-06-01,"sbmt","transporte não regular","voo doméstico",3021,3022,6043,5019,5035,10054,0,0,0,0
"15932",2019-06-01,"sbmt","transporte não regular","voo internacional",0,0,0,0,0,0,0,0,0,0
"15933",2019-06-01,"sbnf","transporte regular","voo doméstico",565,565,1130,63907,65561,129468,0,0,0,0
"15934",2019-06-01,"sbnf","transporte regular","voo internacional",0,0,0,0,0,0,0,0,0,0
"15935",2019-06-01,"sbnf","transporte não regular","voo doméstico",292,294,586,605,490,1095,0,0,0,0
"15936",2019-06-01,"sbnf","transporte não regular","voo internacional",1,1,2,0,0,0,0,0,0,0
"15937",2019-06-01,"sbpb","transporte regular","voo doméstico",5,5,10,314,542,856,0,0,0,0
"15938",2019-06-01,"sbpb","transporte regular","voo internacional",0,0,0,0,0,0,0,0,0,0
"15939",2019-06-01,"sbpb","transporte não regular","voo doméstico",57,58,115,147,139,286,0,0,0,0
"15940",2019-06-01,"sbpb","transporte não regular","voo internacional",0,0,0,0,0,0,0,0,0,0
"15941",2019-06-01,"sbpj","transporte regular","voo doméstico",250,247,497,23710,23910,47620,0,0,0,0
"15942",2019-06-01,"sbpj","transporte regular","voo internacional",0,0,0,0,0,0,0,0,0,0
"15943",2019-06-01,"sbpj","transporte não regular","voo doméstico",241,240,481,552,189,741,0,0,0,0
"15944",2019-06-01,"sbpj","transporte não regular","voo internacional",0,0,0,0,0,0,0,0,0,0
"15945",2019-06-01,"sbpk","transporte regular","voo doméstico",23,23,46,1109,1170,2279,0,0,0,0
"15946",2019-06-01,"sbpk","transporte regular","voo internacional",0,0,0,0,0,0,0,0,0,0
"15947",2019-06-01,"sbpk","transporte não regular","voo doméstico",41,42,83,116,123,239,0,0,0,0
"15948",2019-06-01,"sbpk","transporte não regular","voo internacional",1,0,1,0,0,0,0,0,0,0
"15949",2019-06-01,"sbpl","transporte regular","voo doméstico",137,137,274,14161,15412,29573,0,0,0,0
"15950",2019-06-01,"sbpl","transporte regular","voo internacional",4,4,8,0,0,0,0,0,0,0
"15951",2019-06-01,"sbpl","transporte não regular","voo doméstico",109,109,218,367,239,606,0,0,0,0
"15952",2019-06-01,"sbpl","transporte não regular","voo internacional",0,0,0,0,0,0,0,0,0,0
"15953",2019-06-01,"sbpp","transporte regular","voo doméstico",0,0,0,0,0,0,0,0,0,0
"15954",2019-06-01,"sbpp","transporte regular","voo internacional",0,0,0,0,0,0,0,0,0,0
"15955",2019-06-01,"sbpp","transporte não regular","voo doméstico",103,99,202,143,151,294,0,0,0,0
"15956",2019-06-01,"sbpp","transporte não regular","voo internacional",5,8,13,12,4,16,0,0,0,0
"15957",2019-06-01,"sbpr","transporte regular","voo doméstico",0,0,0,0,0,0,0,0,0,0
"15958",2019-06-01,"sbpr","transporte regular","voo internacional",0,0,0,0,0,0,0,0,0,0
"15959",2019-06-01,"sbpr","transporte não regular","voo doméstico",967,975,1942,1063,978,2041,0,0,0,0
"15960",2019-06-01,"sbpr","transporte não regular","voo internacional",0,0,0,0,0,0,0,0,0,0
"15961",2019-06-01,"sbpv","transporte regular","voo doméstico",216,217,433,29034,27703,56737,0,0,0,0
"15962",2019-06-01,"sbpv","transporte regular","voo internacional",0,0,0,0,0,0,0,0,0,0
"15963",2019-06-01,"sbpv","transporte não regular","voo doméstico",171,172,343,71,0,71,0,0,0,0
"15964",2019-06-01,"sbpv","transporte não regular","voo internacional",0,1,1,0,0,0,0,0,0,0
"15965",2019-06-01,"sbrb","transporte regular","voo doméstico",136,135,271,12605,12787,25392,0,0,0,0
"15966",2019-06-01,"sbrb","transporte regular","voo internacional",0,0,0,0,0,0,0,0,0,0
"15967",2019-06-01,"sbrb","transporte não regular","voo doméstico",126,125,251,333,193,526,0,0,0,0
"15968",2019-06-01,"sbrb","transporte não regular","voo internacional",0,0,0,0,0,0,0,0,0,0
"15969",2019-06-01,"sbrj","transporte regular","voo doméstico",3268,3265,6533,360134,360777,720911,0,0,0,0
"15970",2019-06-01,"sbrj","transporte regular","voo internacional",0,0,0,0,0,0,0,0,0,0
"15971",2019-06-01,"sbrj","transporte não regular","voo doméstico",485,488,973,1511,1038,2549,0,0,0,0
"15972",2019-06-01,"sbrj","transporte não regular","voo internacional",1,1,2,0,0,0,0,0,0,0
"15973",2019-06-01,"sbsj","transporte regular","voo doméstico",38,38,76,1804,1697,3501,0,0,0,0
"15974",2019-06-01,"sbsj","transporte regular","voo internacional",0,0,0,0,0,0,0,0,0,0
"15975",2019-06-01,"sbsj","transporte não regular","voo doméstico",339,326,665,776,801,1577,0,0,0,0
"15976",2019-06-01,"sbsj","transporte não regular","voo internacional",3,11,14,33,21,54,0,0,0,0
"15977",2019-06-01,"sbsl","transporte regular","voo doméstico",501,500,1001,64510,70566,135076,0,0,0,0
"15978",2019-06-01,"sbsl","transporte regular","voo internacional",0,0,0,0,0,0,0,0,0,0
"15979",2019-06-01,"sbsl","transporte não regular","voo doméstico",211,213,424,1009,755,1764,0,0,0,0
"15980",2019-06-01,"sbsl","transporte não regular","voo internacional",1,0,1,0,0,0,0,0,0,0
"15981",2019-06-01,"sbsn","transporte regular","voo doméstico",196,192,388,17064,18216,35280,0,0,0,0
"15982",2019-06-01,"sbsn","transporte regular","voo internacional",0,0,0,0,0,0,0,0,0,0
"15983",2019-06-01,"sbsn","transporte não regular","voo doméstico",258,260,518,1058,565,1623,2200,2400,4600,0
"15984",2019-06-01,"sbsn","transporte não regular","voo internacional",0,0,0,0,0,0,0,0,0,0
"15985",2019-06-01,"sbsp","transporte regular","voo doméstico",6405,6461,12866,870508,830676,1701184,0,0,0,0
"15986",2019-06-01,"sbsp","transporte regular","voo internacional",0,0,0,0,0,0,0,0,0,0
"15987",2019-06-01,"sbsp","transporte não regular","voo doméstico",1972,1904,3876,11203,14056,25259,0,0,0,0
"15988",2019-06-01,"sbsp","transporte não regular","voo internacional",8,9,17,0,0,0,0,0,0,0
"15989",2019-06-01,"sbte","transporte regular","voo doméstico",349,351,700,43706,47299,91005,0,0,0,0
"15990",2019-06-01,"sbte","transporte regular","voo internacional",0,0,0,0,0,0,0,0,0,0
"15991",2019-06-01,"sbte","transporte não regular","voo doméstico",170,169,339,857,973,1830,0,0,0,0
"15992",2019-06-01,"sbte","transporte não regular","voo internacional",0,0,0,0,0,0,0,0,0,0
"15993",2019-06-01,"sbtf","transporte regular","voo doméstico",30,30,60,1154,1162,2316,0,0,0,0
"15994",2019-06-01,"sbtf","transporte regular","voo internacional",0,0,0,0,0,0,0,0,0,0
"15995",2019-06-01,"sbtf","transporte não regular","voo doméstico",108,108,216,220,179,399,140,0,140,190
"15996",2019-06-01,"sbtf","transporte não regular","voo internacional",0,0,0,0,0,0,0,0,0,0
"15997",2019-06-01,"sbtt","transporte regular","voo doméstico",29,29,58,2368,2548,4916,0,0,0,0
"15998",2019-06-01,"sbtt","transporte regular","voo internacional",0,0,0,0,0,0,0,0,0,0
"15999",2019-06-01,"sbtt","transporte não regular","voo doméstico",57,57,114,256,267,523,483,655,1138,0
"16000",2019-06-01,"sbtt","transporte não regular","voo internacional",0,0,0,0,0,0,0,0,0,0
"16001",2019-06-01,"sbuf","transporte regular","voo doméstico",8,8,16,474,499,973,0,0,0,0
"16002",2019-06-01,"sbuf","transporte regular","voo internacional",0,0,0,0,0,0,0,0,0,0
"16003",2019-06-01,"sbuf","transporte não regular","voo doméstico",15,15,30,22,20,42,0,0,0,0
"16004",2019-06-01,"sbuf","transporte não regular","voo internacional",0,0,0,0,0,0,0,0,0,0
"16005",2019-06-01,"sbug","transporte regular","voo doméstico",15,15,30,691,743,1434,0,0,0,0
"16006",2019-06-01,"sbug","transporte regular","voo internacional",0,0,0,0,0,0,0,0,0,0
"16007",2019-06-01,"sbug","transporte não regular","voo doméstico",7,7,14,16,15,31,0,0,0,0
"16008",2019-06-01,"sbug","transporte não regular","voo internacional",0,0,0,0,0,0,0,0,0,0
"16009",2019-06-01,"sbul","transporte regular","voo doméstico",501,501,1002,43388,43919,87307,0,0,0,0
"16010",2019-06-01,"sbul","transporte regular","voo internacional",0,0,0,0,0,0,0,0,0,0
"16011",2019-06-01,"sbul","transporte não regular","voo doméstico",415,409,824,1109,851,1960,0,0,0,0
"16012",2019-06-01,"sbul","transporte não regular","voo internacional",0,0,0,0,0,0,0,0,0,0
"16013",2019-06-01,"sbur","transporte regular","voo doméstico",60,60,120,2838,2888,5726,0,0,0,0
"16014",2019-06-01,"sbur","transporte regular","voo internacional",0,0,0,0,0,0,0,0,0,0
"16015",2019-06-01,"sbur","transporte não regular","voo doméstico",223,225,448,825,849,1674,0,0,0,0
"16016",2019-06-01,"sbur","transporte não regular","voo internacional",0,0,0,0,0,0,0,0,0,0
"16017",2019-05-01,"sbbe","transporte regular","voo doméstico",1049,1056,2105,130253,128354,258607,0,0,0,0
"16018",2019-05-01,"sbbe","transporte regular","voo internacional",52,51,103,6766,6246,13012,0,35,35,0
"16019",2019-05-01,"sbbe","transporte não regular","voo doméstico",412,409,821,1698,2697,4395,0,0,0,0
"16020",2019-05-01,"sbbe","transporte não regular","voo internacional",21,13,34,0,24,24,0,0,0,0
"16021",2019-05-01,"sbbg","transporte regular","voo doméstico",0,0,0,0,0,0,0,0,0,0
"16022",2019-05-01,"sbbg","transporte regular","voo internacional",0,0,0,0,0,0,0,0,0,0
"16023",2019-05-01,"sbbg","transporte não regular","voo doméstico",15,15,30,67,69,136,0,0,0,0
"16024",2019-05-01,"sbbg","transporte não regular","voo internacional",3,2,5,0,11,11,0,0,0,0
"16025",2019-05-01,"sbbh","transporte regular","voo doméstico",0,0,0,0,0,0,0,0,0,0
"16026",2019-05-01,"sbbh","transporte regular","voo internacional",0,0,0,0,0,0,0,0,0,0
"16027",2019-05-01,"sbbh","transporte não regular","voo doméstico",1576,1579,3155,8064,8068,16132,0,0,0,0
"16028",2019-05-01,"sbbh","transporte não regular","voo internacional",4,4,8,22,22,44,0,0,0,0
"16029",2019-05-01,"sbbi","transporte regular","voo doméstico",0,0,0,0,0,0,0,0,0,0
"16030",2019-05-01,"sbbi","transporte regular","voo internacional",0,0,0,0,0,0,0,0,0,0
"16031",2019-05-01,"sbbi","transporte não regular","voo doméstico",1008,1018,2026,730,617,1347,0,0,0,0
"16032",2019-05-01,"sbbi","transporte não regular","voo internacional",2,2,4,0,0,0,0,0,0,0
"16033",2019-05-01,"sbbv","transporte regular","voo doméstico",98,98,196,15903,11945,27848,0,0,0,0
"16034",2019-05-01,"sbbv","transporte regular","voo internacional",0,0,0,0,0,0,0,0,0,0
"16035",2019-05-01,"sbbv","transporte não regular","voo doméstico",45,49,94,67,32,99,0,0,0,0
"16036",2019-05-01,"sbbv","transporte não regular","voo internacional",12,8,20,0,0,0,0,0,0,0
"16037",2019-05-01,"sbcg","transporte regular","voo doméstico",513,514,1027,57305,57877,115182,68578,86854,155432,0
"16038",2019-05-01,"sbcg","transporte regular","voo internacional",0,0,0,0,0,0,0,0,0,0
"16039",2019-05-01,"sbcg","transporte não regular","voo doméstico",217,217,434,1449,1327,2776,0,0,0,0
"16040",2019-05-01,"sbcg","transporte não regular","voo internacional",13,9,22,0,0,0,0,0,0,0
"16041",2019-05-01,"sbcj","transporte regular","voo doméstico",76,76,152,5622,6542,12164,0,0,0,0
"16042",2019-05-01,"sbcj","transporte regular","voo internacional",0,0,0,0,0,0,0,0,0,0
"16043",2019-05-01,"sbcj","transporte não regular","voo doméstico",123,123,246,779,204,983,0,0,0,0
"16044",2019-05-01,"sbcj","transporte não regular","voo internacional",1,1,2,4,0,4,0,0,0,0
"16045",2019-05-01,"sbcr","transporte regular","voo doméstico",14,14,28,1266,1181,2447,0,0,0,0
"16046",2019-05-01,"sbcr","transporte regular","voo internacional",0,0,0,0,0,0,0,0,0,0
"16047",2019-05-01,"sbcr","transporte não regular","voo doméstico",80,77,157,121,127,248,0,0,0,0
"16048",2019-05-01,"sbcr","transporte não regular","voo internacional",1,1,2,8,7,15,0,0,0,0
"16049",2019-05-01,"sbct","transporte regular","voo doméstico",2272,2285,4557,256102,247882,503984,123265,52634,175899,145920
"16050",2019-05-01,"sbct","transporte regular","voo internacional",81,81,162,3386,3260,6646,59176,16001,75177,3100
"16051",2019-05-01,"sbct","transporte não regular","voo doméstico",271,254,525,1406,1768,3174,0,0,0,0
"16052",2019-05-01,"sbct","transporte não regular","voo internacional",27,28,55,178,212,390,0,0,0,0
"16053",2019-05-01,"sbcz","transporte regular","voo doméstico",30,30,60,2100,321,2421,0,0,0,0
"16054",2019-05-01,"sbcz","transporte regular","voo internacional",0,0,0,0,0,0,0,0,0,0
"16055",2019-05-01,"sbcz","transporte não regular","voo doméstico",173,175,348,672,637,1309,0,0,0,0
"16056",2019-05-01,"sbcz","transporte não regular","voo internacional",0,0,0,0,0,0,0,0,0,0
"16057",2019-05-01,"sbeg","transporte regular","voo doméstico",970,964,1934,105982,101603,207585,151052,215587,366639,0
"16058",2019-05-01,"sbeg","transporte regular","voo internacional",94,98,192,4618,4779,9397,0,0,0,0
"16059",2019-05-01,"sbeg","transporte não regular","voo doméstico",437,436,873,3588,2879,6467,0,0,0,0
"16060",2019-05-01,"sbeg","transporte não regular","voo internacional",44,47,91,35,0,35,0,0,0,0
"16061",2019-05-01,"sbfi","transporte regular","voo doméstico",547,547,1094,71675,68688,140363,0,0,0,0
"16062",2019-05-01,"sbfi","transporte regular","voo internacional",22,21,43,2384,2246,4630,0,0,0,0
"16063",2019-05-01,"sbfi","transporte não regular","voo doméstico",120,117,237,435,477,912,0,0,0,0
"16064",2019-05-01,"sbfi","transporte não regular","voo internacional",48,47,95,87,121,208,0,0,0,0
"16065",2019-05-01,"sbgo","transporte regular","voo doméstico",1164,1162,2326,127459,129704,257163,233117,292434,525551,0
"16066",2019-05-01,"sbgo","transporte regular","voo internacional",0,0,0,0,0,0,0,0,0,0
"16067",2019-05-01,"sbgo","transporte não regular","voo doméstico",1207,1211,2418,4958,4355,9313,0,0,0,0
"16068",2019-05-01,"sbgo","transporte não regular","voo internacional",3,3,6,0,0,0,0,0,0,0
"16069",2019-05-01,"sbht","transporte regular","voo doméstico",84,84,168,4217,4130,8347,0,0,0,0
"16070",2019-05-01,"sbht","transporte regular","voo internacional",0,0,0,0,0,0,0,0,0,0
"16071",2019-05-01,"sbht","transporte não regular","voo doméstico",43,41,84,68,57,125,0,0,0,0
"16072",2019-05-01,"sbht","transporte não regular","voo internacional",0,0,0,0,0,0,0,0,0,0
"16073",2019-05-01,"sbiz","transporte regular","voo doméstico",115,115,230,13712,12917,26629,0,0,0,0
"16074",2019-05-01,"sbiz","transporte regular","voo internacional",0,0,0,0,0,0,0,0,0,0
"16075",2019-05-01,"sbiz","transporte não regular","voo doméstico",95,94,189,172,183,355,0,0,0,0
"16076",2019-05-01,"sbiz","transporte não regular","voo internacional",1,1,2,0,0,0,0,0,0,0
"16077",2019-05-01,"sbjc","transporte regular","voo doméstico",0,0,0,0,0,0,0,0,0,0
"16078",2019-05-01,"sbjc","transporte regular","voo internacional",0,0,0,0,0,0,0,0,0,0
"16079",2019-05-01,"sbjc","transporte não regular","voo doméstico",273,275,548,548,323,871,0,0,0,0
"16080",2019-05-01,"sbjc","transporte não regular","voo internacional",0,0,0,0,0,0,0,0,0,0
"16081",2019-05-01,"sbjr","transporte regular","voo doméstico",0,0,0,0,0,0,0,0,0,0
"16082",2019-05-01,"sbjr","transporte regular","voo internacional",0,0,0,0,0,0,0,0,0,0
"16083",2019-05-01,"sbjr","transporte não regular","voo doméstico",2755,2757,5512,10569,4008,14577,0,0,0,0
"16084",2019-05-01,"sbjr","transporte não regular","voo internacional",1,1,2,1,0,1,0,0,0,0
"16085",2019-05-01,"sbjv","transporte regular","voo doméstico",216,215,431,22934,21773,44707,0,0,0,0
"16086",2019-05-01,"sbjv","transporte regular","voo internacional",0,0,0,0,0,0,0,0,0,0
"16087",2019-05-01,"sbjv","transporte não regular","voo doméstico",60,59,119,53,118,171,0,0,0,0
"16088",2019-05-01,"sbjv","transporte não regular","voo internacional",1,1,2,0,0,0,0,0,0,0
"16089",2019-05-01,"sblo","transporte regular","voo doméstico",426,425,851,41097,42027,83124,0,0,0,0
"16090",2019-05-01,"sblo","transporte regular","voo internacional",0,0,0,0,0,0,0,0,0,0
"16091",2019-05-01,"sblo","transporte não regular","voo doméstico",400,394,794,255,242,497,0,0,0,0
"16092",2019-05-01,"sblo","transporte não regular","voo internacional",1,1,2,0,0,0,0,0,0,0
"16093",2019-05-01,"sbma","transporte regular","voo doméstico",125,125,250,10404,11402,21806,0,0,0,0
"16094",2019-05-01,"sbma","transporte regular","voo internacional",0,0,0,0,0,0,0,0,0,0
"16095",2019-05-01,"sbma","transporte não regular","voo doméstico",136,139,275,181,287,468,0,0,0,0
"16096",2019-05-01,"sbma","transporte não regular","voo internacional",0,0,0,0,0,0,0,0,0,0
"16097",2019-05-01,"sbmk","transporte regular","voo doméstico",136,135,271,9249,9220,18469,0,0,0,0
"16098",2019-05-01,"sbmk","transporte regular","voo internacional",0,0,0,0,0,0,0,0,0,0
"16099",2019-05-01,"sbmk","transporte não regular","voo doméstico",178,177,355,331,51,382,0,0,0,0
"16100",2019-05-01,"sbmk","transporte não regular","voo internacional",2,2,4,8,0,8,0,0,0,0
"16101",2019-05-01,"sbmq","transporte regular","voo doméstico",166,170,336,20377,18571,38948,12100,30790,42890,0
"16102",2019-05-01,"sbmq","transporte regular","voo internacional",0,0,0,0,0,0,0,0,0,0
"16103",2019-05-01,"sbmq","transporte não regular","voo doméstico",135,128,263,2392,2766,5158,2400,3200,5600,0
"16104",2019-05-01,"sbmq","transporte não regular","voo internacional",2,2,4,0,0,0,0,0,0,0
"16105",2019-05-01,"sbmt","transporte regular","voo doméstico",0,0,0,0,0,0,0,0,0,0
"16106",2019-05-01,"sbmt","transporte regular","voo internacional",0,0,0,0,0,0,0,0,0,0
"16107",2019-05-01,"sbmt","transporte não regular","voo doméstico",2923,2932,5855,4292,4430,8722,0,0,0,0
"16108",2019-05-01,"sbmt","transporte não regular","voo internacional",0,0,0,0,0,0,0,0,0,0
"16109",2019-05-01,"sbnf","transporte regular","voo doméstico",564,562,1126,67840,66907,134747,0,0,0,0
"16110",2019-05-01,"sbnf","transporte regular","voo internacional",0,0,0,0,0,0,0,0,0,0
"16111",2019-05-01,"sbnf","transporte não regular","voo doméstico",252,247,499,445,384,829,0,0,0,0
"16112",2019-05-01,"sbnf","transporte não regular","voo internacional",2,2,4,4,0,4,0,0,0,0
"16113",2019-05-01,"sbpb","transporte regular","voo doméstico",4,4,8,297,428,725,0,0,0,0
"16114",2019-05-01,"sbpb","transporte regular","voo internacional",0,0,0,0,0,0,0,0,0,0
"16115",2019-05-01,"sbpb","transporte não regular","voo doméstico",29,28,57,85,76,161,0,0,0,0
"16116",2019-05-01,"sbpb","transporte não regular","voo internacional",0,0,0,0,0,0,0,0,0,0
"16117",2019-05-01,"sbpj","transporte regular","voo doméstico",261,262,523,24423,23837,48260,0,0,0,0
"16118",2019-05-01,"sbpj","transporte regular","voo internacional",0,0,0,0,0,0,0,0,0,0
"16119",2019-05-01,"sbpj","transporte não regular","voo doméstico",299,299,598,712,256,968,0,0,0,0
"16120",2019-05-01,"sbpj","transporte não regular","voo internacional",2,2,4,0,0,0,0,0,0,0
"16121",2019-05-01,"sbpk","transporte regular","voo doméstico",26,26,52,1482,1397,2879,0,0,0,0
"16122",2019-05-01,"sbpk","transporte regular","voo internacional",0,0,0,0,0,0,0,0,0,0
"16123",2019-05-01,"sbpk","transporte não regular","voo doméstico",34,35,69,339,88,427,0,0,0,0
"16124",2019-05-01,"sbpk","transporte não regular","voo internacional",1,1,2,4,5,9,0,0,0,0
"16125",2019-05-01,"sbpl","transporte regular","voo doméstico",111,111,222,13400,13217,26617,0,0,0,0
"16126",2019-05-01,"sbpl","transporte regular","voo internacional",3,3,6,0,0,0,0,0,0,0
"16127",2019-05-01,"sbpl","transporte não regular","voo doméstico",66,70,136,143,128,271,0,0,0,0
"16128",2019-05-01,"sbpl","transporte não regular","voo internacional",0,0,0,0,0,0,0,0,0,0
"16129",2019-05-01,"sbpp","transporte regular","voo doméstico",0,0,0,0,0,0,0,0,0,0
"16130",2019-05-01,"sbpp","transporte regular","voo internacional",0,0,0,0,0,0,0,0,0,0
"16131",2019-05-01,"sbpp","transporte não regular","voo doméstico",102,105,207,167,158,325,0,0,0,0
"16132",2019-05-01,"sbpp","transporte não regular","voo internacional",9,8,17,20,83,103,0,0,0,0
"16133",2019-05-01,"sbpr","transporte regular","voo doméstico",0,0,0,0,0,0,0,0,0,0
"16134",2019-05-01,"sbpr","transporte regular","voo internacional",0,0,0,0,0,0,0,0,0,0
"16135",2019-05-01,"sbpr","transporte não regular","voo doméstico",888,886,1774,1050,898,1948,0,0,0,0
"16136",2019-05-01,"sbpr","transporte não regular","voo internacional",7,7,14,0,0,0,0,0,0,0
"16137",2019-05-01,"sbpv","transporte regular","voo doméstico",238,238,476,29647,28798,58445,0,0,0,0
"16138",2019-05-01,"sbpv","transporte regular","voo internacional",0,0,0,0,0,0,0,0,0,0
"16139",2019-05-01,"sbpv","transporte não regular","voo doméstico",190,190,380,49,0,49,0,0,0,0
"16140",2019-05-01,"sbpv","transporte não regular","voo internacional",0,0,0,0,0,0,0,0,0,0
"16141",2019-05-01,"sbrb","transporte regular","voo doméstico",125,125,250,11837,10764,22601,0,0,0,0
"16142",2019-05-01,"sbrb","transporte regular","voo internacional",0,0,0,0,0,0,0,0,0,0
"16143",2019-05-01,"sbrb","transporte não regular","voo doméstico",147,149,296,384,215,599,0,0,0,0
"16144",2019-05-01,"sbrb","transporte não regular","voo internacional",1,0,1,0,0,0,0,0,0,0
"16145",2019-05-01,"sbrj","transporte regular","voo doméstico",3618,3626,7244,383644,368400,752044,0,0,0,0
"16146",2019-05-01,"sbrj","transporte regular","voo internacional",0,0,0,0,0,0,0,0,0,0
"16147",2019-05-01,"sbrj","transporte não regular","voo doméstico",522,519,1041,1067,673,1740,0,0,0,0
"16148",2019-05-01,"sbrj","transporte não regular","voo internacional",2,2,4,1,0,1,0,0,0,0
"16149",2019-05-01,"sbsj","transporte regular","voo doméstico",44,44,88,2033,1969,4002,0,0,0,0
"16150",2019-05-01,"sbsj","transporte regular","voo internacional",0,0,0,0,0,0,0,0,0,0
"16151",2019-05-01,"sbsj","transporte não regular","voo doméstico",333,325,658,845,797,1642,0,0,0,0
"16152",2019-05-01,"sbsj","transporte não regular","voo internacional",6,18,24,50,12,62,0,0,0,0
"16153",2019-05-01,"sbsl","transporte regular","voo doméstico",522,524,1046,63956,65076,129032,0,0,0,0
"16154",2019-05-01,"sbsl","transporte regular","voo internacional",0,0,0,0,0,0,0,0,0,0
"16155",2019-05-01,"sbsl","transporte não regular","voo doméstico",218,213,431,700,524,1224,0,0,0,0
"16156",2019-05-01,"sbsl","transporte não regular","voo internacional",0,0,0,0,0,0,0,0,0,0
"16157",2019-05-01,"sbsn","transporte regular","voo doméstico",200,200,400,15153,17383,32536,0,0,0,0
"16158",2019-05-01,"sbsn","transporte regular","voo internacional",0,0,0,0,0,0,0,0,0,0
"16159",2019-05-01,"sbsn","transporte não regular","voo doméstico",259,258,517,711,762,1473,4330,4930,9260,0
"16160",2019-05-01,"sbsn","transporte não regular","voo internacional",3,3,6,0,0,0,0,0,0,0
"16161",2019-05-01,"sbsp","transporte regular","voo doméstico",7080,7137,14217,899350,893584,1792934,0,0,0,0
"16162",2019-05-01,"sbsp","transporte regular","voo internacional",0,0,0,0,0,0,0,0,0,0
"16163",2019-05-01,"sbsp","transporte não regular","voo doméstico",1767,1732,3499,5244,5599,10843,0,0,0,0
"16164",2019-05-01,"sbsp","transporte não regular","voo internacional",7,6,13,0,0,0,0,0,0,0
"16165",2019-05-01,"sbte","transporte regular","voo doméstico",363,361,724,45646,44896,90542,0,0,0,0
"16166",2019-05-01,"sbte","transporte regular","voo internacional",0,0,0,0,0,0,0,0,0,0
"16167",2019-05-01,"sbte","transporte não regular","voo doméstico",160,163,323,1425,1225,2650,0,0,0,0
"16168",2019-05-01,"sbte","transporte não regular","voo internacional",0,0,0,0,0,0,0,0,0,0
"16169",2019-05-01,"sbtf","transporte regular","voo doméstico",29,29,58,1210,1358,2568,0,0,0,0
"16170",2019-05-01,"sbtf","transporte regular","voo internacional",0,0,0,0,0,0,0,0,0,0
"16171",2019-05-01,"sbtf","transporte não regular","voo doméstico",95,96,191,128,116,244,967,260,1227,1120
"16172",2019-05-01,"sbtf","transporte não regular","voo internacional",0,0,0,0,0,0,0,0,0,0
"16173",2019-05-01,"sbtt","transporte regular","voo doméstico",30,30,60,2174,2496,4670,0,0,0,0
"16174",2019-05-01,"sbtt","transporte regular","voo internacional",0,0,0,0,0,0,0,0,0,0
"16175",2019-05-01,"sbtt","transporte não regular","voo doméstico",83,82,165,372,361,733,709,706,1415,0
"16176",2019-05-01,"sbtt","transporte não regular","voo internacional",0,1,1,0,0,0,0,0,0,0
"16177",2019-05-01,"sbuf","transporte regular","voo doméstico",9,9,18,594,563,1157,0,0,0,0
"16178",2019-05-01,"sbuf","transporte regular","voo internacional",0,0,0,0,0,0,0,0,0,0
"16179",2019-05-01,"sbuf","transporte não regular","voo doméstico",34,34,68,62,65,127,0,0,0,0
"16180",2019-05-01,"sbuf","transporte não regular","voo internacional",0,0,0,0,0,0,0,0,0,0
"16181",2019-05-01,"sbug","transporte regular","voo doméstico",17,17,34,942,692,1634,0,0,0,0
"16182",2019-05-01,"sbug","transporte regular","voo internacional",0,0,0,0,0,0,0,0,0,0
"16183",2019-05-01,"sbug","transporte não regular","voo doméstico",13,12,25,21,20,41,0,0,0,0
"16184",2019-05-01,"sbug","transporte não regular","voo internacional",0,0,0,0,0,0,0,0,0,0
"16185",2019-05-01,"sbul","transporte regular","voo doméstico",519,520,1039,47220,45281,92501,0,0,0,0
"16186",2019-05-01,"sbul","transporte regular","voo internacional",0,0,0,0,0,0,0,0,0,0
"16187",2019-05-01,"sbul","transporte não regular","voo doméstico",523,528,1051,1297,1051,2348,0,0,0,0
"16188",2019-05-01,"sbul","transporte não regular","voo internacional",1,1,2,0,0,0,0,0,0,0
"16189",2019-05-01,"sbur","transporte regular","voo doméstico",61,61,122,3417,3278,6695,0,0,0,0
"16190",2019-05-01,"sbur","transporte regular","voo internacional",0,0,0,0,0,0,0,0,0,0
"16191",2019-05-01,"sbur","transporte não regular","voo doméstico",184,191,375,722,717,1439,0,0,0,0
"16192",2019-05-01,"sbur","transporte não regular","voo internacional",0,1,1,0,0,0,0,0,0,0
"16193",2019-03-01,"sbbe","transporte regular","voo doméstico",1075,1072,2147,126389,123503,249892,0,0,0,0
"16194",2019-03-01,"sbbe","transporte regular","voo internacional",58,57,115,6432,6615,13047,0,5,5,0
"16195",2019-03-01,"sbbe","transporte não regular","voo doméstico",322,320,642,461,759,1220,0,0,0,0
"16196",2019-03-01,"sbbe","transporte não regular","voo internacional",15,16,31,0,18,18,0,0,0,0
"16197",2019-03-01,"sbbg","transporte regular","voo doméstico",0,0,0,0,0,0,0,0,0,0
"16198",2019-03-01,"sbbg","transporte regular","voo internacional",0,0,0,0,0,0,0,0,0,0
"16199",2019-03-01,"sbbg","transporte não regular","voo doméstico",12,12,24,48,49,97,0,0,0,0
"16200",2019-03-01,"sbbg","transporte não regular","voo internacional",5,5,10,21,23,44,0,0,0,0
"16201",2019-03-01,"sbbh","transporte regular","voo doméstico",0,0,0,0,0,0,0,0,0,0
"16202",2019-03-01,"sbbh","transporte regular","voo internacional",0,0,0,0,0,0,0,0,0,0
"16203",2019-03-01,"sbbh","transporte não regular","voo doméstico",1458,1450,2908,7332,7293,14625,0,0,0,0
"16204",2019-03-01,"sbbh","transporte não regular","voo internacional",5,5,10,20,20,40,0,0,0,0
"16205",2019-03-01,"sbbi","transporte regular","voo doméstico",0,0,0,0,0,0,0,0,0,0
"16206",2019-03-01,"sbbi","transporte regular","voo internacional",0,0,0,0,0,0,0,0,0,0
"16207",2019-03-01,"sbbi","transporte não regular","voo doméstico",1007,997,2004,906,868,1774,0,0,0,0
"16208",2019-03-01,"sbbi","transporte não regular","voo internacional",2,2,4,0,0,0,0,0,0,0
"16209",2019-03-01,"sbbv","transporte regular","voo doméstico",100,100,200,15470,11869,27339,0,0,0,0
"16210",2019-03-01,"sbbv","transporte regular","voo internacional",0,0,0,0,0,0,0,0,0,0
"16211",2019-03-01,"sbbv","transporte não regular","voo doméstico",94,99,193,230,35,265,0,0,0,0
"16212",2019-03-01,"sbbv","transporte não regular","voo internacional",11,5,16,0,0,0,0,0,0,0
"16213",2019-03-01,"sbcg","transporte regular","voo doméstico",578,577,1155,66043,67075,133118,49173,73650,122823,0
"16214",2019-03-01,"sbcg","transporte regular","voo internacional",0,0,0,0,0,0,0,0,0,0
"16215",2019-03-01,"sbcg","transporte não regular","voo doméstico",186,186,372,224,308,532,0,0,0,0
"16216",2019-03-01,"sbcg","transporte não regular","voo internacional",10,8,18,0,0,0,0,0,0,0
"16217",2019-03-01,"sbcj","transporte regular","voo doméstico",74,75,149,4899,6549,11448,0,0,0,0
"16218",2019-03-01,"sbcj","transporte regular","voo internacional",0,0,0,0,0,0,0,0,0,0
"16219",2019-03-01,"sbcj","transporte não regular","voo doméstico",85,84,169,749,335,1084,0,0,0,0
"16220",2019-03-01,"sbcj","transporte não regular","voo internacional",0,0,0,0,0,0,0,0,0,0
"16221",2019-03-01,"sbcr","transporte regular","voo doméstico",23,23,46,1255,1974,3229,0,0,0,0
"16222",2019-03-01,"sbcr","transporte regular","voo internacional",0,0,0,0,0,0,0,0,0,0
"16223",2019-03-01,"sbcr","transporte não regular","voo doméstico",79,79,158,126,116,242,0,0,0,0
"16224",2019-03-01,"sbcr","transporte não regular","voo internacional",3,3,6,6,11,17,0,0,0,0
"16225",2019-03-01,"sbct","transporte regular","voo doméstico",2359,2356,4715,267713,268046,535759,100892,59618,160510,94478
"16226",2019-03-01,"sbct","transporte regular","voo internacional",81,81,162,2634,2494,5128,18939,4988,23927,0
"16227",2019-03-01,"sbct","transporte não regular","voo doméstico",264,269,533,3718,3901,7619,0,20,20,13518
"16228",2019-03-01,"sbct","transporte não regular","voo internacional",28,25,53,68,79,147,0,0,0,0
"16229",2019-03-01,"sbcz","transporte regular","voo doméstico",30,30,60,2973,585,3558,0,0,0,0
"16230",2019-03-01,"sbcz","transporte regular","voo internacional",0,0,0,0,0,0,0,0,0,0
"16231",2019-03-01,"sbcz","transporte não regular","voo doméstico",151,151,302,542,531,1073,0,0,0,0
"16232",2019-03-01,"sbcz","transporte não regular","voo internacional",0,0,0,0,0,0,0,0,0,0
"16233",2019-03-01,"sbeg","transporte regular","voo doméstico",986,971,1957,105499,108167,213666,122767,190986,313753,0
"16234",2019-03-01,"sbeg","transporte regular","voo internacional",100,105,205,5498,5784,11282,0,0,0,0
"16235",2019-03-01,"sbeg","transporte não regular","voo doméstico",396,403,799,3379,2304,5683,0,0,0,0
"16236",2019-03-01,"sbeg","transporte não regular","voo internacional",62,65,127,62,0,62,0,0,0,0
"16237",2019-03-01,"sbfi","transporte regular","voo doméstico",636,637,1273,92363,89744,182107,0,0,0,0
"16238",2019-03-01,"sbfi","transporte regular","voo internacional",23,23,46,3239,2687,5926,0,0,0,0
"16239",2019-03-01,"sbfi","transporte não regular","voo doméstico",142,142,284,3939,4328,8267,0,0,0,0
"16240",2019-03-01,"sbfi","transporte não regular","voo internacional",51,50,101,87,106,193,0,0,0,0
"16241",2019-03-01,"sbgo","transporte regular","voo doméstico",1301,1298,2599,128968,129193,258161,158538,224095,382633,0
"16242",2019-03-01,"sbgo","transporte regular","voo internacional",0,0,0,0,0,0,0,0,0,0
"16243",2019-03-01,"sbgo","transporte não regular","voo doméstico",1202,1209,2411,4709,3730,8439,0,0,0,0
"16244",2019-03-01,"sbgo","transporte não regular","voo internacional",1,1,2,0,0,0,0,0,0,0
"16245",2019-03-01,"sbht","transporte regular","voo doméstico",81,80,161,3703,3684,7387,0,0,0,0
"16246",2019-03-01,"sbht","transporte regular","voo internacional",0,0,0,0,0,0,0,0,0,0
"16247",2019-03-01,"sbht","transporte não regular","voo doméstico",46,46,92,65,37,102,0,0,0,0
"16248",2019-03-01,"sbht","transporte não regular","voo internacional",0,0,0,0,0,0,0,0,0,0
"16249",2019-03-01,"sbiz","transporte regular","voo doméstico",113,113,226,12394,11510,23904,0,0,0,0
"16250",2019-03-01,"sbiz","transporte regular","voo internacional",0,0,0,0,0,0,0,0,0,0
"16251",2019-03-01,"sbiz","transporte não regular","voo doméstico",68,70,138,156,104,260,0,0,0,0
"16252",2019-03-01,"sbiz","transporte não regular","voo internacional",1,1,2,0,0,0,0,0,0,0
"16253",2019-03-01,"sbjc","transporte regular","voo doméstico",0,0,0,0,0,0,0,0,0,0
"16254",2019-03-01,"sbjc","transporte regular","voo internacional",0,0,0,0,0,0,0,0,0,0
"16255",2019-03-01,"sbjc","transporte não regular","voo doméstico",205,209,414,361,210,571,0,0,0,0
"16256",2019-03-01,"sbjc","transporte não regular","voo internacional",0,0,0,0,0,0,0,0,0,0
"16257",2019-03-01,"sbjr","transporte regular","voo doméstico",0,0,0,0,0,0,0,0,0,0
"16258",2019-03-01,"sbjr","transporte regular","voo internacional",0,0,0,0,0,0,0,0,0,0
"16259",2019-03-01,"sbjr","transporte não regular","voo doméstico",3368,3378,6746,11650,229,11879,0,0,0,0
"16260",2019-03-01,"sbjr","transporte não regular","voo internacional",0,1,1,0,0,0,0,0,0,0
"16261",2019-03-01,"sbjv","transporte regular","voo doméstico",198,199,397,22115,21054,43169,0,0,0,0
"16262",2019-03-01,"sbjv","transporte regular","voo internacional",0,0,0,0,0,0,0,0,0,0
"16263",2019-03-01,"sbjv","transporte não regular","voo doméstico",55,53,108,53,39,92,0,0,0,0
"16264",2019-03-01,"sbjv","transporte não regular","voo internacional",0,0,0,0,0,0,0,0,0,0
"16265",2019-03-01,"sblo","transporte regular","voo doméstico",428,428,856,43012,43617,86629,0,0,0,0
"16266",2019-03-01,"sblo","transporte regular","voo internacional",0,0,0,0,0,0,0,0,0,0
"16267",2019-03-01,"sblo","transporte não regular","voo doméstico",391,398,789,212,260,472,0,0,0,0
"16268",2019-03-01,"sblo","transporte não regular","voo internacional",4,4,8,0,0,0,0,0,0,0
"16269",2019-03-01,"sbma","transporte regular","voo doméstico",109,109,218,9181,9334,18515,0,0,0,0
"16270",2019-03-01,"sbma","transporte regular","voo internacional",0,0,0,0,0,0,0,0,0,0
"16271",2019-03-01,"sbma","transporte não regular","voo doméstico",108,107,215,328,305,633,0,0,0,0
"16272",2019-03-01,"sbma","transporte não regular","voo internacional",0,0,0,0,0,0,0,0,0,0
"16273",2019-03-01,"sbmk","transporte regular","voo doméstico",124,124,248,9537,8649,18186,0,0,0,0
"16274",2019-03-01,"sbmk","transporte regular","voo internacional",0,0,0,0,0,0,0,0,0,0
"16275",2019-03-01,"sbmk","transporte não regular","voo doméstico",171,166,337,400,117,517,0,0,0,0
"16276",2019-03-01,"sbmk","transporte não regular","voo internacional",0,0,0,0,0,0,0,0,0,0
"16277",2019-03-01,"sbmq","transporte regular","voo doméstico",194,195,389,21097,20548,41645,14960,32600,47560,0
"16278",2019-03-01,"sbmq","transporte regular","voo internacional",0,0,0,0,0,0,0,0,0,0
"16279",2019-03-01,"sbmq","transporte não regular","voo doméstico",135,136,271,334,281,615,0,0,0,0
"16280",2019-03-01,"sbmq","transporte não regular","voo internacional",2,0,2,0,0,0,0,0,0,0
"16281",2019-03-01,"sbmt","transporte regular","voo doméstico",0,0,0,0,0,0,0,0,0,0
"16282",2019-03-01,"sbmt","transporte regular","voo internacional",0,0,0,0,0,0,0,0,0,0
"16283",2019-03-01,"sbmt","transporte não regular","voo doméstico",2806,2812,5618,4104,4218,8322,0,0,0,0
"16284",2019-03-01,"sbmt","transporte não regular","voo internacional",0,0,0,0,0,0,0,0,0,0
"16285",2019-03-01,"sbnf","transporte regular","voo doméstico",598,599,1197,75705,73551,149256,0,0,0,0
"16286",2019-03-01,"sbnf","transporte regular","voo internacional",12,12,24,1291,1117,2408,0,0,0,0
"16287",2019-03-01,"sbnf","transporte não regular","voo doméstico",302,295,597,456,471,927,0,0,0,0
"16288",2019-03-01,"sbnf","transporte não regular","voo internacional",1,3,4,6,7,13,0,0,0,0
"16289",2019-03-01,"sbpb","transporte regular","voo doméstico",5,5,10,298,533,831,0,0,0,0
"16290",2019-03-01,"sbpb","transporte regular","voo internacional",0,0,0,0,0,0,0,0,0,0
"16291",2019-03-01,"sbpb","transporte não regular","voo doméstico",67,69,136,217,244,461,0,0,0,0
"16292",2019-03-01,"sbpb","transporte não regular","voo internacional",0,0,0,0,0,0,0,0,0,0
"16293",2019-03-01,"sbpj","transporte regular","voo doméstico",246,246,492,23603,22042,45645,0,0,0,0
"16294",2019-03-01,"sbpj","transporte regular","voo internacional",0,0,0,0,0,0,0,0,0,0
"16295",2019-03-01,"sbpj","transporte não regular","voo doméstico",197,193,390,534,456,990,0,0,0,0
"16296",2019-03-01,"sbpj","transporte não regular","voo internacional",2,2,4,0,0,0,0,0,0,0
"16297",2019-03-01,"sbpk","transporte regular","voo doméstico",22,22,44,1128,1292,2420,0,0,0,0
"16298",2019-03-01,"sbpk","transporte regular","voo internacional",0,0,0,0,0,0,0,0,0,0
"16299",2019-03-01,"sbpk","transporte não regular","voo doméstico",45,42,87,126,177,303,0,0,0,0
"16300",2019-03-01,"sbpk","transporte não regular","voo internacional",6,7,13,8,17,25,0,0,0,0
"16301",2019-03-01,"sbpl","transporte regular","voo doméstico",157,156,313,20033,19721,39754,0,0,0,0
"16302",2019-03-01,"sbpl","transporte regular","voo internacional",4,4,8,0,0,0,0,0,0,0
"16303",2019-03-01,"sbpl","transporte não regular","voo doméstico",62,62,124,88,83,171,0,0,0,0
"16304",2019-03-01,"sbpl","transporte não regular","voo internacional",0,0,0,0,0,0,0,0,0,0
"16305",2019-03-01,"sbpp","transporte regular","voo doméstico",0,0,0,0,0,0,0,0,0,0
"16306",2019-03-01,"sbpp","transporte regular","voo internacional",0,0,0,0,0,0,0,0,0,0
"16307",2019-03-01,"sbpp","transporte não regular","voo doméstico",98,100,198,146,123,269,0,0,0,0
"16308",2019-03-01,"sbpp","transporte não regular","voo internacional",7,6,13,4,9,13,0,0,0,0
"16309",2019-03-01,"sbpr","transporte regular","voo doméstico",0,0,0,0,0,0,0,0,0,0
"16310",2019-03-01,"sbpr","transporte regular","voo internacional",0,0,0,0,0,0,0,0,0,0
"16311",2019-03-01,"sbpr","transporte não regular","voo doméstico",806,809,1615,986,903,1889,0,0,0,0
"16312",2019-03-01,"sbpr","transporte não regular","voo internacional",0,0,0,0,0,0,0,0,0,0
"16313",2019-03-01,"sbpv","transporte regular","voo doméstico",288,286,574,29433,28770,58203,0,0,0,0
"16314",2019-03-01,"sbpv","transporte regular","voo internacional",0,0,0,0,0,0,0,0,0,0
"16315",2019-03-01,"sbpv","transporte não regular","voo doméstico",177,180,357,421,103,524,0,0,0,0
"16316",2019-03-01,"sbpv","transporte não regular","voo internacional",0,0,0,0,0,0,0,0,0,0
"16317",2019-03-01,"sbrb","transporte regular","voo doméstico",144,144,288,13955,14429,28384,0,0,0,0
"16318",2019-03-01,"sbrb","transporte regular","voo internacional",0,0,0,0,0,0,0,0,0,0
"16319",2019-03-01,"sbrb","transporte não regular","voo doméstico",121,122,243,338,276,614,0,0,0,0
"16320",2019-03-01,"sbrb","transporte não regular","voo internacional",1,1,2,0,0,0,0,0,0,0
"16321",2019-03-01,"sbrj","transporte regular","voo doméstico",3518,3526,7044,388403,378631,767034,0,0,0,0
"16322",2019-03-01,"sbrj","transporte regular","voo internacional",0,0,0,0,0,0,0,0,0,0
"16323",2019-03-01,"sbrj","transporte não regular","voo doméstico",582,572,1154,2210,1200,3410,0,0,0,0
"16324",2019-03-01,"sbrj","transporte não regular","voo internacional",4,4,8,0,0,0,0,0,0,0
"16325",2019-03-01,"sbsj","transporte regular","voo doméstico",37,36,73,1656,1732,3388,0,0,0,0
"16326",2019-03-01,"sbsj","transporte regular","voo internacional",0,0,0,0,0,0,0,0,0,0
"16327",2019-03-01,"sbsj","transporte não regular","voo doméstico",440,423,863,1116,1143,2259,0,0,0,0
"16328",2019-03-01,"sbsj","transporte não regular","voo internacional",9,18,27,96,54,150,0,0,0,0
"16329",2019-03-01,"sbsl","transporte regular","voo doméstico",517,516,1033,61538,60669,122207,0,0,0,0
"16330",2019-03-01,"sbsl","transporte regular","voo internacional",0,0,0,0,0,0,0,0,0,0
"16331",2019-03-01,"sbsl","transporte não regular","voo doméstico",169,170,339,243,446,689,510,170,680,0
"16332",2019-03-01,"sbsl","transporte não regular","voo internacional",5,4,9,0,2,2,0,0,0,0
"16333",2019-03-01,"sbsn","transporte regular","voo doméstico",221,222,443,15996,16692,32688,0,0,0,0
"16334",2019-03-01,"sbsn","transporte regular","voo internacional",0,0,0,0,0,0,0,0,0,0
"16335",2019-03-01,"sbsn","transporte não regular","voo doméstico",170,171,341,571,487,1058,2200,2400,4600,0
"16336",2019-03-01,"sbsn","transporte não regular","voo internacional",0,0,0,0,0,0,0,0,0,0
"16337",2019-03-01,"sbsp","transporte regular","voo doméstico",7121,7200,14321,928461,928466,1856927,0,0,0,0
"16338",2019-03-01,"sbsp","transporte regular","voo internacional",0,0,0,0,0,0,0,0,0,0
"16339",2019-03-01,"sbsp","transporte não regular","voo doméstico",1812,1746,3558,8809,8615,17424,0,0,0,0
"16340",2019-03-01,"sbsp","transporte não regular","voo internacional",16,15,31,12,12,24,0,0,0,0
"16341",2019-03-01,"sbte","transporte regular","voo doméstico",365,365,730,45002,44185,89187,0,0,0,0
"16342",2019-03-01,"sbte","transporte regular","voo internacional",0,0,0,0,0,0,0,0,0,0
"16343",2019-03-01,"sbte","transporte não regular","voo doméstico",131,131,262,768,968,1736,0,0,0,0
"16344",2019-03-01,"sbte","transporte não regular","voo internacional",0,0,0,0,0,0,0,0,0,0
"16345",2019-03-01,"sbtf","transporte regular","voo doméstico",31,31,62,1250,1314,2564,0,0,0,0
"16346",2019-03-01,"sbtf","transporte regular","voo internacional",0,0,0,0,0,0,0,0,0,0
"16347",2019-03-01,"sbtf","transporte não regular","voo doméstico",86,86,172,119,81,200,424,0,424,1340
"16348",2019-03-01,"sbtf","transporte não regular","voo internacional",0,0,0,0,0,0,0,0,0,0
"16349",2019-03-01,"sbtt","transporte regular","voo doméstico",30,30,60,2245,2522,4767,0,0,0,0
"16350",2019-03-01,"sbtt","transporte regular","voo internacional",0,0,0,0,0,0,0,0,0,0
"16351",2019-03-01,"sbtt","transporte não regular","voo doméstico",73,72,145,336,316,652,135,230,365,0
"16352",2019-03-01,"sbtt","transporte não regular","voo internacional",0,0,0,0,0,0,0,0,0,0
"16353",2019-03-01,"sbuf","transporte regular","voo doméstico",7,7,14,391,368,759,0,0,0,0
"16354",2019-03-01,"sbuf","transporte regular","voo internacional",0,0,0,0,0,0,0,0,0,0
"16355",2019-03-01,"sbuf","transporte não regular","voo doméstico",6,7,13,19,22,41,0,0,0,0
"16356",2019-03-01,"sbuf","transporte não regular","voo internacional",0,0,0,0,0,0,0,0,0,0
"16357",2019-03-01,"sbug","transporte regular","voo doméstico",15,15,30,873,733,1606,0,0,0,0
"16358",2019-03-01,"sbug","transporte regular","voo internacional",0,0,0,0,0,0,0,0,0,0
"16359",2019-03-01,"sbug","transporte não regular","voo doméstico",8,7,15,17,21,38,0,0,0,0
"16360",2019-03-01,"sbug","transporte não regular","voo internacional",0,0,0,0,0,0,0,0,0,0
"16361",2019-03-01,"sbul","transporte regular","voo doméstico",511,510,1021,48331,46758,95089,0,0,0,0
"16362",2019-03-01,"sbul","transporte regular","voo internacional",0,0,0,0,0,0,0,0,0,0
"16363",2019-03-01,"sbul","transporte não regular","voo doméstico",465,463,928,1249,1233,2482,0,0,0,0
"16364",2019-03-01,"sbul","transporte não regular","voo internacional",1,1,2,6,6,12,0,0,0,0
"16365",2019-03-01,"sbur","transporte regular","voo doméstico",58,58,116,3040,3204,6244,0,0,0,0
"16366",2019-03-01,"sbur","transporte regular","voo internacional",0,0,0,0,0,0,0,0,0,0
"16367",2019-03-01,"sbur","transporte não regular","voo doméstico",173,167,340,614,656,1270,0,0,0,0
"16368",2019-03-01,"sbur","transporte não regular","voo internacional",0,1,1,0,0,0,0,0,0,0
"16369",2019-11-01,"sbbe","transporte regular","voo doméstico",1131,1129,2260,149488,145575,295063,0,0,0,0
"16370",2019-11-01,"sbbe","transporte regular","voo internacional",52,52,104,5923,5882,11805,0,2,2,0
"16371",2019-11-01,"sbbe","transporte não regular","voo doméstico",493,498,991,600,1067,1667,0,0,0,0
"16372",2019-11-01,"sbbe","transporte não regular","voo internacional",5,6,11,6,4,10,0,0,0,0
"16373",2019-11-01,"sbbg","transporte regular","voo doméstico",23,24,47,78,77,155,0,0,0,0
"16374",2019-11-01,"sbbg","transporte regular","voo internacional",0,0,0,0,0,0,0,0,0,0
"16375",2019-11-01,"sbbg","transporte não regular","voo doméstico",16,15,31,48,62,110,0,0,0,0
"16376",2019-11-01,"sbbg","transporte não regular","voo internacional",0,0,0,0,0,0,0,0,0,0
"16377",2019-11-01,"sbbh","transporte regular","voo doméstico",0,0,0,0,0,0,0,0,0,0
"16378",2019-11-01,"sbbh","transporte regular","voo internacional",0,0,0,0,0,0,0,0,0,0
"16379",2019-11-01,"sbbh","transporte não regular","voo doméstico",1338,1328,2666,6635,6670,13305,0,0,0,0
"16380",2019-11-01,"sbbh","transporte não regular","voo internacional",1,0,1,0,0,0,0,0,0,0
"16381",2019-11-01,"sbbi","transporte regular","voo doméstico",0,0,0,0,0,0,0,0,0,0
"16382",2019-11-01,"sbbi","transporte regular","voo internacional",0,0,0,0,0,0,0,0,0,0
"16383",2019-11-01,"sbbi","transporte não regular","voo doméstico",1152,1125,2277,1088,974,2062,0,0,0,0
"16384",2019-11-01,"sbbi","transporte não regular","voo internacional",3,3,6,0,0,0,0,0,0,0
"16385",2019-11-01,"sbbv","transporte regular","voo doméstico",94,94,188,15893,12669,28562,0,0,0,0
"16386",2019-11-01,"sbbv","transporte regular","voo internacional",0,0,0,0,0,0,0,0,0,0
"16387",2019-11-01,"sbbv","transporte não regular","voo doméstico",258,260,518,643,139,782,0,0,0,0
"16388",2019-11-01,"sbbv","transporte não regular","voo internacional",19,19,38,6,0,6,0,0,0,0
"16389",2019-11-01,"sbcg","transporte regular","voo doméstico",508,508,1016,61375,61519,122894,52282,66560,118842,0
"16390",2019-11-01,"sbcg","transporte regular","voo internacional",0,0,0,0,0,0,0,0,0,0
"16391",2019-11-01,"sbcg","transporte não regular","voo doméstico",163,159,322,144,70,214,0,0,0,0
"16392",2019-11-01,"sbcg","transporte não regular","voo internacional",11,13,24,3,0,3,0,0,0,0
"16393",2019-11-01,"sbcj","transporte regular","voo doméstico",67,67,134,6409,6108,12517,0,0,0,0
"16394",2019-11-01,"sbcj","transporte regular","voo internacional",0,0,0,0,0,0,0,0,0,0
"16395",2019-11-01,"sbcj","transporte não regular","voo doméstico",93,92,185,809,56,865,0,0,0,0
"16396",2019-11-01,"sbcj","transporte não regular","voo internacional",0,0,0,0,0,0,0,0,0,0
"16397",2019-11-01,"sbcr","transporte regular","voo doméstico",22,22,44,1061,1408,2469,0,0,0,0
"16398",2019-11-01,"sbcr","transporte regular","voo internacional",0,0,0,0,0,0,0,0,0,0
"16399",2019-11-01,"sbcr","transporte não regular","voo doméstico",34,34,68,99,75,174,0,0,0,0
"16400",2019-11-01,"sbcr","transporte não regular","voo internacional",4,5,9,10,3,13,0,0,0,0
"16401",2019-11-01,"sbct","transporte regular","voo doméstico",2491,2502,4993,272189,271465,543654,141650,88465,230115,119888
"16402",2019-11-01,"sbct","transporte regular","voo internacional",89,88,177,3251,3267,6518,50395,26823,77218,837
"16403",2019-11-01,"sbct","transporte não regular","voo doméstico",269,252,521,1047,2486,3533,0,20204,20204,0
"16404",2019-11-01,"sbct","transporte não regular","voo internacional",13,17,30,44,41,85,0,0,0,0
"16405",2019-11-01,"sbcz","transporte regular","voo doméstico",30,30,60,2460,964,3424,0,0,0,0
"16406",2019-11-01,"sbcz","transporte regular","voo internacional",0,0,0,0,0,0,0,0,0,0
"16407",2019-11-01,"sbcz","transporte não regular","voo doméstico",183,179,362,732,753,1485,0,0,0,0
"16408",2019-11-01,"sbcz","transporte não regular","voo internacional",1,2,3,5,0,5,0,0,0,0
"16409",2019-11-01,"sbeg","transporte regular","voo doméstico",1011,998,2009,126603,114790,241393,144459,218154,362613,0
"16410",2019-11-01,"sbeg","transporte regular","voo internacional",98,107,205,5161,4864,10025,0,0,0,0
"16411",2019-11-01,"sbeg","transporte não regular","voo doméstico",691,680,1371,5546,2711,8257,3882,0,3882,0
"16412",2019-11-01,"sbeg","transporte não regular","voo internacional",67,74,141,236,2,238,0,0,0,0
"16413",2019-11-01,"sbfi","transporte regular","voo doméstico",713,709,1422,102361,98702,201063,0,0,0,0
"16414",2019-11-01,"sbfi","transporte regular","voo internacional",30,30,60,3757,3356,7113,0,0,0,0
"16415",2019-11-01,"sbfi","transporte não regular","voo doméstico",123,143,266,289,553,842,0,0,0,0
"16416",2019-11-01,"sbfi","transporte não regular","voo internacional",37,28,65,34,209,243,0,0,0,0
"16417",2019-11-01,"sbgo","transporte regular","voo doméstico",1114,1113,2227,128275,128966,257241,93409,177854,271263,0
"16418",2019-11-01,"sbgo","transporte regular","voo internacional",0,0,0,0,0,0,0,0,0,0
"16419",2019-11-01,"sbgo","transporte não regular","voo doméstico",941,929,1870,3900,3808,7708,0,0,0,0
"16420",2019-11-01,"sbgo","transporte não regular","voo internacional",5,6,11,0,0,0,0,0,0,0
"16421",2019-11-01,"sbht","transporte regular","voo doméstico",53,53,106,4058,3920,7978,0,0,0,0
"16422",2019-11-01,"sbht","transporte regular","voo internacional",0,0,0,0,0,0,0,0,0,0
"16423",2019-11-01,"sbht","transporte não regular","voo doméstico",70,70,140,190,205,395,0,0,0,0
"16424",2019-11-01,"sbht","transporte não regular","voo internacional",0,0,0,0,0,0,0,0,0,0
"16425",2019-11-01,"sbiz","transporte regular","voo doméstico",111,111,222,14044,13193,27237,0,0,0,0
"16426",2019-11-01,"sbiz","transporte regular","voo internacional",0,0,0,0,0,0,0,0,0,0
"16427",2019-11-01,"sbiz","transporte não regular","voo doméstico",92,90,182,25,0,25,0,0,0,0
"16428",2019-11-01,"sbiz","transporte não regular","voo internacional",0,0,0,0,0,0,0,0,0,0
"16429",2019-11-01,"sbjc","transporte regular","voo doméstico",0,0,0,0,0,0,0,0,0,0
"16430",2019-11-01,"sbjc","transporte regular","voo internacional",0,0,0,0,0,0,0,0,0,0
"16431",2019-11-01,"sbjc","transporte não regular","voo doméstico",353,353,706,772,538,1310,0,0,0,0
"16432",2019-11-01,"sbjc","transporte não regular","voo internacional",0,0,0,0,0,0,0,0,0,0
"16433",2019-11-01,"sbjr","transporte regular","voo doméstico",50,55,105,160,149,309,0,0,0,0
"16434",2019-11-01,"sbjr","transporte regular","voo internacional",0,0,0,0,0,0,0,0,0,0
"16435",2019-11-01,"sbjr","transporte não regular","voo doméstico",2371,2371,4742,11563,4900,16463,0,0,0,0
"16436",2019-11-01,"sbjr","transporte não regular","voo internacional",0,0,0,0,0,0,0,0,0,0
"16437",2019-11-01,"sbjv","transporte regular","voo doméstico",193,194,387,22676,22173,44849,0,0,0,0
"16438",2019-11-01,"sbjv","transporte regular","voo internacional",0,0,0,0,0,0,0,0,0,0
"16439",2019-11-01,"sbjv","transporte não regular","voo doméstico",78,75,153,98,259,357,0,0,0,0
"16440",2019-11-01,"sbjv","transporte não regular","voo internacional",1,1,2,0,0,0,0,0,0,0
"16441",2019-11-01,"sblo","transporte regular","voo doméstico",397,397,794,39943,41035,80978,0,0,0,0
"16442",2019-11-01,"sblo","transporte regular","voo internacional",0,0,0,0,0,0,0,0,0,0
"16443",2019-11-01,"sblo","transporte não regular","voo doméstico",496,501,997,181,16,197,0,0,0,0
"16444",2019-11-01,"sblo","transporte não regular","voo internacional",3,3,6,0,0,0,0,0,0,0
"16445",2019-11-01,"sbma","transporte regular","voo doméstico",108,108,216,12375,11681,24056,0,0,0,0
"16446",2019-11-01,"sbma","transporte regular","voo internacional",0,0,0,0,0,0,0,0,0,0
"16447",2019-11-01,"sbma","transporte não regular","voo doméstico",131,138,269,328,153,481,0,0,0,0
"16448",2019-11-01,"sbma","transporte não regular","voo internacional",0,0,0,0,0,0,0,0,0,0
"16449",2019-11-01,"sbmk","transporte regular","voo doméstico",140,141,281,9141,9037,18178,0,0,0,0
"16450",2019-11-01,"sbmk","transporte regular","voo internacional",0,0,0,0,0,0,0,0,0,0
"16451",2019-11-01,"sbmk","transporte não regular","voo doméstico",204,209,413,350,0,350,0,0,0,0
"16452",2019-11-01,"sbmk","transporte não regular","voo internacional",0,0,0,0,0,0,0,0,0,0
"16453",2019-11-01,"sbmq","transporte regular","voo doméstico",203,203,406,28923,26968,55891,0,0,0,0
"16454",2019-11-01,"sbmq","transporte regular","voo internacional",0,0,0,0,0,0,0,0,0,0
"16455",2019-11-01,"sbmq","transporte não regular","voo doméstico",167,172,339,429,133,562,7058,38830,45888,0
"16456",2019-11-01,"sbmq","transporte não regular","voo internacional",9,4,13,0,0,0,0,0,0,0
"16457",2019-11-01,"sbmt","transporte regular","voo doméstico",0,0,0,0,0,0,0,0,0,0
"16458",2019-11-01,"sbmt","transporte regular","voo internacional",0,0,0,0,0,0,0,0,0,0
"16459",2019-11-01,"sbmt","transporte não regular","voo doméstico",2326,2320,4646,3452,3552,7004,0,0,0,0
"16460",2019-11-01,"sbmt","transporte não regular","voo internacional",0,0,0,0,0,0,0,0,0,0
"16461",2019-11-01,"sbnf","transporte regular","voo doméstico",645,646,1291,84980,84989,169969,0,0,0,0
"16462",2019-11-01,"sbnf","transporte regular","voo internacional",0,0,0,0,0,0,0,0,0,0
"16463",2019-11-01,"sbnf","transporte não regular","voo doméstico",328,330,658,657,598,1255,0,0,0,0
"16464",2019-11-01,"sbnf","transporte não regular","voo internacional",2,2,4,9,0,9,0,0,0,0
"16465",2019-11-01,"sbpb","transporte regular","voo doméstico",5,5,10,317,533,850,0,0,0,0
"16466",2019-11-01,"sbpb","transporte regular","voo internacional",0,0,0,0,0,0,0,0,0,0
"16467",2019-11-01,"sbpb","transporte não regular","voo doméstico",52,50,102,117,118,235,0,0,0,0
"16468",2019-11-01,"sbpb","transporte não regular","voo internacional",0,0,0,0,0,0,0,0,0,0
"16469",2019-11-01,"sbpj","transporte regular","voo doméstico",228,228,456,23700,23110,46810,0,0,0,0
"16470",2019-11-01,"sbpj","transporte regular","voo internacional",0,0,0,0,0,0,0,0,0,0
"16471",2019-11-01,"sbpj","transporte não regular","voo doméstico",189,193,382,357,255,612,0,0,0,0
"16472",2019-11-01,"sbpj","transporte não regular","voo internacional",0,0,0,0,0,0,0,0,0,0
"16473",2019-11-01,"sbpk","transporte regular","voo doméstico",21,21,42,1151,1196,2347,0,0,0,0
"16474",2019-11-01,"sbpk","transporte regular","voo internacional",0,0,0,0,0,0,0,0,0,0
"16475",2019-11-01,"sbpk","transporte não regular","voo doméstico",29,29,58,64,76,140,0,0,0,0
"16476",2019-11-01,"sbpk","transporte não regular","voo internacional",2,2,4,2,0,2,0,0,0,0
"16477",2019-11-01,"sbpl","transporte regular","voo doméstico",149,149,298,15258,15595,30853,0,0,0,0
"16478",2019-11-01,"sbpl","transporte regular","voo internacional",4,4,8,0,0,0,0,0,0,0
"16479",2019-11-01,"sbpl","transporte não regular","voo doméstico",90,91,181,222,271,493,0,0,0,0
"16480",2019-11-01,"sbpl","transporte não regular","voo internacional",1,1,2,15,15,30,0,0,0,0
"16481",2019-11-01,"sbpp","transporte regular","voo doméstico",0,0,0,0,0,0,0,0,0,0
"16482",2019-11-01,"sbpp","transporte regular","voo internacional",0,0,0,0,0,0,0,0,0,0
"16483",2019-11-01,"sbpp","transporte não regular","voo doméstico",93,89,182,162,159,321,0,0,0,0
"16484",2019-11-01,"sbpp","transporte não regular","voo internacional",6,8,14,15,7,22,0,0,0,0
"16485",2019-11-01,"sbpr","transporte regular","voo doméstico",0,0,0,0,0,0,0,0,0,0
"16486",2019-11-01,"sbpr","transporte regular","voo internacional",0,0,0,0,0,0,0,0,0,0
"16487",2019-11-01,"sbpr","transporte não regular","voo doméstico",576,578,1154,775,676,1451,0,0,0,0
"16488",2019-11-01,"sbpr","transporte não regular","voo internacional",0,0,0,0,0,0,0,0,0,0
"16489",2019-11-01,"sbpv","transporte regular","voo doméstico",222,222,444,29687,27212,56899,0,0,0,0
"16490",2019-11-01,"sbpv","transporte regular","voo internacional",0,0,0,0,0,0,0,0,0,0
"16491",2019-11-01,"sbpv","transporte não regular","voo doméstico",134,133,267,129,340,469,0,0,0,0
"16492",2019-11-01,"sbpv","transporte não regular","voo internacional",1,1,2,0,0,0,0,0,0,0
"16493",2019-11-01,"sbrb","transporte regular","voo doméstico",148,149,297,15474,14259,29733,0,0,0,0
"16494",2019-11-01,"sbrb","transporte regular","voo internacional",0,0,0,0,0,0,0,0,0,0
"16495",2019-11-01,"sbrb","transporte não regular","voo doméstico",173,186,359,450,244,694,0,0,0,0
"16496",2019-11-01,"sbrb","transporte não regular","voo internacional",14,11,25,28,0,28,0,0,0,0
"16497",2019-11-01,"sbrj","transporte regular","voo doméstico",3990,4023,8013,445079,439552,884631,0,0,0,0
"16498",2019-11-01,"sbrj","transporte regular","voo internacional",0,0,0,0,0,0,0,0,0,0
"16499",2019-11-01,"sbrj","transporte não regular","voo doméstico",525,488,1013,1786,804,2590,0,0,0,0
"16500",2019-11-01,"sbrj","transporte não regular","voo internacional",2,2,4,9,0,9,0,0,0,0
"16501",2019-11-01,"sbsj","transporte regular","voo doméstico",34,34,68,1488,1357,2845,0,0,0,0
"16502",2019-11-01,"sbsj","transporte regular","voo internacional",0,0,0,0,0,0,0,0,0,0
"16503",2019-11-01,"sbsj","transporte não regular","voo doméstico",493,482,975,1562,1754,3316,0,0,0,0
"16504",2019-11-01,"sbsj","transporte não regular","voo internacional",4,17,21,36,4,40,0,0,0,0
"16505",2019-11-01,"sbsl","transporte regular","voo doméstico",551,549,1100,71559,72105,143664,0,0,0,0
"16506",2019-11-01,"sbsl","transporte regular","voo internacional",0,0,0,0,0,0,0,0,0,0
"16507",2019-11-01,"sbsl","transporte não regular","voo doméstico",203,203,406,346,267,613,0,0,0,0
"16508",2019-11-01,"sbsl","transporte não regular","voo internacional",3,3,6,8,4,12,0,0,0,0
"16509",2019-11-01,"sbsn","transporte regular","voo doméstico",202,202,404,25301,23005,48306,0,0,0,0
"16510",2019-11-01,"sbsn","transporte regular","voo internacional",0,0,0,0,0,0,0,0,0,0
"16511",2019-11-01,"sbsn","transporte não regular","voo doméstico",180,182,362,604,303,907,950,1200,2150,0
"16512",2019-11-01,"sbsn","transporte não regular","voo internacional",0,0,0,0,0,0,0,0,0,0
"16513",2019-11-01,"sbsp","transporte regular","voo doméstico",7296,7347,14643,948178,952127,1900305,0,0,0,0
"16514",2019-11-01,"sbsp","transporte regular","voo internacional",0,0,0,0,0,0,0,0,0,0
"16515",2019-11-01,"sbsp","transporte não regular","voo doméstico",2115,2077,4192,8125,7560,15685,0,0,0,0
"16516",2019-11-01,"sbsp","transporte não regular","voo internacional",6,6,12,0,0,0,0,0,0,0
"16517",2019-11-01,"sbte","transporte regular","voo doméstico",337,338,675,47112,45679,92791,0,0,0,0
"16518",2019-11-01,"sbte","transporte regular","voo internacional",0,0,0,0,0,0,0,0,0,0
"16519",2019-11-01,"sbte","transporte não regular","voo doméstico",172,165,337,861,894,1755,0,0,0,0
"16520",2019-11-01,"sbte","transporte não regular","voo internacional",0,0,0,0,0,0,0,0,0,0
"16521",2019-11-01,"sbtf","transporte regular","voo doméstico",13,13,26,1252,1206,2458,0,0,0,0
"16522",2019-11-01,"sbtf","transporte regular","voo internacional",0,0,0,0,0,0,0,0,0,0
"16523",2019-11-01,"sbtf","transporte não regular","voo doméstico",114,114,228,120,82,202,1055,0,1055,1505
"16524",2019-11-01,"sbtf","transporte não regular","voo internacional",0,0,0,0,0,0,0,0,0,0
"16525",2019-11-01,"sbtt","transporte regular","voo doméstico",28,28,56,2538,2685,5223,0,0,0,0
"16526",2019-11-01,"sbtt","transporte regular","voo internacional",0,0,0,0,0,0,0,0,0,0
"16527",2019-11-01,"sbtt","transporte não regular","voo doméstico",111,109,220,528,539,1067,100,0,100,0
"16528",2019-11-01,"sbtt","transporte não regular","voo internacional",2,3,5,12,12,24,0,0,0,0
"16529",2019-11-01,"sbuf","transporte regular","voo doméstico",9,9,18,465,456,921,0,0,0,0
"16530",2019-11-01,"sbuf","transporte regular","voo internacional",0,0,0,0,0,0,0,0,0,0
"16531",2019-11-01,"sbuf","transporte não regular","voo doméstico",26,25,51,39,25,64,0,0,0,0
"16532",2019-11-01,"sbuf","transporte não regular","voo internacional",0,0,0,0,0,0,0,0,0,0
"16533",2019-11-01,"sbug","transporte regular","voo doméstico",16,16,32,928,837,1765,0,0,0,0
"16534",2019-11-01,"sbug","transporte regular","voo internacional",0,0,0,0,0,0,0,0,0,0
"16535",2019-11-01,"sbug","transporte não regular","voo doméstico",3,3,6,6,8,14,0,0,0,0
"16536",2019-11-01,"sbug","transporte não regular","voo internacional",0,0,0,0,0,0,0,0,0,0
"16537",2019-11-01,"sbul","transporte regular","voo doméstico",450,447,897,44105,42659,86764,0,0,0,0
"16538",2019-11-01,"sbul","transporte regular","voo internacional",0,0,0,0,0,0,0,0,0,0
"16539",2019-11-01,"sbul","transporte não regular","voo doméstico",510,517,1027,1348,1002,2350,0,0,0,0
"16540",2019-11-01,"sbul","transporte não regular","voo internacional",0,0,0,0,0,0,0,0,0,0
"16541",2019-11-01,"sbur","transporte regular","voo doméstico",77,79,156,3268,3148,6416,0,0,0,0
"16542",2019-11-01,"sbur","transporte regular","voo internacional",0,0,0,0,0,0,0,0,0,0
"16543",2019-11-01,"sbur","transporte não regular","voo doméstico",149,151,300,563,572,1135,0,0,0,0
"16544",2019-11-01,"sbur","transporte não regular","voo internacional",1,0,1,0,0,0,0,0,0,0
"16545",2019-10-01,"sbbe","transporte regular","voo doméstico",1181,1185,2366,151498,149709,301207,0,0,0,0
"16546",2019-10-01,"sbbe","transporte regular","voo internacional",55,54,109,6757,6775,13532,2,17,19,0
"16547",2019-10-01,"sbbe","transporte não regular","voo doméstico",532,528,1060,767,1458,2225,0,0,0,0
"16548",2019-10-01,"sbbe","transporte não regular","voo internacional",10,7,17,12,18,30,0,0,0,0
"16549",2019-10-01,"sbbg","transporte regular","voo doméstico",19,19,38,62,55,117,0,0,0,0
"16550",2019-10-01,"sbbg","transporte regular","voo internacional",0,0,0,0,0,0,0,0,0,0
"16551",2019-10-01,"sbbg","transporte não regular","voo doméstico",13,12,25,32,49,81,0,0,0,0
"16552",2019-10-01,"sbbg","transporte não regular","voo internacional",3,4,7,14,4,18,0,0,0,0
"16553",2019-10-01,"sbbh","transporte regular","voo doméstico",0,0,0,0,0,0,0,0,0,0
"16554",2019-10-01,"sbbh","transporte regular","voo internacional",0,0,0,0,0,0,0,0,0,0
"16555",2019-10-01,"sbbh","transporte não regular","voo doméstico",1567,1575,3142,7325,7382,14707,0,0,0,0
"16556",2019-10-01,"sbbh","transporte não regular","voo internacional",0,0,0,0,0,0,0,0,0,0
"16557",2019-10-01,"sbbi","transporte regular","voo doméstico",0,0,0,0,0,0,0,0,0,0
"16558",2019-10-01,"sbbi","transporte regular","voo internacional",0,0,0,0,0,0,0,0,0,0
"16559",2019-10-01,"sbbi","transporte não regular","voo doméstico",1211,1215,2426,1030,899,1929,0,0,0,0
"16560",2019-10-01,"sbbi","transporte não regular","voo internacional",0,0,0,0,0,0,0,0,0,0
"16561",2019-10-01,"sbbv","transporte regular","voo doméstico",99,100,199,17068,12967,30035,0,0,0,0
"16562",2019-10-01,"sbbv","transporte regular","voo internacional",0,0,0,0,0,0,0,0,0,0
"16563",2019-10-01,"sbbv","transporte não regular","voo doméstico",305,304,609,341,139,480,0,0,0,0
"16564",2019-10-01,"sbbv","transporte não regular","voo internacional",16,13,29,10,0,10,0,0,0,0
"16565",2019-10-01,"sbcg","transporte regular","voo doméstico",571,570,1141,68749,68742,137491,54488,93550,148038,0
"16566",2019-10-01,"sbcg","transporte regular","voo internacional",0,0,0,0,0,0,0,0,0,0
"16567",2019-10-01,"sbcg","transporte não regular","voo doméstico",198,198,396,242,249,491,0,0,0,0
"16568",2019-10-01,"sbcg","transporte não regular","voo internacional",10,11,21,0,0,0,0,0,0,0
"16569",2019-10-01,"sbcj","transporte regular","voo doméstico",78,78,156,6919,6930,13849,0,0,0,0
"16570",2019-10-01,"sbcj","transporte regular","voo internacional",0,0,0,0,0,0,0,0,0,0
"16571",2019-10-01,"sbcj","transporte não regular","voo doméstico",99,99,198,695,176,871,0,0,0,0
"16572",2019-10-01,"sbcj","transporte não regular","voo internacional",0,0,0,0,0,0,0,0,0,0
"16573",2019-10-01,"sbcr","transporte regular","voo doméstico",21,21,42,1314,1863,3177,0,0,0,0
"16574",2019-10-01,"sbcr","transporte regular","voo internacional",0,0,0,0,0,0,0,0,0,0
"16575",2019-10-01,"sbcr","transporte não regular","voo doméstico",48,48,96,85,86,171,0,0,0,0
"16576",2019-10-01,"sbcr","transporte não regular","voo internacional",2,1,3,1,3,4,0,0,0,0
"16577",2019-10-01,"sbct","transporte regular","voo doméstico",2563,2569,5132,279862,278148,558010,169020,91470,260490,216151
"16578",2019-10-01,"sbct","transporte regular","voo internacional",74,74,148,3294,3238,6532,61593,23499,85092,0
"16579",2019-10-01,"sbct","transporte não regular","voo doméstico",269,264,533,1051,2207,3258,100,100,200,0
"16580",2019-10-01,"sbct","transporte não regular","voo internacional",16,11,27,39,47,86,0,0,0,0
"16581",2019-10-01,"sbcz","transporte regular","voo doméstico",31,31,62,2240,936,3176,0,0,0,0
"16582",2019-10-01,"sbcz","transporte regular","voo internacional",0,0,0,0,0,0,0,0,0,0
"16583",2019-10-01,"sbcz","transporte não regular","voo doméstico",244,246,490,941,699,1640,0,0,0,0
"16584",2019-10-01,"sbcz","transporte não regular","voo internacional",0,0,0,0,0,0,0,0,0,0
"16585",2019-10-01,"sbeg","transporte regular","voo doméstico",1067,1055,2122,129067,121495,250562,154242,242652,396894,0
"16586",2019-10-01,"sbeg","transporte regular","voo internacional",92,95,187,4995,4721,9716,0,0,0,0
"16587",2019-10-01,"sbeg","transporte não regular","voo doméstico",666,670,1336,7347,4430,11777,4425,26753,31178,0
"16588",2019-10-01,"sbeg","transporte não regular","voo internacional",63,67,130,19,967,986,0,0,0,0
"16589",2019-10-01,"sbfi","transporte regular","voo doméstico",696,694,1390,97822,98414,196236,0,0,0,0
"16590",2019-10-01,"sbfi","transporte regular","voo internacional",30,29,59,3404,3576,6980,0,0,0,0
"16591",2019-10-01,"sbfi","transporte não regular","voo doméstico",144,138,282,1533,1653,3186,0,0,0,0
"16592",2019-10-01,"sbfi","transporte não regular","voo internacional",37,35,72,37,52,89,0,0,0,0
"16593",2019-10-01,"sbgo","transporte regular","voo doméstico",1207,1203,2410,133655,134701,268356,91680,201963,293643,0
"16594",2019-10-01,"sbgo","transporte regular","voo internacional",0,0,0,0,0,0,0,0,0,0
"16595",2019-10-01,"sbgo","transporte não regular","voo doméstico",995,1013,2008,4325,3662,7987,0,0,0,0
"16596",2019-10-01,"sbgo","transporte não regular","voo internacional",3,1,4,0,0,0,0,0,0,0
"16597",2019-10-01,"sbht","transporte regular","voo doméstico",74,74,148,4153,3866,8019,0,0,0,0
"16598",2019-10-01,"sbht","transporte regular","voo internacional",0,0,0,0,0,0,0,0,0,0
"16599",2019-10-01,"sbht","transporte não regular","voo doméstico",31,31,62,161,138,299,0,0,0,0
"16600",2019-10-01,"sbht","transporte não regular","voo internacional",0,0,0,0,0,0,0,0,0,0
"16601",2019-10-01,"sbiz","transporte regular","voo doméstico",116,116,232,14530,13991,28521,0,0,0,0
"16602",2019-10-01,"sbiz","transporte regular","voo internacional",0,0,0,0,0,0,0,0,0,0
"16603",2019-10-01,"sbiz","transporte não regular","voo doméstico",165,163,328,83,64,147,0,0,0,0
"16604",2019-10-01,"sbiz","transporte não regular","voo internacional",1,1,2,0,0,0,0,0,0,0
"16605",2019-10-01,"sbjc","transporte regular","voo doméstico",0,0,0,0,0,0,0,0,0,0
"16606",2019-10-01,"sbjc","transporte regular","voo internacional",0,0,0,0,0,0,0,0,0,0
"16607",2019-10-01,"sbjc","transporte não regular","voo doméstico",294,294,588,628,407,1035,0,0,0,0
"16608",2019-10-01,"sbjc","transporte não regular","voo internacional",0,0,0,0,0,0,0,0,0,0
"16609",2019-10-01,"sbjr","transporte regular","voo doméstico",13,8,21,16,10,26,0,0,0,0
"16610",2019-10-01,"sbjr","transporte regular","voo internacional",0,0,0,0,0,0,0,0,0,0
"16611",2019-10-01,"sbjr","transporte não regular","voo doméstico",2536,2534,5070,10891,3831,14722,0,0,0,0
"16612",2019-10-01,"sbjr","transporte não regular","voo internacional",0,0,0,0,0,0,0,0,0,0
"16613",2019-10-01,"sbjv","transporte regular","voo doméstico",236,237,473,27277,27389,54666,0,0,0,0
"16614",2019-10-01,"sbjv","transporte regular","voo internacional",0,0,0,0,0,0,0,0,0,0
"16615",2019-10-01,"sbjv","transporte não regular","voo doméstico",65,65,130,103,225,328,0,0,0,0
"16616",2019-10-01,"sbjv","transporte não regular","voo internacional",0,0,0,0,0,0,0,0,0,0
"16617",2019-10-01,"sblo","transporte regular","voo doméstico",430,430,860,43174,45532,88706,0,0,0,0
"16618",2019-10-01,"sblo","transporte regular","voo internacional",0,0,0,0,0,0,0,0,0,0
"16619",2019-10-01,"sblo","transporte não regular","voo doméstico",523,520,1043,354,880,1234,0,0,0,0
"16620",2019-10-01,"sblo","transporte não regular","voo internacional",0,0,0,0,0,0,0,0,0,0
"16621",2019-10-01,"sbma","transporte regular","voo doméstico",116,116,232,13284,12439,25723,0,0,0,0
"16622",2019-10-01,"sbma","transporte regular","voo internacional",0,0,0,0,0,0,0,0,0,0
"16623",2019-10-01,"sbma","transporte não regular","voo doméstico",191,187,378,216,256,472,0,0,0,0
"16624",2019-10-01,"sbma","transporte não regular","voo internacional",17,17,34,14,0,14,0,0,0,0
"16625",2019-10-01,"sbmk","transporte regular","voo doméstico",157,157,314,9946,9756,19702,0,0,0,0
"16626",2019-10-01,"sbmk","transporte regular","voo internacional",0,0,0,0,0,0,0,0,0,0
"16627",2019-10-01,"sbmk","transporte não regular","voo doméstico",214,209,423,439,82,521,0,0,0,0
"16628",2019-10-01,"sbmk","transporte não regular","voo internacional",1,1,2,0,0,0,0,0,0,0
"16629",2019-10-01,"sbmq","transporte regular","voo doméstico",211,209,420,27375,25644,53019,0,0,0,0
"16630",2019-10-01,"sbmq","transporte regular","voo internacional",0,0,0,0,0,0,0,0,0,0
"16631",2019-10-01,"sbmq","transporte não regular","voo doméstico",151,155,306,195,108,303,15910,35100,51010,0
"16632",2019-10-01,"sbmq","transporte não regular","voo internacional",7,6,13,0,0,0,0,0,0,0
"16633",2019-10-01,"sbmt","transporte regular","voo doméstico",0,0,0,0,0,0,0,0,0,0
"16634",2019-10-01,"sbmt","transporte regular","voo internacional",0,0,0,0,0,0,0,0,0,0
"16635",2019-10-01,"sbmt","transporte não regular","voo doméstico",2770,2765,5535,4034,4172,8206,0,0,0,0
"16636",2019-10-01,"sbmt","transporte não regular","voo internacional",0,0,0,0,0,0,0,0,0,0
"16637",2019-10-01,"sbnf","transporte regular","voo doméstico",740,741,1481,86985,89102,176087,0,0,0,0
"16638",2019-10-01,"sbnf","transporte regular","voo internacional",0,0,0,0,0,0,0,0,0,0
"16639",2019-10-01,"sbnf","transporte não regular","voo doméstico",279,274,553,1603,1425,3028,0,0,0,0
"16640",2019-10-01,"sbnf","transporte não regular","voo internacional",1,1,2,2,9,11,0,0,0,0
"16641",2019-10-01,"sbpb","transporte regular","voo doméstico",3,3,6,221,337,558,0,0,0,0
"16642",2019-10-01,"sbpb","transporte regular","voo internacional",0,0,0,0,0,0,0,0,0,0
"16643",2019-10-01,"sbpb","transporte não regular","voo doméstico",71,70,141,192,181,373,0,0,0,0
"16644",2019-10-01,"sbpb","transporte não regular","voo internacional",0,0,0,0,0,0,0,0,0,0
"16645",2019-10-01,"sbpj","transporte regular","voo doméstico",254,254,508,25725,25556,51281,0,0,0,0
"16646",2019-10-01,"sbpj","transporte regular","voo internacional",0,0,0,0,0,0,0,0,0,0
"16647",2019-10-01,"sbpj","transporte não regular","voo doméstico",186,187,373,322,51,373,0,0,0,0
"16648",2019-10-01,"sbpj","transporte não regular","voo internacional",6,9,15,0,0,0,0,0,0,0
"16649",2019-10-01,"sbpk","transporte regular","voo doméstico",25,25,50,1424,1390,2814,0,0,0,0
"16650",2019-10-01,"sbpk","transporte regular","voo internacional",0,0,0,0,0,0,0,0,0,0
"16651",2019-10-01,"sbpk","transporte não regular","voo doméstico",23,20,43,52,70,122,0,0,0,0
"16652",2019-10-01,"sbpk","transporte não regular","voo internacional",1,5,6,3,0,3,0,0,0,0
"16653",2019-10-01,"sbpl","transporte regular","voo doméstico",148,148,296,15158,15943,31101,0,0,0,0
"16654",2019-10-01,"sbpl","transporte regular","voo internacional",5,5,10,0,0,0,0,0,0,0
"16655",2019-10-01,"sbpl","transporte não regular","voo doméstico",83,83,166,135,300,435,0,0,0,0
"16656",2019-10-01,"sbpl","transporte não regular","voo internacional",0,0,0,0,0,0,0,0,0,0
"16657",2019-10-01,"sbpp","transporte regular","voo doméstico",0,0,0,0,0,0,0,0,0,0
"16658",2019-10-01,"sbpp","transporte regular","voo internacional",0,0,0,0,0,0,0,0,0,0
"16659",2019-10-01,"sbpp","transporte não regular","voo doméstico",97,101,198,168,171,339,0,0,0,0
"16660",2019-10-01,"sbpp","transporte não regular","voo internacional",10,5,15,5,5,10,0,0,0,0
"16661",2019-10-01,"sbpr","transporte regular","voo doméstico",0,0,0,0,0,0,0,0,0,0
"16662",2019-10-01,"sbpr","transporte regular","voo internacional",0,0,0,0,0,0,0,0,0,0
"16663",2019-10-01,"sbpr","transporte não regular","voo doméstico",979,986,1965,1105,1032,2137,0,0,0,0
"16664",2019-10-01,"sbpr","transporte não regular","voo internacional",0,0,0,0,0,0,0,0,0,0
"16665",2019-10-01,"sbpv","transporte regular","voo doméstico",225,225,450,31424,30340,61764,0,0,0,0
"16666",2019-10-01,"sbpv","transporte regular","voo internacional",0,0,0,0,0,0,0,0,0,0
"16667",2019-10-01,"sbpv","transporte não regular","voo doméstico",165,164,329,29,0,29,0,0,0,0
"16668",2019-10-01,"sbpv","transporte não regular","voo internacional",0,0,0,0,0,0,0,0,0,0
"16669",2019-10-01,"sbrb","transporte regular","voo doméstico",154,154,308,14312,13535,27847,0,0,0,0
"16670",2019-10-01,"sbrb","transporte regular","voo internacional",0,0,0,0,0,0,0,0,0,0
"16671",2019-10-01,"sbrb","transporte não regular","voo doméstico",189,184,373,355,178,533,0,0,0,0
"16672",2019-10-01,"sbrb","transporte não regular","voo internacional",0,0,0,0,0,0,0,0,0,0
"16673",2019-10-01,"sbrj","transporte regular","voo doméstico",4115,4125,8240,461128,447001,908129,0,0,0,0
"16674",2019-10-01,"sbrj","transporte regular","voo internacional",0,0,0,0,0,0,0,0,0,0
"16675",2019-10-01,"sbrj","transporte não regular","voo doméstico",535,531,1066,1510,999,2509,0,0,0,0
"16676",2019-10-01,"sbrj","transporte não regular","voo internacional",1,1,2,0,0,0,0,0,0,0
"16677",2019-10-01,"sbsj","transporte regular","voo doméstico",43,44,87,1996,1856,3852,0,0,0,0
"16678",2019-10-01,"sbsj","transporte regular","voo internacional",0,0,0,0,0,0,0,0,0,0
"16679",2019-10-01,"sbsj","transporte não regular","voo doméstico",473,463,936,1613,1741,3354,0,0,0,0
"16680",2019-10-01,"sbsj","transporte não regular","voo internacional",4,14,18,39,5,44,0,0,0,0
"16681",2019-10-01,"sbsl","transporte regular","voo doméstico",534,534,1068,69131,69952,139083,0,0,0,0
"16682",2019-10-01,"sbsl","transporte regular","voo internacional",0,0,0,0,0,0,0,0,0,0
"16683",2019-10-01,"sbsl","transporte não regular","voo doméstico",237,242,479,324,194,518,0,0,0,0
"16684",2019-10-01,"sbsl","transporte não regular","voo internacional",2,1,3,0,0,0,0,0,0,0
"16685",2019-10-01,"sbsn","transporte regular","voo doméstico",232,232,464,25635,24624,50259,0,0,0,0
"16686",2019-10-01,"sbsn","transporte regular","voo internacional",0,0,0,0,0,0,0,0,0,0
"16687",2019-10-01,"sbsn","transporte não regular","voo doméstico",229,228,457,181,93,274,0,0,0,0
"16688",2019-10-01,"sbsn","transporte não regular","voo internacional",0,0,0,0,0,0,0,0,0,0
"16689",2019-10-01,"sbsp","transporte regular","voo doméstico",7414,7455,14869,995511,996545,1992056,0,0,0,0
"16690",2019-10-01,"sbsp","transporte regular","voo internacional",0,0,0,0,0,0,0,0,0,0
"16691",2019-10-01,"sbsp","transporte não regular","voo doméstico",2244,2194,4438,16153,17165,33318,0,0,0,0
"16692",2019-10-01,"sbsp","transporte não regular","voo internacional",5,4,9,0,0,0,0,0,0,0
"16693",2019-10-01,"sbte","transporte regular","voo doméstico",340,339,679,47880,47162,95042,0,0,0,0
"16694",2019-10-01,"sbte","transporte regular","voo internacional",0,0,0,0,0,0,0,0,0,0
"16695",2019-10-01,"sbte","transporte não regular","voo doméstico",166,165,331,986,904,1890,0,0,0,0
"16696",2019-10-01,"sbte","transporte não regular","voo internacional",0,0,0,0,0,0,0,0,0,0
"16697",2019-10-01,"sbtf","transporte regular","voo doméstico",25,25,50,1339,1376,2715,0,0,0,0
"16698",2019-10-01,"sbtf","transporte regular","voo internacional",0,0,0,0,0,0,0,0,0,0
"16699",2019-10-01,"sbtf","transporte não regular","voo doméstico",109,110,219,120,95,215,520,280,800,810
"16700",2019-10-01,"sbtf","transporte não regular","voo internacional",0,0,0,0,0,0,0,0,0,0
"16701",2019-10-01,"sbtt","transporte regular","voo doméstico",29,29,58,2259,2652,4911,0,0,0,0
"16702",2019-10-01,"sbtt","transporte regular","voo internacional",0,0,0,0,0,0,0,0,0,0
"16703",2019-10-01,"sbtt","transporte não regular","voo doméstico",97,95,192,441,474,915,680,1142,1822,0
"16704",2019-10-01,"sbtt","transporte não regular","voo internacional",2,3,5,5,0,5,0,0,0,0
"16705",2019-10-01,"sbuf","transporte regular","voo doméstico",8,8,16,437,434,871,0,0,0,0
"16706",2019-10-01,"sbuf","transporte regular","voo internacional",0,0,0,0,0,0,0,0,0,0
"16707",2019-10-01,"sbuf","transporte não regular","voo doméstico",26,25,51,41,29,70,0,0,0,0
"16708",2019-10-01,"sbuf","transporte não regular","voo internacional",0,0,0,0,0,0,0,0,0,0
"16709",2019-10-01,"sbug","transporte regular","voo doméstico",15,15,30,916,775,1691,0,0,0,0
"16710",2019-10-01,"sbug","transporte regular","voo internacional",0,0,0,0,0,0,0,0,0,0
"16711",2019-10-01,"sbug","transporte não regular","voo doméstico",8,8,16,70,67,137,0,0,0,0
"16712",2019-10-01,"sbug","transporte não regular","voo internacional",0,0,0,0,0,0,0,0,0,0
"16713",2019-10-01,"sbul","transporte regular","voo doméstico",514,513,1027,51245,50656,101901,0,0,0,0
"16714",2019-10-01,"sbul","transporte regular","voo internacional",0,0,0,0,0,0,0,0,0,0
"16715",2019-10-01,"sbul","transporte não regular","voo doméstico",568,570,1138,1513,1331,2844,0,0,0,0
"16716",2019-10-01,"sbul","transporte não regular","voo internacional",0,0,0,0,0,0,0,0,0,0
"16717",2019-10-01,"sbur","transporte regular","voo doméstico",67,65,132,3332,3312,6644,0,0,0,0
"16718",2019-10-01,"sbur","transporte regular","voo internacional",0,0,0,0,0,0,0,0,0,0
"16719",2019-10-01,"sbur","transporte não regular","voo doméstico",199,198,397,602,595,1197,0,0,0,0
"16720",2019-10-01,"sbur","transporte não regular","voo internacional",0,0,0,0,0,0,0,0,0,0
"16721",2019-09-01,"sbbe","transporte regular","voo doméstico",1089,1085,2174,143833,143901,287734,0,0,0,0
"16722",2019-09-01,"sbbe","transporte regular","voo internacional",56,60,116,8235,7093,15328,0,4,4,0
"16723",2019-09-01,"sbbe","transporte não regular","voo doméstico",441,443,884,709,1004,1713,0,0,0,0
"16724",2019-09-01,"sbbe","transporte não regular","voo internacional",9,8,17,0,8,8,0,0,0,0
"16725",2019-09-01,"sbbg","transporte regular","voo doméstico",7,7,14,27,11,38,0,0,0,0
"16726",2019-09-01,"sbbg","transporte regular","voo internacional",0,0,0,0,0,0,0,0,0,0
"16727",2019-09-01,"sbbg","transporte não regular","voo doméstico",16,13,29,39,67,106,0,0,0,0
"16728",2019-09-01,"sbbg","transporte não regular","voo internacional",0,1,1,2,0,2,0,0,0,0
"16729",2019-09-01,"sbbh","transporte regular","voo doméstico",0,0,0,0,0,0,0,0,0,0
"16730",2019-09-01,"sbbh","transporte regular","voo internacional",0,0,0,0,0,0,0,0,0,0
"16731",2019-09-01,"sbbh","transporte não regular","voo doméstico",1487,1490,2977,6811,6720,13531,0,0,0,0
"16732",2019-09-01,"sbbh","transporte não regular","voo internacional",2,3,5,20,15,35,0,0,0,0
"16733",2019-09-01,"sbbi","transporte regular","voo doméstico",0,0,0,0,0,0,0,0,0,0
"16734",2019-09-01,"sbbi","transporte regular","voo internacional",0,0,0,0,0,0,0,0,0,0
"16735",2019-09-01,"sbbi","transporte não regular","voo doméstico",1003,1005,2008,1004,925,1929,0,0,0,0
"16736",2019-09-01,"sbbi","transporte não regular","voo internacional",0,0,0,0,0,0,0,0,0,0
"16737",2019-09-01,"sbbv","transporte regular","voo doméstico",101,100,201,16731,12866,29597,0,0,0,0
"16738",2019-09-01,"sbbv","transporte regular","voo internacional",0,0,0,0,0,0,0,0,0,0
"16739",2019-09-01,"sbbv","transporte não regular","voo doméstico",235,235,470,396,286,682,0,0,0,0
"16740",2019-09-01,"sbbv","transporte não regular","voo internacional",17,18,35,11,0,11,0,0,0,0
"16741",2019-09-01,"sbcg","transporte regular","voo doméstico",555,553,1108,62541,64081,126622,48923,88089,137012,0
"16742",2019-09-01,"sbcg","transporte regular","voo internacional",0,0,0,0,0,0,0,0,0,0
"16743",2019-09-01,"sbcg","transporte não regular","voo doméstico",222,218,440,354,286,640,0,0,0,0
"16744",2019-09-01,"sbcg","transporte não regular","voo internacional",12,12,24,4,2,6,0,0,0,0
"16745",2019-09-01,"sbcj","transporte regular","voo doméstico",81,81,162,6127,7752,13879,0,0,0,0
"16746",2019-09-01,"sbcj","transporte regular","voo internacional",0,0,0,0,0,0,0,0,0,0
"16747",2019-09-01,"sbcj","transporte não regular","voo doméstico",72,72,144,564,169,733,0,0,0,0
"16748",2019-09-01,"sbcj","transporte não regular","voo internacional",0,0,0,0,0,0,0,0,0,0
"16749",2019-09-01,"sbcr","transporte regular","voo doméstico",21,21,42,1347,1829,3176,0,0,0,0
"16750",2019-09-01,"sbcr","transporte regular","voo internacional",0,0,0,0,0,0,0,0,0,0
"16751",2019-09-01,"sbcr","transporte não regular","voo doméstico",45,47,92,112,104,216,0,0,0,0
"16752",2019-09-01,"sbcr","transporte não regular","voo internacional",2,0,2,0,4,4,0,0,0,0
"16753",2019-09-01,"sbct","transporte regular","voo doméstico",2487,2515,5002,268792,263000,531792,108113,42294,150407,153097
"16754",2019-09-01,"sbct","transporte regular","voo internacional",78,78,156,3369,3607,6976,42555,29930,72485,0
"16755",2019-09-01,"sbct","transporte não regular","voo doméstico",304,286,590,1270,2679,3949,0,1185,1185,0
"16756",2019-09-01,"sbct","transporte não regular","voo internacional",17,16,33,55,47,102,0,0,0,0
"16757",2019-09-01,"sbcz","transporte regular","voo doméstico",30,30,60,2552,1030,3582,0,0,0,0
"16758",2019-09-01,"sbcz","transporte regular","voo internacional",0,0,0,0,0,0,0,0,0,0
"16759",2019-09-01,"sbcz","transporte não regular","voo doméstico",217,219,436,741,594,1335,0,0,0,0
"16760",2019-09-01,"sbcz","transporte não regular","voo internacional",0,0,0,0,0,0,0,0,0,0
"16761",2019-09-01,"sbeg","transporte regular","voo doméstico",1005,1004,2009,120482,115209,235691,108014,172717,280731,0
"16762",2019-09-01,"sbeg","transporte regular","voo internacional",90,97,187,4665,4785,9450,0,0,0,0
"16763",2019-09-01,"sbeg","transporte não regular","voo doméstico",565,577,1142,6602,4450,11052,11719,7839,19558,0
"16764",2019-09-01,"sbeg","transporte não regular","voo internacional",62,54,116,74,104,178,0,0,0,0
"16765",2019-09-01,"sbfi","transporte regular","voo doméstico",686,687,1373,87591,85978,173569,0,0,0,0
"16766",2019-09-01,"sbfi","transporte regular","voo internacional",25,25,50,2823,2569,5392,0,0,0,0
"16767",2019-09-01,"sbfi","transporte não regular","voo doméstico",111,116,227,1401,1553,2954,0,0,0,0
"16768",2019-09-01,"sbfi","transporte não regular","voo internacional",33,32,65,64,57,121,0,0,0,0
"16769",2019-09-01,"sbgo","transporte regular","voo doméstico",1187,1187,2374,129240,129629,258869,92942,133241,226183,0
"16770",2019-09-01,"sbgo","transporte regular","voo internacional",0,0,0,0,0,0,0,0,0,0
"16771",2019-09-01,"sbgo","transporte não regular","voo doméstico",1035,1013,2048,4084,3944,8028,0,0,0,0
"16772",2019-09-01,"sbgo","transporte não regular","voo internacional",5,6,11,0,0,0,0,0,0,0
"16773",2019-09-01,"sbht","transporte regular","voo doméstico",78,78,156,4192,3959,8151,0,0,0,0
"16774",2019-09-01,"sbht","transporte regular","voo internacional",0,0,0,0,0,0,0,0,0,0
"16775",2019-09-01,"sbht","transporte não regular","voo doméstico",68,69,137,168,160,328,0,0,0,0
"16776",2019-09-01,"sbht","transporte não regular","voo internacional",1,1,2,0,0,0,0,0,0,0
"16777",2019-09-01,"sbiz","transporte regular","voo doméstico",110,110,220,14074,13692,27766,0,0,0,0
"16778",2019-09-01,"sbiz","transporte regular","voo internacional",0,0,0,0,0,0,0,0,0,0
"16779",2019-09-01,"sbiz","transporte não regular","voo doméstico",144,145,289,184,133,317,0,0,0,0
"16780",2019-09-01,"sbiz","transporte não regular","voo internacional",0,0,0,0,0,0,0,0,0,0
"16781",2019-09-01,"sbjc","transporte regular","voo doméstico",0,0,0,0,0,0,0,0,0,0
"16782",2019-09-01,"sbjc","transporte regular","voo internacional",0,0,0,0,0,0,0,0,0,0
"16783",2019-09-01,"sbjc","transporte não regular","voo doméstico",250,251,501,591,236,827,0,0,0,0
"16784",2019-09-01,"sbjc","transporte não regular","voo internacional",0,0,0,0,0,0,0,0,0,0
"16785",2019-09-01,"sbjr","transporte regular","voo doméstico",0,0,0,0,0,0,0,0,0,0
"16786",2019-09-01,"sbjr","transporte regular","voo internacional",0,0,0,0,0,0,0,0,0,0
"16787",2019-09-01,"sbjr","transporte não regular","voo doméstico",2107,2107,4214,9726,3115,12841,0,0,0,0
"16788",2019-09-01,"sbjr","transporte não regular","voo internacional",0,0,0,0,0,0,0,0,0,0
"16789",2019-09-01,"sbjv","transporte regular","voo doméstico",238,239,477,26936,26885,53821,0,0,0,0
"16790",2019-09-01,"sbjv","transporte regular","voo internacional",0,0,0,0,0,0,0,0,0,0
"16791",2019-09-01,"sbjv","transporte não regular","voo doméstico",61,60,121,50,238,288,0,0,0,0
"16792",2019-09-01,"sbjv","transporte não regular","voo internacional",0,0,0,0,0,0,0,0,0,0
"16793",2019-09-01,"sblo","transporte regular","voo doméstico",426,424,850,43205,44313,87518,0,0,0,0
"16794",2019-09-01,"sblo","transporte regular","voo internacional",0,0,0,0,0,0,0,0,0,0
"16795",2019-09-01,"sblo","transporte não regular","voo doméstico",452,448,900,121,57,178,0,0,0,0
"16796",2019-09-01,"sblo","transporte não regular","voo internacional",0,0,0,0,0,0,0,0,0,0
"16797",2019-09-01,"sbma","transporte regular","voo doméstico",130,130,260,12866,13800,26666,0,0,0,0
"16798",2019-09-01,"sbma","transporte regular","voo internacional",0,0,0,0,0,0,0,0,0,0
"16799",2019-09-01,"sbma","transporte não regular","voo doméstico",164,165,329,222,282,504,0,0,0,0
"16800",2019-09-01,"sbma","transporte não regular","voo internacional",0,0,0,0,0,0,0,0,0,0
"16801",2019-09-01,"sbmk","transporte regular","voo doméstico",151,151,302,9587,9463,19050,0,0,0,0
"16802",2019-09-01,"sbmk","transporte regular","voo internacional",0,0,0,0,0,0,0,0,0,0
"16803",2019-09-01,"sbmk","transporte não regular","voo doméstico",174,176,350,300,3,303,0,0,0,0
"16804",2019-09-01,"sbmk","transporte não regular","voo internacional",0,0,0,0,0,0,0,0,0,0
"16805",2019-09-01,"sbmq","transporte regular","voo doméstico",197,198,395,26574,24984,51558,0,0,0,0
"16806",2019-09-01,"sbmq","transporte regular","voo internacional",0,0,0,0,0,0,0,0,0,0
"16807",2019-09-01,"sbmq","transporte não regular","voo doméstico",141,141,282,129,103,232,10500,30529,41029,0
"16808",2019-09-01,"sbmq","transporte não regular","voo internacional",3,1,4,0,0,0,0,0,0,0
"16809",2019-09-01,"sbmt","transporte regular","voo doméstico",0,0,0,0,0,0,0,0,0,0
"16810",2019-09-01,"sbmt","transporte regular","voo internacional",0,0,0,0,0,0,0,0,0,0
"16811",2019-09-01,"sbmt","transporte não regular","voo doméstico",2192,2188,4380,3533,3580,7113,0,0,0,0
"16812",2019-09-01,"sbmt","transporte não regular","voo internacional",0,0,0,0,0,0,0,0,0,0
"16813",2019-09-01,"sbnf","transporte regular","voo doméstico",635,637,1272,76230,75842,152072,0,0,0,0
"16814",2019-09-01,"sbnf","transporte regular","voo internacional",0,0,0,0,0,0,0,0,0,0
"16815",2019-09-01,"sbnf","transporte não regular","voo doméstico",279,277,556,817,754,1571,0,0,0,0
"16816",2019-09-01,"sbnf","transporte não regular","voo internacional",1,1,2,6,4,10,0,0,0,0
"16817",2019-09-01,"sbpb","transporte regular","voo doméstico",4,4,8,361,411,772,0,0,0,0
"16818",2019-09-01,"sbpb","transporte regular","voo internacional",0,0,0,0,0,0,0,0,0,0
"16819",2019-09-01,"sbpb","transporte não regular","voo doméstico",76,80,156,221,188,409,0,0,0,0
"16820",2019-09-01,"sbpb","transporte não regular","voo internacional",0,0,0,0,0,0,0,0,0,0
"16821",2019-09-01,"sbpj","transporte regular","voo doméstico",244,244,488,24616,24175,48791,0,0,0,0
"16822",2019-09-01,"sbpj","transporte regular","voo internacional",0,0,0,0,0,0,0,0,0,0
"16823",2019-09-01,"sbpj","transporte não regular","voo doméstico",207,206,413,408,499,907,0,0,0,0
"16824",2019-09-01,"sbpj","transporte não regular","voo internacional",5,3,8,0,0,0,0,0,0,0
"16825",2019-09-01,"sbpk","transporte regular","voo doméstico",25,25,50,1332,1286,2618,0,0,0,0
"16826",2019-09-01,"sbpk","transporte regular","voo internacional",0,0,0,0,0,0,0,0,0,0
"16827",2019-09-01,"sbpk","transporte não regular","voo doméstico",39,38,77,99,105,204,0,0,0,0
"16828",2019-09-01,"sbpk","transporte não regular","voo internacional",1,1,2,0,0,0,0,0,0,0
"16829",2019-09-01,"sbpl","transporte regular","voo doméstico",139,139,278,15388,15336,30724,0,0,0,0
"16830",2019-09-01,"sbpl","transporte regular","voo internacional",4,4,8,0,0,0,0,0,0,0
"16831",2019-09-01,"sbpl","transporte não regular","voo doméstico",83,81,164,111,102,213,0,0,0,0
"16832",2019-09-01,"sbpl","transporte não regular","voo internacional",0,0,0,0,0,0,0,0,0,0
"16833",2019-09-01,"sbpp","transporte regular","voo doméstico",0,0,0,0,0,0,0,0,0,0
"16834",2019-09-01,"sbpp","transporte regular","voo internacional",0,0,0,0,0,0,0,0,0,0
"16835",2019-09-01,"sbpp","transporte não regular","voo doméstico",83,80,163,151,157,308,0,0,0,0
"16836",2019-09-01,"sbpp","transporte não regular","voo internacional",5,8,13,4,5,9,0,0,0,0
"16837",2019-09-01,"sbpr","transporte regular","voo doméstico",0,0,0,0,0,0,0,0,0,0
"16838",2019-09-01,"sbpr","transporte regular","voo internacional",0,0,0,0,0,0,0,0,0,0
"16839",2019-09-01,"sbpr","transporte não regular","voo doméstico",846,835,1681,905,877,1782,0,0,0,0
"16840",2019-09-01,"sbpr","transporte não regular","voo internacional",0,0,0,0,0,0,0,0,0,0
"16841",2019-09-01,"sbpv","transporte regular","voo doméstico",214,215,429,29332,27747,57079,0,0,0,0
"16842",2019-09-01,"sbpv","transporte regular","voo internacional",0,0,0,0,0,0,0,0,0,0
"16843",2019-09-01,"sbpv","transporte não regular","voo doméstico",190,190,380,380,289,669,0,0,0,0
"16844",2019-09-01,"sbpv","transporte não regular","voo internacional",0,0,0,0,0,0,0,0,0,0
"16845",2019-09-01,"sbrb","transporte regular","voo doméstico",145,144,289,14200,13995,28195,0,0,0,0
"16846",2019-09-01,"sbrb","transporte regular","voo internacional",0,0,0,0,0,0,0,0,0,0
"16847",2019-09-01,"sbrb","transporte não regular","voo doméstico",147,143,290,439,234,673,0,0,0,0
"16848",2019-09-01,"sbrb","transporte não regular","voo internacional",8,6,14,0,0,0,0,0,0,0
"16849",2019-09-01,"sbrj","transporte regular","voo doméstico",1581,1572,3153,145750,154886,300636,0,0,0,0
"16850",2019-09-01,"sbrj","transporte regular","voo internacional",0,0,0,0,0,0,0,0,0,0
"16851",2019-09-01,"sbrj","transporte não regular","voo doméstico",450,448,898,1035,683,1718,0,0,0,0
"16852",2019-09-01,"sbrj","transporte não regular","voo internacional",1,1,2,0,0,0,0,0,0,0
"16853",2019-09-01,"sbsj","transporte regular","voo doméstico",23,23,46,1161,1036,2197,0,0,0,0
"16854",2019-09-01,"sbsj","transporte regular","voo internacional",0,0,0,0,0,0,0,0,0,0
"16855",2019-09-01,"sbsj","transporte não regular","voo doméstico",351,343,694,999,1036,2035,0,0,0,0
"16856",2019-09-01,"sbsj","transporte não regular","voo internacional",3,15,18,85,5,90,0,0,0,0
"16857",2019-09-01,"sbsl","transporte regular","voo doméstico",478,478,956,64183,65248,129431,0,0,0,0
"16858",2019-09-01,"sbsl","transporte regular","voo internacional",0,0,0,0,0,0,0,0,0,0
"16859",2019-09-01,"sbsl","transporte não regular","voo doméstico",258,257,515,850,772,1622,0,0,0,0
"16860",2019-09-01,"sbsl","transporte não regular","voo internacional",2,1,3,0,5,5,0,0,0,0
"16861",2019-09-01,"sbsn","transporte regular","voo doméstico",227,227,454,23908,22404,46312,0,0,0,0
"16862",2019-09-01,"sbsn","transporte regular","voo internacional",0,0,0,0,0,0,0,0,0,0
"16863",2019-09-01,"sbsn","transporte não regular","voo doméstico",227,229,456,682,457,1139,2060,2400,4460,0
"16864",2019-09-01,"sbsn","transporte não regular","voo internacional",1,1,2,0,0,0,0,0,0,0
"16865",2019-09-01,"sbsp","transporte regular","voo doméstico",7113,7216,14329,911894,900424,1812318,0,0,0,0
"16866",2019-09-01,"sbsp","transporte regular","voo internacional",0,0,0,0,0,0,0,0,0,0
"16867",2019-09-01,"sbsp","transporte não regular","voo doméstico",2049,1919,3968,16743,21175,37918,0,0,0,0
"16868",2019-09-01,"sbsp","transporte não regular","voo internacional",3,3,6,0,0,0,0,0,0,0
"16869",2019-09-01,"sbte","transporte regular","voo doméstico",345,345,690,46373,45364,91737,0,0,0,0
"16870",2019-09-01,"sbte","transporte regular","voo internacional",0,0,0,0,0,0,0,0,0,0
"16871",2019-09-01,"sbte","transporte não regular","voo doméstico",176,175,351,924,938,1862,0,0,0,0
"16872",2019-09-01,"sbte","transporte não regular","voo internacional",0,0,0,0,0,0,0,0,0,0
"16873",2019-09-01,"sbtf","transporte regular","voo doméstico",27,27,54,1316,1391,2707,0,0,0,0
"16874",2019-09-01,"sbtf","transporte regular","voo internacional",0,0,0,0,0,0,0,0,0,0
"16875",2019-09-01,"sbtf","transporte não regular","voo doméstico",101,101,202,128,106,234,370,214,584,2300
"16876",2019-09-01,"sbtf","transporte não regular","voo internacional",0,0,0,0,0,0,0,0,0,0
"16877",2019-09-01,"sbtt","transporte regular","voo doméstico",30,30,60,2300,2467,4767,0,0,0,0
"16878",2019-09-01,"sbtt","transporte regular","voo internacional",0,0,0,0,0,0,0,0,0,0
"16879",2019-09-01,"sbtt","transporte não regular","voo doméstico",131,135,266,582,477,1059,835,1074,1909,0
"16880",2019-09-01,"sbtt","transporte não regular","voo internacional",0,0,0,0,0,0,0,0,0,0
"16881",2019-09-01,"sbuf","transporte regular","voo doméstico",9,9,18,518,486,1004,0,0,0,0
"16882",2019-09-01,"sbuf","transporte regular","voo internacional",0,0,0,0,0,0,0,0,0,0
"16883",2019-09-01,"sbuf","transporte não regular","voo doméstico",11,13,24,43,43,86,0,0,0,0
"16884",2019-09-01,"sbuf","transporte não regular","voo internacional",0,0,0,0,0,0,0,0,0,0
"16885",2019-09-01,"sbug","transporte regular","voo doméstico",16,16,32,908,950,1858,0,0,0,0
"16886",2019-09-01,"sbug","transporte regular","voo internacional",0,0,0,0,0,0,0,0,0,0
"16887",2019-09-01,"sbug","transporte não regular","voo doméstico",7,7,14,11,18,29,0,0,0,0
"16888",2019-09-01,"sbug","transporte não regular","voo internacional",0,0,0,0,0,0,0,0,0,0
"16889",2019-09-01,"sbul","transporte regular","voo doméstico",496,497,993,48317,46551,94868,0,0,0,0
"16890",2019-09-01,"sbul","transporte regular","voo internacional",0,0,0,0,0,0,0,0,0,0
"16891",2019-09-01,"sbul","transporte não regular","voo doméstico",494,497,991,1427,1065,2492,0,0,0,0
"16892",2019-09-01,"sbul","transporte não regular","voo internacional",0,0,0,0,0,0,0,0,0,0
"16893",2019-09-01,"sbur","transporte regular","voo doméstico",60,60,120,3124,3101,6225,0,0,0,0
"16894",2019-09-01,"sbur","transporte regular","voo internacional",0,0,0,0,0,0,0,0,0,0
"16895",2019-09-01,"sbur","transporte não regular","voo doméstico",153,152,305,531,537,1068,0,0,0,0
"16896",2019-09-01,"sbur","transporte não regular","voo internacional",0,0,0,0,0,0,0,0,0,0
"16897",2020-04-01,"sbbe","transporte regular","voo doméstico",123,122,245,6886,9083,15969,0,0,0,0
"16898",2020-04-01,"sbbe","transporte regular","voo internacional",0,0,0,0,0,0,0,0,0,0
"16899",2020-04-01,"sbbe","transporte não regular","voo doméstico",549,546,1095,1352,1211,2563,0,0,0,0
"16900",2020-04-01,"sbbe","transporte não regular","voo internacional",0,4,4,7,0,7,0,0,0,0
"16901",2020-04-01,"sbbg","transporte regular","voo doméstico",0,0,0,0,0,0,0,0,0,0
"16902",2020-04-01,"sbbg","transporte regular","voo internacional",0,0,0,0,0,0,0,0,0,0
"16903",2020-04-01,"sbbg","transporte não regular","voo doméstico",2,2,4,8,8,16,0,0,0,0
"16904",2020-04-01,"sbbg","transporte não regular","voo internacional",0,0,0,0,0,0,0,0,0,0
"16905",2020-04-01,"sbbh","transporte regular","voo doméstico",0,0,0,0,0,0,0,0,0,0
"16906",2020-04-01,"sbbh","transporte regular","voo internacional",0,0,0,0,0,0,0,0,0,0
"16907",2020-04-01,"sbbh","transporte não regular","voo doméstico",800,792,1592,4234,4277,8511,0,0,0,0
"16908",2020-04-01,"sbbh","transporte não regular","voo internacional",0,0,0,0,0,0,0,0,0,0
"16909",2020-04-01,"sbbi","transporte regular","voo doméstico",0,0,0,0,0,0,0,0,0,0
"16910",2020-04-01,"sbbi","transporte regular","voo internacional",0,0,0,0,0,0,0,0,0,0
"16911",2020-04-01,"sbbi","transporte não regular","voo doméstico",804,795,1599,631,524,1155,0,0,0,0
"16912",2020-04-01,"sbbi","transporte não regular","voo internacional",1,0,1,0,0,0,0,0,0,0
"16913",2020-04-01,"sbbv","transporte regular","voo doméstico",18,18,36,952,1105,2057,0,0,0,0
"16914",2020-04-01,"sbbv","transporte regular","voo internacional",0,0,0,0,0,0,0,0,0,0
"16915",2020-04-01,"sbbv","transporte não regular","voo doméstico",205,206,411,239,137,376,0,0,0,0
"16916",2020-04-01,"sbbv","transporte não regular","voo internacional",4,4,8,0,0,0,0,0,0,0
"16917",2020-04-01,"sbcg","transporte regular","voo doméstico",60,59,119,3829,3041,6870,33817,85420,119237,0
"16918",2020-04-01,"sbcg","transporte regular","voo internacional",0,0,0,0,0,0,0,0,0,0
"16919",2020-04-01,"sbcg","transporte não regular","voo doméstico",79,80,159,27,16,43,0,0,0,0
"16920",2020-04-01,"sbcg","transporte não regular","voo internacional",7,6,13,0,0,0,0,0,0,0
"16921",2020-04-01,"sbcj","transporte regular","voo doméstico",0,0,0,0,0,0,0,0,0,0
"16922",2020-04-01,"sbcj","transporte regular","voo internacional",0,0,0,0,0,0,0,0,0,0
"16923",2020-04-01,"sbcj","transporte não regular","voo doméstico",70,69,139,258,3,261,0,0,0,0
"16924",2020-04-01,"sbcj","transporte não regular","voo internacional",0,0,0,0,0,0,0,0,0,0
"16925",2020-04-01,"sbcr","transporte regular","voo doméstico",0,0,0,0,0,0,0,0,0,0
"16926",2020-04-01,"sbcr","transporte regular","voo internacional",0,0,0,0,0,0,0,0,0,0
"16927",2020-04-01,"sbcr","transporte não regular","voo doméstico",46,46,92,50,38,88,0,0,0,0
"16928",2020-04-01,"sbcr","transporte não regular","voo internacional",0,0,0,0,0,0,0,0,0,0
"16929",2020-04-01,"sbct","transporte regular","voo doméstico",141,135,276,10224,10916,21140,36692,15335,52027,44797
"16930",2020-04-01,"sbct","transporte regular","voo internacional",28,28,56,0,0,0,55408,24875,80283,0
"16931",2020-04-01,"sbct","transporte não regular","voo doméstico",64,68,132,110,57,167,0,0,0,0
"16932",2020-04-01,"sbct","transporte não regular","voo internacional",1,1,2,0,0,0,0,0,0,0
"16933",2020-04-01,"sbcz","transporte regular","voo doméstico",0,0,0,0,0,0,0,0,0,0
"16934",2020-04-01,"sbcz","transporte regular","voo internacional",0,0,0,0,0,0,0,0,0,0
"16935",2020-04-01,"sbcz","transporte não regular","voo doméstico",115,114,229,339,309,648,0,0,0,0
"16936",2020-04-01,"sbcz","transporte não regular","voo internacional",0,0,0,0,0,0,0,0,0,0
"16937",2020-04-01,"sbeg","transporte regular","voo doméstico",203,190,393,9330,7502,16832,88973,179769,268742,0
"16938",2020-04-01,"sbeg","transporte regular","voo internacional",33,43,76,0,0,0,0,0,0,0
"16939",2020-04-01,"sbeg","transporte não regular","voo doméstico",360,357,717,1678,47,1725,0,0,0,0
"16940",2020-04-01,"sbeg","transporte não regular","voo internacional",16,19,35,2,0,2,0,0,0,0
"16941",2020-04-01,"sbfi","transporte regular","voo doméstico",6,6,12,200,263,463,0,0,0,0
"16942",2020-04-01,"sbfi","transporte regular","voo internacional",0,0,0,0,0,0,0,0,0,0
"16943",2020-04-01,"sbfi","transporte não regular","voo doméstico",43,42,85,15,14,29,0,0,0,0
"16944",2020-04-01,"sbfi","transporte não regular","voo internacional",1,3,4,2,0,2,0,0,0,0
"16945",2020-04-01,"sbgo","transporte regular","voo doméstico",94,95,189,4185,4772,8957,82843,102190,185033,0
"16946",2020-04-01,"sbgo","transporte regular","voo internacional",0,0,0,0,0,0,0,0,0,0
"16947",2020-04-01,"sbgo","transporte não regular","voo doméstico",680,693,1373,2022,1964,3986,0,0,0,0
"16948",2020-04-01,"sbgo","transporte não regular","voo internacional",0,0,0,0,0,0,0,0,0,0
"16949",2020-04-01,"sbht","transporte regular","voo doméstico",15,15,30,0,0,0,0,0,0,0
"16950",2020-04-01,"sbht","transporte regular","voo internacional",0,0,0,0,0,0,0,0,0,0
"16951",2020-04-01,"sbht","transporte não regular","voo doméstico",115,113,228,108,124,232,0,0,0,0
"16952",2020-04-01,"sbht","transporte não regular","voo internacional",0,0,0,0,0,0,0,0,0,0
"16953",2020-04-01,"sbiz","transporte regular","voo doméstico",4,4,8,270,314,584,0,0,0,0
"16954",2020-04-01,"sbiz","transporte regular","voo internacional",0,0,0,0,0,0,0,0,0,0
"16955",2020-04-01,"sbiz","transporte não regular","voo doméstico",49,51,100,19,3,22,0,0,0,0
"16956",2020-04-01,"sbiz","transporte não regular","voo internacional",0,0,0,0,0,0,0,0,0,0
"16957",2020-04-01,"sbjc","transporte regular","voo doméstico",0,0,0,0,0,0,0,0,0,0
"16958",2020-04-01,"sbjc","transporte regular","voo internacional",0,0,0,0,0,0,0,0,0,0
"16959",2020-04-01,"sbjc","transporte não regular","voo doméstico",263,262,525,589,405,994,0,0,0,0
"16960",2020-04-01,"sbjc","transporte não regular","voo internacional",0,0,0,0,0,0,0,0,0,0
"16961",2020-04-01,"sbjr","transporte regular","voo doméstico",0,0,0,0,0,0,0,0,0,0
"16962",2020-04-01,"sbjr","transporte regular","voo internacional",0,0,0,0,0,0,0,0,0,0
"16963",2020-04-01,"sbjr","transporte não regular","voo doméstico",1371,1369,2740,6857,1909,8766,0,0,0,0
"16964",2020-04-01,"sbjr","transporte não regular","voo internacional",0,0,0,0,0,0,0,0,0,0
"16965",2020-04-01,"sbjv","transporte regular","voo doméstico",0,0,0,0,0,0,0,0,0,0
"16966",2020-04-01,"sbjv","transporte regular","voo internacional",0,0,0,0,0,0,0,0,0,0
"16967",2020-04-01,"sbjv","transporte não regular","voo doméstico",56,57,113,77,22,99,0,0,0,0
"16968",2020-04-01,"sbjv","transporte não regular","voo internacional",0,0,0,0,0,0,0,0,0,0
"16969",2020-04-01,"sblo","transporte regular","voo doméstico",0,0,0,0,0,0,0,0,0,0
"16970",2020-04-01,"sblo","transporte regular","voo internacional",0,0,0,0,0,0,0,0,0,0
"16971",2020-04-01,"sblo","transporte não regular","voo doméstico",289,285,574,49,14,63,0,0,0,0
"16972",2020-04-01,"sblo","transporte não regular","voo internacional",0,0,0,0,0,0,0,0,0,0
"16973",2020-04-01,"sbma","transporte regular","voo doméstico",5,5,10,390,461,851,0,0,0,0
"16974",2020-04-01,"sbma","transporte regular","voo internacional",0,0,0,0,0,0,0,0,0,0
"16975",2020-04-01,"sbma","transporte não regular","voo doméstico",109,111,220,104,107,211,0,0,0,0
"16976",2020-04-01,"sbma","transporte não regular","voo internacional",0,0,0,0,0,0,0,0,0,0
"16977",2020-04-01,"sbmk","transporte regular","voo doméstico",13,13,26,306,363,669,0,0,0,0
"16978",2020-04-01,"sbmk","transporte regular","voo internacional",0,0,0,0,0,0,0,0,0,0
"16979",2020-04-01,"sbmk","transporte não regular","voo doméstico",139,139,278,161,0,161,0,0,0,0
"16980",2020-04-01,"sbmk","transporte não regular","voo internacional",0,0,0,0,0,0,0,0,0,0
"16981",2020-04-01,"sbmq","transporte regular","voo doméstico",32,33,65,492,839,1331,0,0,0,0
"16982",2020-04-01,"sbmq","transporte regular","voo internacional",0,0,0,0,0,0,0,0,0,0
"16983",2020-04-01,"sbmq","transporte não regular","voo doméstico",217,215,432,644,438,1082,12000,30440,42440,0
"16984",2020-04-01,"sbmq","transporte não regular","voo internacional",1,1,2,0,0,0,0,0,0,0
"16985",2020-04-01,"sbmt","transporte regular","voo doméstico",0,0,0,0,0,0,0,0,0,0
"16986",2020-04-01,"sbmt","transporte regular","voo internacional",0,0,0,0,0,0,0,0,0,0
"16987",2020-04-01,"sbmt","transporte não regular","voo doméstico",997,993,1990,1701,1744,3445,0,0,0,0
"16988",2020-04-01,"sbmt","transporte não regular","voo internacional",0,0,0,0,0,0,0,0,0,0
"16989",2020-04-01,"sbnf","transporte regular","voo doméstico",3,3,6,159,120,279,0,0,0,0
"16990",2020-04-01,"sbnf","transporte regular","voo internacional",0,0,0,0,0,0,0,0,0,0
"16991",2020-04-01,"sbnf","transporte não regular","voo doméstico",142,141,283,141,79,220,0,0,0,0
"16992",2020-04-01,"sbnf","transporte não regular","voo internacional",0,0,0,0,0,0,0,0,0,0
"16993",2020-04-01,"sbpb","transporte regular","voo doméstico",0,0,0,0,0,0,0,0,0,0
"16994",2020-04-01,"sbpb","transporte regular","voo internacional",0,0,0,0,0,0,0,0,0,0
"16995",2020-04-01,"sbpb","transporte não regular","voo doméstico",24,24,48,47,41,88,0,0,0,0
"16996",2020-04-01,"sbpb","transporte não regular","voo internacional",0,0,0,0,0,0,0,0,0,0
"16997",2020-04-01,"sbpj","transporte regular","voo doméstico",26,26,52,1510,1735,3245,0,0,0,0
"16998",2020-04-01,"sbpj","transporte regular","voo internacional",0,0,0,0,0,0,0,0,0,0
"16999",2020-04-01,"sbpj","transporte não regular","voo doméstico",143,142,285,123,69,192,0,0,0,0
"17000",2020-04-01,"sbpj","transporte não regular","voo internacional",1,1,2,0,0,0,0,0,0,0
"17001",2020-04-01,"sbpk","transporte regular","voo doméstico",0,0,0,0,0,0,0,0,0,0
"17002",2020-04-01,"sbpk","transporte regular","voo internacional",0,0,0,0,0,0,0,0,0,0
"17003",2020-04-01,"sbpk","transporte não regular","voo doméstico",16,15,31,37,37,74,0,0,0,0
"17004",2020-04-01,"sbpk","transporte não regular","voo internacional",0,0,0,0,0,0,0,0,0,0
"17005",2020-04-01,"sbpl","transporte regular","voo doméstico",29,29,58,824,967,1791,0,0,0,0
"17006",2020-04-01,"sbpl","transporte regular","voo internacional",0,0,0,0,0,0,0,0,0,0
"17007",2020-04-01,"sbpl","transporte não regular","voo doméstico",55,56,111,25,10,35,0,0,0,0
"17008",2020-04-01,"sbpl","transporte não regular","voo internacional",0,0,0,0,0,0,0,0,0,0
"17009",2020-04-01,"sbpp","transporte regular","voo doméstico",0,0,0,0,0,0,0,0,0,0
"17010",2020-04-01,"sbpp","transporte regular","voo internacional",0,0,0,0,0,0,0,0,0,0
"17011",2020-04-01,"sbpp","transporte não regular","voo doméstico",46,44,90,67,68,135,0,0,0,0
"17012",2020-04-01,"sbpp","transporte não regular","voo internacional",0,0,0,0,0,0,0,0,0,0
"17013",2020-04-01,"sbpr","transporte regular","voo doméstico",0,0,0,0,0,0,0,0,0,0
"17014",2020-04-01,"sbpr","transporte regular","voo internacional",0,0,0,0,0,0,0,0,0,0
"17015",2020-04-01,"sbpr","transporte não regular","voo doméstico",273,290,563,464,376,840,0,0,0,0
"17016",2020-04-01,"sbpr","transporte não regular","voo internacional",0,0,0,0,0,0,0,0,0,0
"17017",2020-04-01,"sbpv","transporte regular","voo doméstico",36,36,72,2317,3233,5550,0,0,0,0
"17018",2020-04-01,"sbpv","transporte regular","voo internacional",0,0,0,0,0,0,0,0,0,0
"17019",2020-04-01,"sbpv","transporte não regular","voo doméstico",127,132,259,75,0,75,0,0,0,0
"17020",2020-04-01,"sbpv","transporte não regular","voo internacional",0,0,0,0,0,0,0,0,0,0
"17021",2020-04-01,"sbrb","transporte regular","voo doméstico",9,11,20,913,1104,2017,0,0,0,0
"17022",2020-04-01,"sbrb","transporte regular","voo internacional",0,0,0,0,0,0,0,0,0,0
"17023",2020-04-01,"sbrb","transporte não regular","voo doméstico",115,117,232,141,10,151,0,0,0,0
"17024",2020-04-01,"sbrb","transporte não regular","voo internacional",4,2,6,0,0,0,0,0,0,0
"17025",2020-04-01,"sbrj","transporte regular","voo doméstico",188,187,375,15724,14675,30399,0,0,0,0
"17026",2020-04-01,"sbrj","transporte regular","voo internacional",0,0,0,0,0,0,0,0,0,0
"17027",2020-04-01,"sbrj","transporte não regular","voo doméstico",143,139,282,333,315,648,0,0,0,0
"17028",2020-04-01,"sbrj","transporte não regular","voo internacional",0,0,0,0,0,0,0,0,0,0
"17029",2020-04-01,"sbsj","transporte regular","voo doméstico",0,0,0,0,0,0,0,0,0,0
"17030",2020-04-01,"sbsj","transporte regular","voo internacional",0,0,0,0,0,0,0,0,0,0
"17031",2020-04-01,"sbsj","transporte não regular","voo doméstico",110,105,215,260,285,545,0,0,0,0
"17032",2020-04-01,"sbsj","transporte não regular","voo internacional",2,1,3,2,3,5,0,0,0,0
"17033",2020-04-01,"sbsl","transporte regular","voo doméstico",65,65,130,4579,5874,10453,0,0,0,0
"17034",2020-04-01,"sbsl","transporte regular","voo internacional",0,0,0,0,0,0,0,0,0,0
"17035",2020-04-01,"sbsl","transporte não regular","voo doméstico",165,167,332,167,32,199,0,0,0,0
"17036",2020-04-01,"sbsl","transporte não regular","voo internacional",0,0,0,0,0,0,0,0,0,0
"17037",2020-04-01,"sbsn","transporte regular","voo doméstico",5,5,10,359,329,688,0,0,0,0
"17038",2020-04-01,"sbsn","transporte regular","voo internacional",0,0,0,0,0,0,0,0,0,0
"17039",2020-04-01,"sbsn","transporte não regular","voo doméstico",219,220,439,122,4,126,0,0,0,0
"17040",2020-04-01,"sbsn","transporte não regular","voo internacional",0,0,0,0,0,0,0,0,0,0
"17041",2020-04-01,"sbsp","transporte regular","voo doméstico",59,46,105,1750,2419,4169,0,0,0,0
"17042",2020-04-01,"sbsp","transporte regular","voo internacional",0,0,0,0,0,0,0,0,0,0
"17043",2020-04-01,"sbsp","transporte não regular","voo doméstico",810,805,1615,1416,1459,2875,0,0,0,0
"17044",2020-04-01,"sbsp","transporte não regular","voo internacional",1,1,2,0,0,0,0,0,0,0
"17045",2020-04-01,"sbte","transporte regular","voo doméstico",22,23,45,2099,2437,4536,0,0,0,0
"17046",2020-04-01,"sbte","transporte regular","voo internacional",0,0,0,0,0,0,0,0,0,0
"17047",2020-04-01,"sbte","transporte não regular","voo doméstico",94,96,190,483,595,1078,0,0,0,0
"17048",2020-04-01,"sbte","transporte não regular","voo internacional",0,0,0,0,0,0,0,0,0,0
"17049",2020-04-01,"sbtf","transporte regular","voo doméstico",9,9,18,243,548,791,0,0,0,0
"17050",2020-04-01,"sbtf","transporte regular","voo internacional",0,0,0,0,0,0,0,0,0,0
"17051",2020-04-01,"sbtf","transporte não regular","voo doméstico",105,106,211,82,51,133,680,0,680,1870
"17052",2020-04-01,"sbtf","transporte não regular","voo internacional",0,0,0,0,0,0,0,0,0,0
"17053",2020-04-01,"sbtt","transporte regular","voo doméstico",9,9,18,238,700,938,0,0,0,0
"17054",2020-04-01,"sbtt","transporte regular","voo internacional",0,0,0,0,0,0,0,0,0,0
"17055",2020-04-01,"sbtt","transporte não regular","voo doméstico",63,64,127,311,257,568,0,0,0,0
"17056",2020-04-01,"sbtt","transporte não regular","voo internacional",0,0,0,0,0,0,0,0,0,0
"17057",2020-04-01,"sbuf","transporte regular","voo doméstico",0,0,0,0,0,0,0,0,0,0
"17058",2020-04-01,"sbuf","transporte regular","voo internacional",0,0,0,0,0,0,0,0,0,0
"17059",2020-04-01,"sbuf","transporte não regular","voo doméstico",23,24,47,22,12,34,0,0,0,0
"17060",2020-04-01,"sbuf","transporte não regular","voo internacional",0,0,0,0,0,0,0,0,0,0
"17061",2020-04-01,"sbug","transporte regular","voo doméstico",0,0,0,0,0,0,0,0,0,0
"17062",2020-04-01,"sbug","transporte regular","voo internacional",0,0,0,0,0,0,0,0,0,0
"17063",2020-04-01,"sbug","transporte não regular","voo doméstico",3,3,6,11,7,18,0,0,0,0
"17064",2020-04-01,"sbug","transporte não regular","voo internacional",0,0,0,0,0,0,0,0,0,0
"17065",2020-04-01,"sbul","transporte regular","voo doméstico",15,15,30,578,710,1288,0,0,0,0
"17066",2020-04-01,"sbul","transporte regular","voo internacional",0,0,0,0,0,0,0,0,0,0
"17067",2020-04-01,"sbul","transporte não regular","voo doméstico",217,223,440,394,391,785,0,0,0,0
"17068",2020-04-01,"sbul","transporte não regular","voo internacional",0,0,0,0,0,0,0,0,0,0
"17069",2020-04-01,"sbur","transporte regular","voo doméstico",0,0,0,0,0,0,0,0,0,0
"17070",2020-04-01,"sbur","transporte regular","voo internacional",0,0,0,0,0,0,0,0,0,0
"17071",2020-04-01,"sbur","transporte não regular","voo doméstico",101,99,200,308,299,607,0,0,0,0
"17072",2020-04-01,"sbur","transporte não regular","voo internacional",0,0,0,0,0,0,0,0,0,0
"17073",2020-02-01,"sbbe","transporte regular","voo doméstico",1005,1005,2010,137523,128580,266103,0,0,0,0
"17074",2020-02-01,"sbbe","transporte regular","voo internacional",56,56,112,5942,5734,11676,0,25,25,0
"17075",2020-02-01,"sbbe","transporte não regular","voo doméstico",349,350,699,528,753,1281,0,0,0,0
"17076",2020-02-01,"sbbe","transporte não regular","voo internacional",5,1,6,0,10,10,0,0,0,0
"17077",2020-02-01,"sbbg","transporte regular","voo doméstico",20,23,43,98,96,194,0,0,0,0
"17078",2020-02-01,"sbbg","transporte regular","voo internacional",0,0,0,0,0,0,0,0,0,0
"17079",2020-02-01,"sbbg","transporte não regular","voo doméstico",16,12,28,46,71,117,0,0,0,0
"17080",2020-02-01,"sbbg","transporte não regular","voo internacional",2,3,5,8,5,13,0,0,0,0
"17081",2020-02-01,"sbbh","transporte regular","voo doméstico",0,0,0,0,0,0,0,0,0,0
"17082",2020-02-01,"sbbh","transporte regular","voo internacional",0,0,0,0,0,0,0,0,0,0
"17083",2020-02-01,"sbbh","transporte não regular","voo doméstico",1217,1207,2424,6433,6455,12888,0,0,0,0
"17084",2020-02-01,"sbbh","transporte não regular","voo internacional",1,1,2,0,0,0,0,0,0,0
"17085",2020-02-01,"sbbi","transporte regular","voo doméstico",0,0,0,0,0,0,0,0,0,0
"17086",2020-02-01,"sbbi","transporte regular","voo internacional",0,0,0,0,0,0,0,0,0,0
"17087",2020-02-01,"sbbi","transporte não regular","voo doméstico",871,854,1725,804,730,1534,0,0,0,0
"17088",2020-02-01,"sbbi","transporte não regular","voo internacional",1,1,2,0,0,0,0,0,0,0
"17089",2020-02-01,"sbbv","transporte regular","voo doméstico",93,93,186,15420,13256,28676,0,0,0,0
"17090",2020-02-01,"sbbv","transporte regular","voo internacional",0,0,0,0,0,0,0,0,0,0
"17091",2020-02-01,"sbbv","transporte não regular","voo doméstico",214,209,423,329,131,460,0,0,0,0
"17092",2020-02-01,"sbbv","transporte não regular","voo internacional",5,8,13,14,0,14,0,0,0,0
"17093",2020-02-01,"sbcg","transporte regular","voo doméstico",483,481,964,53403,55081,108484,0,0,0,0
"17094",2020-02-01,"sbcg","transporte regular","voo internacional",0,0,0,0,0,0,0,0,0,0
"17095",2020-02-01,"sbcg","transporte não regular","voo doméstico",120,124,244,276,98,374,0,0,0,0
"17096",2020-02-01,"sbcg","transporte não regular","voo internacional",6,4,10,0,0,0,0,0,0,0
"17097",2020-02-01,"sbcj","transporte regular","voo doméstico",51,51,102,5314,4750,10064,0,0,0,0
"17098",2020-02-01,"sbcj","transporte regular","voo internacional",0,0,0,0,0,0,0,0,0,0
"17099",2020-02-01,"sbcj","transporte não regular","voo doméstico",98,99,197,1073,13,1086,0,0,0,0
"17100",2020-02-01,"sbcj","transporte não regular","voo internacional",0,0,0,0,0,0,0,0,0,0
"17101",2020-02-01,"sbcr","transporte regular","voo doméstico",20,20,40,773,1486,2259,0,0,0,0
"17102",2020-02-01,"sbcr","transporte regular","voo internacional",0,0,0,0,0,0,0,0,0,0
"17103",2020-02-01,"sbcr","transporte não regular","voo doméstico",28,28,56,68,65,133,0,0,0,0
"17104",2020-02-01,"sbcr","transporte não regular","voo internacional",2,3,5,5,0,5,0,0,0,0
"17105",2020-02-01,"sbct","transporte regular","voo doméstico",2267,2271,4538,239122,239608,478730,114688,43363,158051,72114
"17106",2020-02-01,"sbct","transporte regular","voo internacional",72,72,144,2843,2548,5391,8508,4594,13102,0
"17107",2020-02-01,"sbct","transporte não regular","voo doméstico",269,265,534,730,1401,2131,0,0,0,0
"17108",2020-02-01,"sbct","transporte não regular","voo internacional",15,19,34,66,44,110,0,0,0,0
"17109",2020-02-01,"sbcz","transporte regular","voo doméstico",29,29,58,2211,1255,3466,0,0,0,0
"17110",2020-02-01,"sbcz","transporte regular","voo internacional",0,0,0,0,0,0,0,0,0,0
"17111",2020-02-01,"sbcz","transporte não regular","voo doméstico",147,145,292,577,651,1228,0,0,0,0
"17112",2020-02-01,"sbcz","transporte não regular","voo internacional",3,2,5,0,0,0,0,0,0,0
"17113",2020-02-01,"sbeg","transporte regular","voo doméstico",1018,1007,2025,118603,117069,235672,0,0,0,0
"17114",2020-02-01,"sbeg","transporte regular","voo internacional",88,95,183,4397,4799,9196,0,0,0,0
"17115",2020-02-01,"sbeg","transporte não regular","voo doméstico",430,430,860,2566,772,3338,0,0,0,0
"17116",2020-02-01,"sbeg","transporte não regular","voo internacional",76,74,150,40,56,96,0,0,0,0
"17117",2020-02-01,"sbfi","transporte regular","voo doméstico",670,671,1341,96050,97067,193117,0,0,0,0
"17118",2020-02-01,"sbfi","transporte regular","voo internacional",49,49,98,1685,2024,3709,0,0,0,0
"17119",2020-02-01,"sbfi","transporte não regular","voo doméstico",117,118,235,262,647,909,0,0,0,0
"17120",2020-02-01,"sbfi","transporte não regular","voo internacional",42,41,83,72,86,158,0,0,0,0
"17121",2020-02-01,"sbgo","transporte regular","voo doméstico",1037,1040,2077,113639,110045,223684,99708,163290,262998,0
"17122",2020-02-01,"sbgo","transporte regular","voo internacional",0,0,0,0,0,0,0,0,0,0
"17123",2020-02-01,"sbgo","transporte não regular","voo doméstico",798,794,1592,2963,2478,5441,0,0,0,0
"17124",2020-02-01,"sbgo","transporte não regular","voo internacional",1,1,2,0,0,0,0,0,0,0
"17125",2020-02-01,"sbht","transporte regular","voo doméstico",46,46,92,3058,2855,5913,0,0,0,0
"17126",2020-02-01,"sbht","transporte regular","voo internacional",0,0,0,0,0,0,0,0,0,0
"17127",2020-02-01,"sbht","transporte não regular","voo doméstico",92,91,183,130,195,325,0,0,0,0
"17128",2020-02-01,"sbht","transporte não regular","voo internacional",0,0,0,0,0,0,0,0,0,0
"17129",2020-02-01,"sbiz","transporte regular","voo doméstico",111,111,222,14174,12831,27005,0,0,0,0
"17130",2020-02-01,"sbiz","transporte regular","voo internacional",0,0,0,0,0,0,0,0,0,0
"17131",2020-02-01,"sbiz","transporte não regular","voo doméstico",76,75,151,10,0,10,0,0,0,0
"17132",2020-02-01,"sbiz","transporte não regular","voo internacional",0,0,0,0,0,0,0,0,0,0
"17133",2020-02-01,"sbjc","transporte regular","voo doméstico",0,0,0,0,0,0,0,0,0,0
"17134",2020-02-01,"sbjc","transporte regular","voo internacional",0,0,0,0,0,0,0,0,0,0
"17135",2020-02-01,"sbjc","transporte não regular","voo doméstico",219,218,437,505,225,730,0,0,0,0
"17136",2020-02-01,"sbjc","transporte não regular","voo internacional",0,0,0,0,0,0,0,0,0,0
"17137",2020-02-01,"sbjr","transporte regular","voo doméstico",45,50,95,118,107,225,0,0,0,0
"17138",2020-02-01,"sbjr","transporte regular","voo internacional",0,0,0,0,0,0,0,0,0,0
"17139",2020-02-01,"sbjr","transporte não regular","voo doméstico",2401,2389,4790,11434,4841,16275,0,0,0,0
"17140",2020-02-01,"sbjr","transporte não regular","voo internacional",1,1,2,1,0,1,0,0,0,0
"17141",2020-02-01,"sbjv","transporte regular","voo doméstico",188,194,382,18751,17630,36381,0,0,0,0
"17142",2020-02-01,"sbjv","transporte regular","voo internacional",0,0,0,0,0,0,0,0,0,0
"17143",2020-02-01,"sbjv","transporte não regular","voo doméstico",64,59,123,58,38,96,0,0,0,0
"17144",2020-02-01,"sbjv","transporte não regular","voo internacional",0,0,0,0,0,0,0,0,0,0
"17145",2020-02-01,"sblo","transporte regular","voo doméstico",342,342,684,31124,34900,66024,0,0,0,0
"17146",2020-02-01,"sblo","transporte regular","voo internacional",0,0,0,0,0,0,0,0,0,0
"17147",2020-02-01,"sblo","transporte não regular","voo doméstico",397,393,790,98,177,275,0,0,0,0
"17148",2020-02-01,"sblo","transporte não regular","voo internacional",6,6,12,0,0,0,0,0,0,0
"17149",2020-02-01,"sbma","transporte regular","voo doméstico",106,105,211,12239,10688,22927,0,0,0,0
"17150",2020-02-01,"sbma","transporte regular","voo internacional",0,0,0,0,0,0,0,0,0,0
"17151",2020-02-01,"sbma","transporte não regular","voo doméstico",91,93,184,213,244,457,0,0,0,0
"17152",2020-02-01,"sbma","transporte não regular","voo internacional",0,0,0,0,0,0,0,0,0,0
"17153",2020-02-01,"sbmk","transporte regular","voo doméstico",125,125,250,8417,8449,16866,0,0,0,0
"17154",2020-02-01,"sbmk","transporte regular","voo internacional",0,0,0,0,0,0,0,0,0,0
"17155",2020-02-01,"sbmk","transporte não regular","voo doméstico",150,151,301,354,105,459,0,0,0,0
"17156",2020-02-01,"sbmk","transporte não regular","voo internacional",0,0,0,0,0,0,0,0,0,0
"17157",2020-02-01,"sbmq","transporte regular","voo doméstico",170,169,339,25554,24290,49844,0,0,0,0
"17158",2020-02-01,"sbmq","transporte regular","voo internacional",0,0,0,0,0,0,0,0,0,0
"17159",2020-02-01,"sbmq","transporte não regular","voo doméstico",107,108,215,371,110,481,11230,28763,39993,0
"17160",2020-02-01,"sbmq","transporte não regular","voo internacional",3,3,6,0,0,0,0,0,0,0
"17161",2020-02-01,"sbmt","transporte regular","voo doméstico",0,0,0,0,0,0,0,0,0,0
"17162",2020-02-01,"sbmt","transporte regular","voo internacional",0,0,0,0,0,0,0,0,0,0
"17163",2020-02-01,"sbmt","transporte não regular","voo doméstico",1839,1841,3680,2596,2767,5363,0,0,0,0
"17164",2020-02-01,"sbmt","transporte não regular","voo internacional",0,0,0,0,0,0,0,0,0,0
"17165",2020-02-01,"sbnf","transporte regular","voo doméstico",609,610,1219,73003,67926,140929,0,0,0,0
"17166",2020-02-01,"sbnf","transporte regular","voo internacional",0,0,0,0,0,0,0,0,0,0
"17167",2020-02-01,"sbnf","transporte não regular","voo doméstico",304,314,618,501,1063,1564,0,0,0,0
"17168",2020-02-01,"sbnf","transporte não regular","voo internacional",3,2,5,0,0,0,0,0,0,0
"17169",2020-02-01,"sbpb","transporte regular","voo doméstico",5,5,10,367,563,930,0,0,0,0
"17170",2020-02-01,"sbpb","transporte regular","voo internacional",0,0,0,0,0,0,0,0,0,0
"17171",2020-02-01,"sbpb","transporte não regular","voo doméstico",41,40,81,85,83,168,0,0,0,0
"17172",2020-02-01,"sbpb","transporte não regular","voo internacional",0,0,0,0,0,0,0,0,0,0
"17173",2020-02-01,"sbpj","transporte regular","voo doméstico",175,175,350,19845,18765,38610,0,0,0,0
"17174",2020-02-01,"sbpj","transporte regular","voo internacional",0,0,0,0,0,0,0,0,0,0
"17175",2020-02-01,"sbpj","transporte não regular","voo doméstico",148,149,297,268,151,419,0,0,0,0
"17176",2020-02-01,"sbpj","transporte não regular","voo internacional",0,0,0,0,0,0,0,0,0,0
"17177",2020-02-01,"sbpk","transporte regular","voo doméstico",26,26,52,1335,1410,2745,0,0,0,0
"17178",2020-02-01,"sbpk","transporte regular","voo internacional",0,0,0,0,0,0,0,0,0,0
"17179",2020-02-01,"sbpk","transporte não regular","voo doméstico",30,31,61,104,80,184,0,0,0,0
"17180",2020-02-01,"sbpk","transporte não regular","voo internacional",9,9,18,0,13,13,0,0,0,0
"17181",2020-02-01,"sbpl","transporte regular","voo doméstico",157,157,314,16309,15094,31403,0,0,0,0
"17182",2020-02-01,"sbpl","transporte regular","voo internacional",3,3,6,0,0,0,0,0,0,0
"17183",2020-02-01,"sbpl","transporte não regular","voo doméstico",94,95,189,237,290,527,0,0,0,0
"17184",2020-02-01,"sbpl","transporte não regular","voo internacional",0,0,0,0,0,0,0,0,0,0
"17185",2020-02-01,"sbpp","transporte regular","voo doméstico",0,0,0,0,0,0,0,0,0,0
"17186",2020-02-01,"sbpp","transporte regular","voo internacional",0,0,0,0,0,0,0,0,0,0
"17187",2020-02-01,"sbpp","transporte não regular","voo doméstico",88,89,177,155,174,329,0,0,0,0
"17188",2020-02-01,"sbpp","transporte não regular","voo internacional",6,6,12,12,14,26,0,0,0,0
"17189",2020-02-01,"sbpr","transporte regular","voo doméstico",0,0,0,0,0,0,0,0,0,0
"17190",2020-02-01,"sbpr","transporte regular","voo internacional",0,0,0,0,0,0,0,0,0,0
"17191",2020-02-01,"sbpr","transporte não regular","voo doméstico",494,494,988,723,686,1409,0,0,0,0
"17192",2020-02-01,"sbpr","transporte não regular","voo internacional",0,0,0,0,0,0,0,0,0,0
"17193",2020-02-01,"sbpv","transporte regular","voo doméstico",220,218,438,27437,30191,57628,0,0,0,0
"17194",2020-02-01,"sbpv","transporte regular","voo internacional",0,0,0,0,0,0,0,0,0,0
"17195",2020-02-01,"sbpv","transporte não regular","voo doméstico",143,146,289,69,189,258,0,0,0,0
"17196",2020-02-01,"sbpv","transporte não regular","voo internacional",0,0,0,0,0,0,0,0,0,0
"17197",2020-02-01,"sbrb","transporte regular","voo doméstico",144,143,287,13768,15151,28919,0,0,0,0
"17198",2020-02-01,"sbrb","transporte regular","voo internacional",0,0,0,0,0,0,0,0,0,0
"17199",2020-02-01,"sbrb","transporte não regular","voo doméstico",124,125,249,538,273,811,0,0,0,0
"17200",2020-02-01,"sbrb","transporte não regular","voo internacional",0,0,0,0,0,0,0,0,0,0
"17201",2020-02-01,"sbrj","transporte regular","voo doméstico",3957,3985,7942,436292,427913,864205,0,0,0,0
"17202",2020-02-01,"sbrj","transporte regular","voo internacional",0,0,0,0,0,0,0,0,0,0
"17203",2020-02-01,"sbrj","transporte não regular","voo doméstico",503,448,951,1584,628,2212,0,0,0,0
"17204",2020-02-01,"sbrj","transporte não regular","voo internacional",1,1,2,0,0,0,0,0,0,0
"17205",2020-02-01,"sbsj","transporte regular","voo doméstico",27,26,53,1343,1460,2803,0,0,0,0
"17206",2020-02-01,"sbsj","transporte regular","voo internacional",0,0,0,0,0,0,0,0,0,0
"17207",2020-02-01,"sbsj","transporte não regular","voo doméstico",335,337,672,942,1009,1951,0,0,0,0
"17208",2020-02-01,"sbsj","transporte não regular","voo internacional",0,3,3,8,0,8,0,0,0,0
"17209",2020-02-01,"sbsl","transporte regular","voo doméstico",460,459,919,64747,61896,126643,0,0,0,0
"17210",2020-02-01,"sbsl","transporte regular","voo internacional",0,0,0,0,0,0,0,0,0,0
"17211",2020-02-01,"sbsl","transporte não regular","voo doméstico",153,152,305,396,289,685,0,0,0,0
"17212",2020-02-01,"sbsl","transporte não regular","voo internacional",2,1,3,0,0,0,0,0,0,0
"17213",2020-02-01,"sbsn","transporte regular","voo doméstico",177,179,356,20536,19762,40298,0,0,0,0
"17214",2020-02-01,"sbsn","transporte regular","voo internacional",0,0,0,0,0,0,0,0,0,0
"17215",2020-02-01,"sbsn","transporte não regular","voo doméstico",238,240,478,287,220,507,0,0,0,0
"17216",2020-02-01,"sbsn","transporte não regular","voo internacional",0,0,0,0,0,0,0,0,0,0
"17217",2020-02-01,"sbsp","transporte regular","voo doméstico",6672,6788,13460,795201,769014,1564215,0,0,0,0
"17218",2020-02-01,"sbsp","transporte regular","voo internacional",0,0,0,0,0,0,0,0,0,0
"17219",2020-02-01,"sbsp","transporte não regular","voo doméstico",1934,1804,3738,29057,31291,60348,0,0,0,0
"17220",2020-02-01,"sbsp","transporte não regular","voo internacional",4,3,7,0,0,0,0,0,0,0
"17221",2020-02-01,"sbte","transporte regular","voo doméstico",326,326,652,47460,41776,89236,0,0,0,0
"17222",2020-02-01,"sbte","transporte regular","voo internacional",0,0,0,0,0,0,0,0,0,0
"17223",2020-02-01,"sbte","transporte não regular","voo doméstico",126,131,257,668,660,1328,0,0,0,0
"17224",2020-02-01,"sbte","transporte não regular","voo internacional",0,0,0,0,0,0,0,0,0,0
"17225",2020-02-01,"sbtf","transporte regular","voo doméstico",34,34,68,1144,1457,2601,0,0,0,0
"17226",2020-02-01,"sbtf","transporte regular","voo internacional",0,0,0,0,0,0,0,0,0,0
"17227",2020-02-01,"sbtf","transporte não regular","voo doméstico",84,85,169,136,114,250,645,0,645,1620
"17228",2020-02-01,"sbtf","transporte não regular","voo internacional",0,0,0,0,0,0,0,0,0,0
"17229",2020-02-01,"sbtt","transporte regular","voo doméstico",24,24,48,2335,2673,5008,0,0,0,0
"17230",2020-02-01,"sbtt","transporte regular","voo internacional",0,0,0,0,0,0,0,0,0,0
"17231",2020-02-01,"sbtt","transporte não regular","voo doméstico",71,71,142,343,338,681,0,0,0,0
"17232",2020-02-01,"sbtt","transporte não regular","voo internacional",0,0,0,0,0,0,0,0,0,0
"17233",2020-02-01,"sbuf","transporte regular","voo doméstico",12,12,24,501,423,924,0,0,0,0
"17234",2020-02-01,"sbuf","transporte regular","voo internacional",0,0,0,0,0,0,0,0,0,0
"17235",2020-02-01,"sbuf","transporte não regular","voo doméstico",14,15,29,16,227,243,0,0,0,0
"17236",2020-02-01,"sbuf","transporte não regular","voo internacional",0,0,0,0,0,0,0,0,0,0
"17237",2020-02-01,"sbug","transporte regular","voo doméstico",16,16,32,818,803,1621,0,0,0,0
"17238",2020-02-01,"sbug","transporte regular","voo internacional",0,0,0,0,0,0,0,0,0,0
"17239",2020-02-01,"sbug","transporte não regular","voo doméstico",6,6,12,14,10,24,0,0,0,0
"17240",2020-02-01,"sbug","transporte não regular","voo internacional",0,0,0,0,0,0,0,0,0,0
"17241",2020-02-01,"sbul","transporte regular","voo doméstico",422,420,842,37792,38688,76480,0,0,0,0
"17242",2020-02-01,"sbul","transporte regular","voo internacional",0,0,0,0,0,0,0,0,0,0
"17243",2020-02-01,"sbul","transporte não regular","voo doméstico",408,408,816,1058,866,1924,0,0,0,0
"17244",2020-02-01,"sbul","transporte não regular","voo internacional",0,0,0,0,0,0,0,0,0,0
"17245",2020-02-01,"sbur","transporte regular","voo doméstico",73,74,147,2290,2496,4786,0,0,0,0
"17246",2020-02-01,"sbur","transporte regular","voo internacional",0,0,0,0,0,0,0,0,0,0
"17247",2020-02-01,"sbur","transporte não regular","voo doméstico",125,122,247,462,494,956,0,0,0,0
"17248",2020-02-01,"sbur","transporte não regular","voo internacional",0,0,0,0,0,0,0,0,0,0
"17249",2020-01-01,"sbbe","transporte regular","voo doméstico",1200,1203,2403,161240,159614,320854,0,0,0,0
"17250",2020-01-01,"sbbe","transporte regular","voo internacional",63,64,127,7351,7005,14356,0,19,19,0
"17251",2020-01-01,"sbbe","transporte não regular","voo doméstico",385,387,772,727,984,1711,0,0,0,0
"17252",2020-01-01,"sbbe","transporte não regular","voo internacional",7,6,13,2,12,14,0,0,0,0
"17253",2020-01-01,"sbbg","transporte regular","voo doméstico",26,27,53,133,117,250,0,0,0,0
"17254",2020-01-01,"sbbg","transporte regular","voo internacional",0,0,0,0,0,0,0,0,0,0
"17255",2020-01-01,"sbbg","transporte não regular","voo doméstico",18,20,38,68,81,149,0,0,0,0
"17256",2020-01-01,"sbbg","transporte não regular","voo internacional",8,5,13,12,15,27,0,0,0,0
"17257",2020-01-01,"sbbh","transporte regular","voo doméstico",0,0,0,0,0,0,0,0,0,0
"17258",2020-01-01,"sbbh","transporte regular","voo internacional",0,0,0,0,0,0,0,0,0,0
"17259",2020-01-01,"sbbh","transporte não regular","voo doméstico",1144,1118,2262,5934,6068,12002,0,0,0,0
"17260",2020-01-01,"sbbh","transporte não regular","voo internacional",0,0,0,0,0,0,0,0,0,0
"17261",2020-01-01,"sbbi","transporte regular","voo doméstico",0,0,0,0,0,0,0,0,0,0
"17262",2020-01-01,"sbbi","transporte regular","voo internacional",0,0,0,0,0,0,0,0,0,0
"17263",2020-01-01,"sbbi","transporte não regular","voo doméstico",996,1002,1998,871,827,1698,0,0,0,0
"17264",2020-01-01,"sbbi","transporte não regular","voo internacional",0,0,0,0,0,0,0,0,0,0
"17265",2020-01-01,"sbbv","transporte regular","voo doméstico",100,101,201,16336,15573,31909,0,0,0,0
"17266",2020-01-01,"sbbv","transporte regular","voo internacional",0,0,0,0,0,0,0,0,0,0
"17267",2020-01-01,"sbbv","transporte não regular","voo doméstico",257,257,514,494,427,921,0,0,0,0
"17268",2020-01-01,"sbbv","transporte não regular","voo internacional",12,13,25,22,5,27,0,0,0,0
"17269",2020-01-01,"sbcg","transporte regular","voo doméstico",546,546,1092,65712,69637,135349,54165,90384,144549,0
"17270",2020-01-01,"sbcg","transporte regular","voo internacional",0,0,0,0,0,0,0,0,0,0
"17271",2020-01-01,"sbcg","transporte não regular","voo doméstico",102,106,208,167,245,412,0,274,274,0
"17272",2020-01-01,"sbcg","transporte não regular","voo internacional",16,10,26,0,5,5,0,0,0,0
"17273",2020-01-01,"sbcj","transporte regular","voo doméstico",62,62,124,5962,6876,12838,0,0,0,0
"17274",2020-01-01,"sbcj","transporte regular","voo internacional",0,0,0,0,0,0,0,0,0,0
"17275",2020-01-01,"sbcj","transporte não regular","voo doméstico",98,97,195,587,150,737,0,0,0,0
"17276",2020-01-01,"sbcj","transporte não regular","voo internacional",0,0,0,0,0,0,0,0,0,0
"17277",2020-01-01,"sbcr","transporte regular","voo doméstico",21,21,42,888,1490,2378,0,0,0,0
"17278",2020-01-01,"sbcr","transporte regular","voo internacional",0,0,0,0,0,0,0,0,0,0
"17279",2020-01-01,"sbcr","transporte não regular","voo doméstico",27,27,54,60,45,105,0,0,0,0
"17280",2020-01-01,"sbcr","transporte não regular","voo internacional",5,4,9,8,13,21,0,0,0,0
"17281",2020-01-01,"sbct","transporte regular","voo doméstico",2572,2578,5150,279697,279793,559490,161549,59500,221049,106792
"17282",2020-01-01,"sbct","transporte regular","voo internacional",66,66,132,3215,4085,7300,40032,20632,60664,0
"17283",2020-01-01,"sbct","transporte não regular","voo doméstico",225,215,440,582,1096,1678,0,0,0,0
"17284",2020-01-01,"sbct","transporte não regular","voo internacional",12,11,23,47,52,99,0,0,0,0
"17285",2020-01-01,"sbcz","transporte regular","voo doméstico",30,30,60,2750,1042,3792,0,0,0,0
"17286",2020-01-01,"sbcz","transporte regular","voo internacional",0,0,0,0,0,0,0,0,0,0
"17287",2020-01-01,"sbcz","transporte não regular","voo doméstico",149,150,299,607,562,1169,0,0,0,0
"17288",2020-01-01,"sbcz","transporte não regular","voo internacional",0,0,0,0,0,0,0,0,0,0
"17289",2020-01-01,"sbeg","transporte regular","voo doméstico",1177,1174,2351,145247,148655,293902,129835,238444,368279,0
"17290",2020-01-01,"sbeg","transporte regular","voo internacional",110,114,224,6080,5733,11813,0,0,0,0
"17291",2020-01-01,"sbeg","transporte não regular","voo doméstico",489,504,993,5055,3008,8063,0,0,0,0
"17292",2020-01-01,"sbeg","transporte não regular","voo internacional",78,66,144,24,1,25,0,0,0,0
"17293",2020-01-01,"sbfi","transporte regular","voo doméstico",833,830,1663,125553,111482,237035,0,0,0,0
"17294",2020-01-01,"sbfi","transporte regular","voo internacional",53,53,106,3308,2875,6183,0,0,0,0
"17295",2020-01-01,"sbfi","transporte não regular","voo doméstico",112,108,220,370,457,827,0,0,0,0
"17296",2020-01-01,"sbfi","transporte não regular","voo internacional",23,25,48,31,54,85,0,0,0,0
"17297",2020-01-01,"sbgo","transporte regular","voo doméstico",1250,1250,2500,135957,148933,284890,98671,160970,259641,0
"17298",2020-01-01,"sbgo","transporte regular","voo internacional",0,0,0,0,0,0,0,0,0,0
"17299",2020-01-01,"sbgo","transporte não regular","voo doméstico",756,726,1482,3021,3138,6159,0,0,0,0
"17300",2020-01-01,"sbgo","transporte não regular","voo internacional",0,0,0,0,0,0,0,0,0,0
"17301",2020-01-01,"sbht","transporte regular","voo doméstico",91,91,182,4387,4377,8764,0,0,0,0
"17302",2020-01-01,"sbht","transporte regular","voo internacional",0,0,0,0,0,0,0,0,0,0
"17303",2020-01-01,"sbht","transporte não regular","voo doméstico",50,48,98,58,60,118,0,0,0,0
"17304",2020-01-01,"sbht","transporte não regular","voo internacional",0,0,0,0,0,0,0,0,0,0
"17305",2020-01-01,"sbiz","transporte regular","voo doméstico",114,114,228,15694,14841,30535,0,0,0,0
"17306",2020-01-01,"sbiz","transporte regular","voo internacional",0,0,0,0,0,0,0,0,0,0
"17307",2020-01-01,"sbiz","transporte não regular","voo doméstico",95,99,194,37,62,99,0,0,0,0
"17308",2020-01-01,"sbiz","transporte não regular","voo internacional",0,0,0,0,0,0,0,0,0,0
"17309",2020-01-01,"sbjc","transporte regular","voo doméstico",0,0,0,0,0,0,0,0,0,0
"17310",2020-01-01,"sbjc","transporte regular","voo internacional",0,0,0,0,0,0,0,0,0,0
"17311",2020-01-01,"sbjc","transporte não regular","voo doméstico",217,233,450,504,329,833,0,0,0,0
"17312",2020-01-01,"sbjc","transporte não regular","voo internacional",0,0,0,0,0,0,0,0,0,0
"17313",2020-01-01,"sbjr","transporte regular","voo doméstico",62,63,125,149,150,299,0,0,0,0
"17314",2020-01-01,"sbjr","transporte regular","voo internacional",0,0,0,0,0,0,0,0,0,0
"17315",2020-01-01,"sbjr","transporte não regular","voo doméstico",2881,2885,5766,12266,4993,17259,0,0,0,0
"17316",2020-01-01,"sbjr","transporte não regular","voo internacional",0,0,0,0,0,0,0,0,0,0
"17317",2020-01-01,"sbjv","transporte regular","voo doméstico",236,236,472,27098,25531,52629,0,0,0,0
"17318",2020-01-01,"sbjv","transporte regular","voo internacional",0,0,0,0,0,0,0,0,0,0
"17319",2020-01-01,"sbjv","transporte não regular","voo doméstico",86,85,171,98,70,168,0,0,0,0
"17320",2020-01-01,"sbjv","transporte não regular","voo internacional",0,0,0,0,0,0,0,0,0,0
"17321",2020-01-01,"sblo","transporte regular","voo doméstico",393,393,786,37633,38412,76045,0,0,0,0
"17322",2020-01-01,"sblo","transporte regular","voo internacional",0,0,0,0,0,0,0,0,0,0
"17323",2020-01-01,"sblo","transporte não regular","voo doméstico",385,383,768,828,691,1519,0,0,0,0
"17324",2020-01-01,"sblo","transporte não regular","voo internacional",5,5,10,0,0,0,0,0,0,0
"17325",2020-01-01,"sbma","transporte regular","voo doméstico",111,112,223,13155,14149,27304,0,0,0,0
"17326",2020-01-01,"sbma","transporte regular","voo internacional",0,0,0,0,0,0,0,0,0,0
"17327",2020-01-01,"sbma","transporte não regular","voo doméstico",128,127,255,225,643,868,0,0,0,0
"17328",2020-01-01,"sbma","transporte não regular","voo internacional",1,1,2,0,0,0,0,0,0,0
"17329",2020-01-01,"sbmk","transporte regular","voo doméstico",145,145,290,10718,9775,20493,0,0,0,0
"17330",2020-01-01,"sbmk","transporte regular","voo internacional",0,0,0,0,0,0,0,0,0,0
"17331",2020-01-01,"sbmk","transporte não regular","voo doméstico",124,125,249,313,166,479,0,0,0,0
"17332",2020-01-01,"sbmk","transporte não regular","voo internacional",0,0,0,0,0,0,0,0,0,0
"17333",2020-01-01,"sbmq","transporte regular","voo doméstico",221,221,442,31266,32014,63280,0,0,0,0
"17334",2020-01-01,"sbmq","transporte regular","voo internacional",0,0,0,0,0,0,0,0,0,0
"17335",2020-01-01,"sbmq","transporte não regular","voo doméstico",128,128,256,208,127,335,13900,39170,53070,0
"17336",2020-01-01,"sbmq","transporte não regular","voo internacional",4,4,8,0,0,0,0,0,0,0
"17337",2020-01-01,"sbmt","transporte regular","voo doméstico",0,0,0,0,0,0,0,0,0,0
"17338",2020-01-01,"sbmt","transporte regular","voo internacional",0,0,0,0,0,0,0,0,0,0
"17339",2020-01-01,"sbmt","transporte não regular","voo doméstico",2162,2159,4321,3073,3325,6398,0,0,0,0
"17340",2020-01-01,"sbmt","transporte não regular","voo internacional",0,0,0,0,0,0,0,0,0,0
"17341",2020-01-01,"sbnf","transporte regular","voo doméstico",750,751,1501,100652,95210,195862,0,0,0,0
"17342",2020-01-01,"sbnf","transporte regular","voo internacional",0,0,0,0,0,0,0,0,0,0
"17343",2020-01-01,"sbnf","transporte não regular","voo doméstico",344,342,686,680,509,1189,0,0,0,0
"17344",2020-01-01,"sbnf","transporte não regular","voo internacional",16,17,33,6,20,26,0,0,0,0
"17345",2020-01-01,"sbpb","transporte regular","voo doméstico",4,4,8,262,356,618,0,0,0,0
"17346",2020-01-01,"sbpb","transporte regular","voo internacional",0,0,0,0,0,0,0,0,0,0
"17347",2020-01-01,"sbpb","transporte não regular","voo doméstico",73,77,150,196,245,441,0,0,0,0
"17348",2020-01-01,"sbpb","transporte não regular","voo internacional",0,0,0,0,0,0,0,0,0,0
"17349",2020-01-01,"sbpj","transporte regular","voo doméstico",223,222,445,23049,25026,48075,0,0,0,0
"17350",2020-01-01,"sbpj","transporte regular","voo internacional",0,0,0,0,0,0,0,0,0,0
"17351",2020-01-01,"sbpj","transporte não regular","voo doméstico",153,151,304,370,468,838,0,0,0,0
"17352",2020-01-01,"sbpj","transporte não regular","voo internacional",1,1,2,0,0,0,0,0,0,0
"17353",2020-01-01,"sbpk","transporte regular","voo doméstico",26,26,52,1490,1521,3011,0,0,0,0
"17354",2020-01-01,"sbpk","transporte regular","voo internacional",0,0,0,0,0,0,0,0,0,0
"17355",2020-01-01,"sbpk","transporte não regular","voo doméstico",20,23,43,90,90,180,0,0,0,0
"17356",2020-01-01,"sbpk","transporte não regular","voo internacional",10,9,19,0,9,9,0,0,0,0
"17357",2020-01-01,"sbpl","transporte regular","voo doméstico",227,227,454,22089,24948,47037,0,0,0,0
"17358",2020-01-01,"sbpl","transporte regular","voo internacional",3,3,6,0,0,0,0,0,0,0
"17359",2020-01-01,"sbpl","transporte não regular","voo doméstico",63,64,127,158,97,255,0,0,0,0
"17360",2020-01-01,"sbpl","transporte não regular","voo internacional",0,0,0,0,0,0,0,0,0,0
"17361",2020-01-01,"sbpp","transporte regular","voo doméstico",0,0,0,0,0,0,0,0,0,0
"17362",2020-01-01,"sbpp","transporte regular","voo internacional",0,0,0,0,0,0,0,0,0,0
"17363",2020-01-01,"sbpp","transporte não regular","voo doméstico",60,58,118,103,118,221,0,0,0,0
"17364",2020-01-01,"sbpp","transporte não regular","voo internacional",4,4,8,2,2,4,0,0,0,0
"17365",2020-01-01,"sbpr","transporte regular","voo doméstico",0,0,0,0,0,0,0,0,0,0
"17366",2020-01-01,"sbpr","transporte regular","voo internacional",0,0,0,0,0,0,0,0,0,0
"17367",2020-01-01,"sbpr","transporte não regular","voo doméstico",585,571,1156,620,628,1248,0,0,0,0
"17368",2020-01-01,"sbpr","transporte não regular","voo internacional",0,0,0,0,0,0,0,0,0,0
"17369",2020-01-01,"sbpv","transporte regular","voo doméstico",246,246,492,36130,35530,71660,0,0,0,0
"17370",2020-01-01,"sbpv","transporte regular","voo internacional",0,0,0,0,0,0,0,0,0,0
"17371",2020-01-01,"sbpv","transporte não regular","voo doméstico",139,139,278,69,0,69,0,0,0,0
"17372",2020-01-01,"sbpv","transporte não regular","voo internacional",0,0,0,0,0,0,0,0,0,0
"17373",2020-01-01,"sbrb","transporte regular","voo doméstico",158,156,314,17949,17212,35161,0,0,0,0
"17374",2020-01-01,"sbrb","transporte regular","voo internacional",0,0,0,0,0,0,0,0,0,0
"17375",2020-01-01,"sbrb","transporte não regular","voo doméstico",139,138,277,501,166,667,0,0,0,0
"17376",2020-01-01,"sbrb","transporte não regular","voo internacional",0,0,0,0,0,0,0,0,0,0
"17377",2020-01-01,"sbrj","transporte regular","voo doméstico",4513,4540,9053,515488,473852,989340,0,0,0,0
"17378",2020-01-01,"sbrj","transporte regular","voo internacional",0,0,0,0,0,0,0,0,0,0
"17379",2020-01-01,"sbrj","transporte não regular","voo doméstico",445,417,862,1076,609,1685,0,0,0,0
"17380",2020-01-01,"sbrj","transporte não regular","voo internacional",2,2,4,0,0,0,0,0,0,0
"17381",2020-01-01,"sbsj","transporte regular","voo doméstico",22,22,44,1156,1276,2432,0,0,0,0
"17382",2020-01-01,"sbsj","transporte regular","voo internacional",0,0,0,0,0,0,0,0,0,0
"17383",2020-01-01,"sbsj","transporte não regular","voo doméstico",343,338,681,783,845,1628,0,0,0,0
"17384",2020-01-01,"sbsj","transporte não regular","voo internacional",0,1,1,2,0,2,0,0,0,0
"17385",2020-01-01,"sbsl","transporte regular","voo doméstico",583,582,1165,83472,80313,163785,0,0,0,0
"17386",2020-01-01,"sbsl","transporte regular","voo internacional",0,0,0,0,0,0,0,0,0,0
"17387",2020-01-01,"sbsl","transporte não regular","voo doméstico",158,161,319,573,345,918,0,0,0,0
"17388",2020-01-01,"sbsl","transporte não regular","voo internacional",1,2,3,0,4,4,0,0,0,0
"17389",2020-01-01,"sbsn","transporte regular","voo doméstico",270,268,538,34028,26795,60823,0,0,0,0
"17390",2020-01-01,"sbsn","transporte regular","voo internacional",0,0,0,0,0,0,0,0,0,0
"17391",2020-01-01,"sbsn","transporte não regular","voo doméstico",169,167,336,361,309,670,0,0,0,0
"17392",2020-01-01,"sbsn","transporte não regular","voo internacional",3,3,6,4,0,4,0,0,0,0
"17393",2020-01-01,"sbsp","transporte regular","voo doméstico",7478,7533,15011,875527,935803,1811330,0,0,0,0
"17394",2020-01-01,"sbsp","transporte regular","voo internacional",0,0,0,0,0,0,0,0,0,0
"17395",2020-01-01,"sbsp","transporte não regular","voo doméstico",1846,1784,3630,49344,54438,103782,0,0,0,0
"17396",2020-01-01,"sbsp","transporte não regular","voo internacional",1,1,2,0,0,0,0,0,0,0
"17397",2020-01-01,"sbte","transporte regular","voo doméstico",423,422,845,62941,57861,120802,0,0,0,0
"17398",2020-01-01,"sbte","transporte regular","voo internacional",0,0,0,0,0,0,0,0,0,0
"17399",2020-01-01,"sbte","transporte não regular","voo doméstico",151,139,290,770,814,1584,0,0,0,0
"17400",2020-01-01,"sbte","transporte não regular","voo internacional",0,0,0,0,0,0,0,0,0,0
"17401",2020-01-01,"sbtf","transporte regular","voo doméstico",33,33,66,1052,1281,2333,0,0,0,0
"17402",2020-01-01,"sbtf","transporte regular","voo internacional",0,0,0,0,0,0,0,0,0,0
"17403",2020-01-01,"sbtf","transporte não regular","voo doméstico",110,109,219,155,129,284,950,0,950,2345
"17404",2020-01-01,"sbtf","transporte não regular","voo internacional",0,0,0,0,0,0,0,0,0,0
"17405",2020-01-01,"sbtt","transporte regular","voo doméstico",30,30,60,2804,3101,5905,0,0,0,0
"17406",2020-01-01,"sbtt","transporte regular","voo internacional",0,0,0,0,0,0,0,0,0,0
"17407",2020-01-01,"sbtt","transporte não regular","voo doméstico",81,80,161,382,370,752,0,0,0,0
"17408",2020-01-01,"sbtt","transporte não regular","voo internacional",0,0,0,0,0,0,0,0,0,0
"17409",2020-01-01,"sbuf","transporte regular","voo doméstico",12,11,23,771,648,1419,0,0,0,0
"17410",2020-01-01,"sbuf","transporte regular","voo internacional",0,0,0,0,0,0,0,0,0,0
"17411",2020-01-01,"sbuf","transporte não regular","voo doméstico",33,33,66,147,105,252,0,0,0,0
"17412",2020-01-01,"sbuf","transporte não regular","voo internacional",0,0,0,0,0,0,0,0,0,0
"17413",2020-01-01,"sbug","transporte regular","voo doméstico",17,17,34,766,725,1491,0,0,0,0
"17414",2020-01-01,"sbug","transporte regular","voo internacional",0,0,0,0,0,0,0,0,0,0
"17415",2020-01-01,"sbug","transporte não regular","voo doméstico",6,6,12,11,7,18,0,0,0,0
"17416",2020-01-01,"sbug","transporte não regular","voo internacional",0,0,0,0,0,0,0,0,0,0
"17417",2020-01-01,"sbul","transporte regular","voo doméstico",476,475,951,44742,44327,89069,0,0,0,0
"17418",2020-01-01,"sbul","transporte regular","voo internacional",0,0,0,0,0,0,0,0,0,0
"17419",2020-01-01,"sbul","transporte não regular","voo doméstico",376,376,752,1393,1493,2886,0,0,0,0
"17420",2020-01-01,"sbul","transporte não regular","voo internacional",1,1,2,0,0,0,0,0,0,0
"17421",2020-01-01,"sbur","transporte regular","voo doméstico",55,56,111,2303,2307,4610,0,0,0,0
"17422",2020-01-01,"sbur","transporte regular","voo internacional",0,0,0,0,0,0,0,0,0,0
"17423",2020-01-01,"sbur","transporte não regular","voo doméstico",136,138,274,477,531,1008,0,0,0,0
"17424",2020-01-01,"sbur","transporte não regular","voo internacional",0,0,0,0,0,0,0,0,0,0
"17425",2020-07-01,"sbbe","transporte regular","voo doméstico",434,438,872,51074,51975,103049,0,0,0,0
"17426",2020-07-01,"sbbe","transporte regular","voo internacional",4,2,6,2,436,438,1,0,1,0
"17427",2020-07-01,"sbbe","transporte não regular","voo doméstico",571,562,1133,691,1141,1832,0,0,0,0
"17428",2020-07-01,"sbbe","transporte não regular","voo internacional",2,5,7,4,0,4,0,0,0,0
"17429",2020-07-01,"sbbg","transporte regular","voo doméstico",0,0,0,0,0,0,0,0,0,0
"17430",2020-07-01,"sbbg","transporte regular","voo internacional",0,0,0,0,0,0,0,0,0,0
"17431",2020-07-01,"sbbg","transporte não regular","voo doméstico",8,8,16,38,38,76,0,0,0,0
"17432",2020-07-01,"sbbg","transporte não regular","voo internacional",0,0,0,0,0,0,0,0,0,0
"17433",2020-07-01,"sbbh","transporte regular","voo doméstico",0,0,0,0,0,0,0,0,0,0
"17434",2020-07-01,"sbbh","transporte regular","voo internacional",0,0,0,0,0,0,0,0,0,0
"17435",2020-07-01,"sbbh","transporte não regular","voo doméstico",1306,1317,2623,6328,6215,12543,0,0,0,0
"17436",2020-07-01,"sbbh","transporte não regular","voo internacional",0,0,0,0,0,0,0,0,0,0
"17437",2020-07-01,"sbbi","transporte regular","voo doméstico",0,0,0,0,0,0,0,0,0,0
"17438",2020-07-01,"sbbi","transporte regular","voo internacional",0,0,0,0,0,0,0,0,0,0
"17439",2020-07-01,"sbbi","transporte não regular","voo doméstico",1136,1132,2268,710,626,1336,0,0,0,0
"17440",2020-07-01,"sbbi","transporte não regular","voo internacional",2,2,4,0,0,0,0,0,0,0
"17441",2020-07-01,"sbbv","transporte regular","voo doméstico",39,39,78,5298,4680,9978,0,0,0,0
"17442",2020-07-01,"sbbv","transporte regular","voo internacional",0,0,0,0,0,0,0,0,0,0
"17443",2020-07-01,"sbbv","transporte não regular","voo doméstico",132,126,258,50,34,84,0,0,0,0
"17444",2020-07-01,"sbbv","transporte não regular","voo internacional",10,10,20,1,3,4,0,0,0,0
"17445",2020-07-01,"sbcg","transporte regular","voo doméstico",146,145,291,14406,13382,27788,5262,4914,10176,0
"17446",2020-07-01,"sbcg","transporte regular","voo internacional",0,0,0,0,0,0,0,0,0,0
"17447",2020-07-01,"sbcg","transporte não regular","voo doméstico",206,200,406,189,88,277,19590,27024,46614,0
"17448",2020-07-01,"sbcg","transporte não regular","voo internacional",2,0,2,0,0,0,0,0,0,0
"17449",2020-07-01,"sbcj","transporte regular","voo doméstico",4,4,8,208,56,264,0,0,0,0
"17450",2020-07-01,"sbcj","transporte regular","voo internacional",0,0,0,0,0,0,0,0,0,0
"17451",2020-07-01,"sbcj","transporte não regular","voo doméstico",143,141,284,393,237,630,0,0,0,0
"17452",2020-07-01,"sbcj","transporte não regular","voo internacional",0,0,0,0,0,0,0,0,0,0
"17453",2020-07-01,"sbcr","transporte regular","voo doméstico",0,0,0,0,0,0,0,0,0,0
"17454",2020-07-01,"sbcr","transporte regular","voo internacional",0,0,0,0,0,0,0,0,0,0
"17455",2020-07-01,"sbcr","transporte não regular","voo doméstico",39,38,77,91,72,163,0,0,0,0
"17456",2020-07-01,"sbcr","transporte não regular","voo internacional",2,2,4,8,8,16,0,0,0,0
"17457",2020-07-01,"sbct","transporte regular","voo doméstico",335,337,672,36109,36179,72288,20405,8707,29112,25196
"17458",2020-07-01,"sbct","transporte regular","voo internacional",30,30,60,0,0,0,18352,76098,94450,0
"17459",2020-07-01,"sbct","transporte não regular","voo doméstico",191,194,385,520,536,1056,0,0,0,0
"17460",2020-07-01,"sbct","transporte não regular","voo internacional",3,5,8,6,0,6,0,0,0,0
"17461",2020-07-01,"sbcz","transporte regular","voo doméstico",0,0,0,0,0,0,0,0,0,0
"17462",2020-07-01,"sbcz","transporte regular","voo internacional",0,0,0,0,0,0,0,0,0,0
"17463",2020-07-01,"sbcz","transporte não regular","voo doméstico",205,207,412,604,531,1135,0,0,0,0
"17464",2020-07-01,"sbcz","transporte não regular","voo internacional",0,0,0,0,0,0,0,0,0,0
"17465",2020-07-01,"sbeg","transporte regular","voo doméstico",459,443,902,36987,33906,70893,53762,125156,178918,0
"17466",2020-07-01,"sbeg","transporte regular","voo internacional",41,53,94,0,0,0,0,0,0,0
"17467",2020-07-01,"sbeg","transporte não regular","voo doméstico",512,511,1023,2158,177,2335,19170,25160,44330,0
"17468",2020-07-01,"sbeg","transporte não regular","voo internacional",32,37,69,34,0,34,0,0,0,0
"17469",2020-07-01,"sbfi","transporte regular","voo doméstico",60,60,120,6331,5678,12009,0,0,0,0
"17470",2020-07-01,"sbfi","transporte regular","voo internacional",0,0,0,0,0,0,0,0,0,0
"17471",2020-07-01,"sbfi","transporte não regular","voo doméstico",28,27,55,58,2,60,0,0,0,0
"17472",2020-07-01,"sbfi","transporte não regular","voo internacional",3,4,7,1,3,4,0,0,0,0
"17473",2020-07-01,"sbgo","transporte regular","voo doméstico",259,260,519,25823,25779,51602,106390,77393,183783,0
"17474",2020-07-01,"sbgo","transporte regular","voo internacional",0,0,0,0,0,0,0,0,0,0
"17475",2020-07-01,"sbgo","transporte não regular","voo doméstico",1023,1025,2048,3307,2525,5832,0,0,0,0
"17476",2020-07-01,"sbgo","transporte não regular","voo internacional",0,1,1,0,0,0,0,0,0,0
"17477",2020-07-01,"sbht","transporte regular","voo doméstico",32,32,64,1352,1281,2633,0,0,0,0
"17478",2020-07-01,"sbht","transporte regular","voo internacional",0,0,0,0,0,0,0,0,0,0
"17479",2020-07-01,"sbht","transporte não regular","voo doméstico",55,55,110,118,89,207,0,0,0,0
"17480",2020-07-01,"sbht","transporte não regular","voo internacional",0,0,0,0,0,0,0,0,0,0
"17481",2020-07-01,"sbiz","transporte regular","voo doméstico",25,25,50,2554,2697,5251,0,0,0,0
"17482",2020-07-01,"sbiz","transporte regular","voo internacional",0,0,0,0,0,0,0,0,0,0
"17483",2020-07-01,"sbiz","transporte não regular","voo doméstico",172,169,341,72,2,74,0,0,0,0
"17484",2020-07-01,"sbiz","transporte não regular","voo internacional",0,0,0,0,0,0,0,0,0,0
"17485",2020-07-01,"sbjc","transporte regular","voo doméstico",0,0,0,0,0,0,0,0,0,0
"17486",2020-07-01,"sbjc","transporte regular","voo internacional",0,0,0,0,0,0,0,0,0,0
"17487",2020-07-01,"sbjc","transporte não regular","voo doméstico",226,231,457,532,353,885,0,0,0,0
"17488",2020-07-01,"sbjc","transporte não regular","voo internacional",0,0,0,0,0,0,0,0,0,0
"17489",2020-07-01,"sbjr","transporte regular","voo doméstico",0,0,0,0,0,0,0,0,0,0
"17490",2020-07-01,"sbjr","transporte regular","voo internacional",0,0,0,0,0,0,0,0,0,0
"17491",2020-07-01,"sbjr","transporte não regular","voo doméstico",1717,1727,3444,8228,1776,10004,0,0,0,0
"17492",2020-07-01,"sbjr","transporte não regular","voo internacional",0,0,0,0,0,0,0,0,0,0
"17493",2020-07-01,"sbjv","transporte regular","voo doméstico",10,10,20,767,845,1612,0,0,0,0
"17494",2020-07-01,"sbjv","transporte regular","voo internacional",0,0,0,0,0,0,0,0,0,0
"17495",2020-07-01,"sbjv","transporte não regular","voo doméstico",71,72,143,67,20,87,0,0,0,0
"17496",2020-07-01,"sbjv","transporte não regular","voo internacional",0,0,0,0,0,0,0,0,0,0
"17497",2020-07-01,"sblo","transporte regular","voo doméstico",42,42,84,3894,4197,8091,0,0,0,0
"17498",2020-07-01,"sblo","transporte regular","voo internacional",0,0,0,0,0,0,0,0,0,0
"17499",2020-07-01,"sblo","transporte não regular","voo doméstico",376,378,754,130,12,142,0,0,0,0
"17500",2020-07-01,"sblo","transporte não regular","voo internacional",0,0,0,0,0,0,0,0,0,0
"17501",2020-07-01,"sbma","transporte regular","voo doméstico",22,22,44,2665,2545,5210,0,0,0,0
"17502",2020-07-01,"sbma","transporte regular","voo internacional",0,0,0,0,0,0,0,0,0,0
"17503",2020-07-01,"sbma","transporte não regular","voo doméstico",123,125,248,378,395,773,0,0,0,0
"17504",2020-07-01,"sbma","transporte não regular","voo internacional",0,0,0,0,0,0,0,0,0,0
"17505",2020-07-01,"sbmk","transporte regular","voo doméstico",20,19,39,1192,1173,2365,0,0,0,0
"17506",2020-07-01,"sbmk","transporte regular","voo internacional",0,0,0,0,0,0,0,0,0,0
"17507",2020-07-01,"sbmk","transporte não regular","voo doméstico",169,168,337,316,0,316,0,0,0,0
"17508",2020-07-01,"sbmk","transporte não regular","voo internacional",0,0,0,0,0,0,0,0,0,0
"17509",2020-07-01,"sbmq","transporte regular","voo doméstico",63,65,128,11782,10273,22055,0,0,0,0
"17510",2020-07-01,"sbmq","transporte regular","voo internacional",0,0,0,0,0,0,0,0,0,0
"17511",2020-07-01,"sbmq","transporte não regular","voo doméstico",175,174,349,370,212,582,12200,43700,55900,0
"17512",2020-07-01,"sbmq","transporte não regular","voo internacional",1,1,2,0,0,0,0,0,0,0
"17513",2020-07-01,"sbmt","transporte regular","voo doméstico",0,0,0,0,0,0,0,0,0,0
"17514",2020-07-01,"sbmt","transporte regular","voo internacional",0,0,0,0,0,0,0,0,0,0
"17515",2020-07-01,"sbmt","transporte não regular","voo doméstico",2043,2040,4083,3410,3457,6867,0,0,0,0
"17516",2020-07-01,"sbmt","transporte não regular","voo internacional",0,0,0,0,0,0,0,0,0,0
"17517",2020-07-01,"sbnf","transporte regular","voo doméstico",178,178,356,16909,17284,34193,0,0,0,0
"17518",2020-07-01,"sbnf","transporte regular","voo internacional",0,0,0,0,0,0,0,0,0,0
"17519",2020-07-01,"sbnf","transporte não regular","voo doméstico",247,244,491,294,381,675,0,0,0,0
"17520",2020-07-01,"sbnf","transporte não regular","voo internacional",0,0,0,0,0,0,0,0,0,0
"17521",2020-07-01,"sbpb","transporte regular","voo doméstico",0,0,0,0,0,0,0,0,0,0
"17522",2020-07-01,"sbpb","transporte regular","voo internacional",0,0,0,0,0,0,0,0,0,0
"17523",2020-07-01,"sbpb","transporte não regular","voo doméstico",43,42,85,93,102,195,0,0,0,0
"17524",2020-07-01,"sbpb","transporte não regular","voo internacional",0,0,0,0,0,0,0,0,0,0
"17525",2020-07-01,"sbpj","transporte regular","voo doméstico",72,72,144,7180,7151,14331,0,0,0,0
"17526",2020-07-01,"sbpj","transporte regular","voo internacional",0,0,0,0,0,0,0,0,0,0
"17527",2020-07-01,"sbpj","transporte não regular","voo doméstico",231,228,459,453,301,754,0,0,0,0
"17528",2020-07-01,"sbpj","transporte não regular","voo internacional",1,1,2,0,0,0,0,0,0,0
"17529",2020-07-01,"sbpk","transporte regular","voo doméstico",0,0,0,0,0,0,0,0,0,0
"17530",2020-07-01,"sbpk","transporte regular","voo internacional",0,0,0,0,0,0,0,0,0,0
"17531",2020-07-01,"sbpk","transporte não regular","voo doméstico",23,22,45,57,53,110,0,0,0,0
"17532",2020-07-01,"sbpk","transporte não regular","voo internacional",0,0,0,0,0,0,0,0,0,0
"17533",2020-07-01,"sbpl","transporte regular","voo doméstico",66,66,132,4840,5157,9997,0,0,0,0
"17534",2020-07-01,"sbpl","transporte regular","voo internacional",0,0,0,0,0,0,0,0,0,0
"17535",2020-07-01,"sbpl","transporte não regular","voo doméstico",66,68,134,87,48,135,0,0,0,0
"17536",2020-07-01,"sbpl","transporte não regular","voo internacional",0,0,0,0,0,0,0,0,0,0
"17537",2020-07-01,"sbpp","transporte regular","voo doméstico",0,0,0,0,0,0,0,0,0,0
"17538",2020-07-01,"sbpp","transporte regular","voo internacional",0,0,0,0,0,0,0,0,0,0
"17539",2020-07-01,"sbpp","transporte não regular","voo doméstico",69,69,138,109,119,228,0,0,0,0
"17540",2020-07-01,"sbpp","transporte não regular","voo internacional",0,0,0,0,0,0,0,0,0,0
"17541",2020-07-01,"sbpr","transporte regular","voo doméstico",0,0,0,0,0,0,0,0,0,0
"17542",2020-07-01,"sbpr","transporte regular","voo internacional",0,0,0,0,0,0,0,0,0,0
"17543",2020-07-01,"sbpr","transporte não regular","voo doméstico",598,599,1197,858,808,1666,0,0,0,0
"17544",2020-07-01,"sbpr","transporte não regular","voo internacional",0,0,0,0,0,0,0,0,0,0
"17545",2020-07-01,"sbpv","transporte regular","voo doméstico",128,128,256,9309,9202,18511,0,0,0,0
"17546",2020-07-01,"sbpv","transporte regular","voo internacional",0,0,0,0,0,0,0,0,0,0
"17547",2020-07-01,"sbpv","transporte não regular","voo doméstico",154,153,307,175,0,175,0,0,0,0
"17548",2020-07-01,"sbpv","transporte não regular","voo internacional",0,0,0,0,0,0,0,0,0,0
"17549",2020-07-01,"sbrb","transporte regular","voo doméstico",34,34,68,3212,2694,5906,0,0,0,0
"17550",2020-07-01,"sbrb","transporte regular","voo internacional",0,0,0,0,0,0,0,0,0,0
"17551",2020-07-01,"sbrb","transporte não regular","voo doméstico",183,180,363,436,139,575,0,0,0,0
"17552",2020-07-01,"sbrb","transporte não regular","voo internacional",1,0,1,0,0,0,0,0,0,0
"17553",2020-07-01,"sbrj","transporte regular","voo doméstico",775,776,1551,81919,83414,165333,0,0,0,0
"17554",2020-07-01,"sbrj","transporte regular","voo internacional",0,0,0,0,0,0,0,0,0,0
"17555",2020-07-01,"sbrj","transporte não regular","voo doméstico",288,281,569,714,495,1209,0,0,0,0
"17556",2020-07-01,"sbrj","transporte não regular","voo internacional",0,0,0,0,0,0,0,0,0,0
"17557",2020-07-01,"sbsj","transporte regular","voo doméstico",0,0,0,0,0,0,0,0,0,0
"17558",2020-07-01,"sbsj","transporte regular","voo internacional",0,0,0,0,0,0,0,0,0,0
"17559",2020-07-01,"sbsj","transporte não regular","voo doméstico",231,225,456,664,689,1353,0,0,0,0
"17560",2020-07-01,"sbsj","transporte não regular","voo internacional",1,2,3,6,2,8,0,0,0,0
"17561",2020-07-01,"sbsl","transporte regular","voo doméstico",167,167,334,18656,19751,38407,0,0,0,0
"17562",2020-07-01,"sbsl","transporte regular","voo internacional",0,0,0,0,0,0,0,0,0,0
"17563",2020-07-01,"sbsl","transporte não regular","voo doméstico",272,278,550,690,635,1325,0,0,0,0
"17564",2020-07-01,"sbsl","transporte não regular","voo internacional",1,1,2,0,0,0,0,0,0,0
"17565",2020-07-01,"sbsn","transporte regular","voo doméstico",90,90,180,6319,6404,12723,0,0,0,0
"17566",2020-07-01,"sbsn","transporte regular","voo internacional",0,0,0,0,0,0,0,0,0,0
"17567",2020-07-01,"sbsn","transporte não regular","voo doméstico",304,307,611,168,5,173,0,0,0,0
"17568",2020-07-01,"sbsn","transporte não regular","voo internacional",0,0,0,0,0,0,0,0,0,0
"17569",2020-07-01,"sbsp","transporte regular","voo doméstico",670,679,1349,62606,63158,125764,0,0,0,0
"17570",2020-07-01,"sbsp","transporte regular","voo internacional",0,0,0,0,0,0,0,0,0,0
"17571",2020-07-01,"sbsp","transporte não regular","voo doméstico",1632,1639,3271,3544,3293,6837,0,0,0,0
"17572",2020-07-01,"sbsp","transporte não regular","voo internacional",2,2,4,0,0,0,0,0,0,0
"17573",2020-07-01,"sbte","transporte regular","voo doméstico",122,122,244,13761,14682,28443,0,0,0,0
"17574",2020-07-01,"sbte","transporte regular","voo internacional",0,0,0,0,0,0,0,0,0,0
"17575",2020-07-01,"sbte","transporte não regular","voo doméstico",122,124,246,274,196,470,0,0,0,0
"17576",2020-07-01,"sbte","transporte não regular","voo internacional",0,0,0,0,0,0,0,0,0,0
"17577",2020-07-01,"sbtf","transporte regular","voo doméstico",29,29,58,557,583,1140,0,0,0,0
"17578",2020-07-01,"sbtf","transporte regular","voo internacional",0,0,0,0,0,0,0,0,0,0
"17579",2020-07-01,"sbtf","transporte não regular","voo doméstico",182,182,364,276,183,459,420,0,420,1770
"17580",2020-07-01,"sbtf","transporte não regular","voo internacional",0,0,0,0,0,0,0,0,0,0
"17581",2020-07-01,"sbtt","transporte regular","voo doméstico",19,19,38,1182,1498,2680,0,0,0,0
"17582",2020-07-01,"sbtt","transporte regular","voo internacional",0,0,0,0,0,0,0,0,0,0
"17583",2020-07-01,"sbtt","transporte não regular","voo doméstico",116,118,234,525,598,1123,0,0,0,0
"17584",2020-07-01,"sbtt","transporte não regular","voo internacional",1,1,2,0,0,0,0,0,0,0
"17585",2020-07-01,"sbuf","transporte regular","voo doméstico",0,0,0,0,0,0,0,0,0,0
"17586",2020-07-01,"sbuf","transporte regular","voo internacional",0,0,0,0,0,0,0,0,0,0
"17587",2020-07-01,"sbuf","transporte não regular","voo doméstico",16,15,31,5,6,11,0,0,0,0
"17588",2020-07-01,"sbuf","transporte não regular","voo internacional",0,0,0,0,0,0,0,0,0,0
"17589",2020-07-01,"sbug","transporte regular","voo doméstico",0,0,0,0,0,0,0,0,0,0
"17590",2020-07-01,"sbug","transporte regular","voo internacional",0,0,0,0,0,0,0,0,0,0
"17591",2020-07-01,"sbug","transporte não regular","voo doméstico",4,4,8,19,17,36,0,0,0,0
"17592",2020-07-01,"sbug","transporte não regular","voo internacional",0,0,0,0,0,0,0,0,0,0
"17593",2020-07-01,"sbul","transporte regular","voo doméstico",81,79,160,5186,5165,10351,0,0,0,0
"17594",2020-07-01,"sbul","transporte regular","voo internacional",0,0,0,0,0,0,0,0,0,0
"17595",2020-07-01,"sbul","transporte não regular","voo doméstico",362,356,718,879,698,1577,0,0,0,0
"17596",2020-07-01,"sbul","transporte não regular","voo internacional",0,0,0,0,0,0,0,0,0,0
"17597",2020-07-01,"sbur","transporte regular","voo doméstico",0,0,0,0,0,0,0,0,0,0
"17598",2020-07-01,"sbur","transporte regular","voo internacional",0,0,0,0,0,0,0,0,0,0
"17599",2020-07-01,"sbur","transporte não regular","voo doméstico",155,153,308,485,503,988,0,0,0,0
"17600",2020-07-01,"sbur","transporte não regular","voo internacional",0,0,0,0,0,0,0,0,0,0
"17601",2020-06-01,"sbbe","transporte regular","voo doméstico",280,277,557,25824,26417,52241,0,0,0,0
"17602",2020-06-01,"sbbe","transporte regular","voo internacional",2,2,4,0,211,211,0,0,0,0
"17603",2020-06-01,"sbbe","transporte não regular","voo doméstico",522,522,1044,687,1050,1737,0,0,0,0
"17604",2020-06-01,"sbbe","transporte não regular","voo internacional",5,4,9,29,75,104,0,0,0,0
"17605",2020-06-01,"sbbg","transporte regular","voo doméstico",0,0,0,0,0,0,0,0,0,0
"17606",2020-06-01,"sbbg","transporte regular","voo internacional",0,0,0,0,0,0,0,0,0,0
"17607",2020-06-01,"sbbg","transporte não regular","voo doméstico",12,12,24,49,53,102,0,0,0,0
"17608",2020-06-01,"sbbg","transporte não regular","voo internacional",0,0,0,0,0,0,0,0,0,0
"17609",2020-06-01,"sbbh","transporte regular","voo doméstico",0,0,0,0,0,0,0,0,0,0
"17610",2020-06-01,"sbbh","transporte regular","voo internacional",0,0,0,0,0,0,0,0,0,0
"17611",2020-06-01,"sbbh","transporte não regular","voo doméstico",1093,1094,2187,5727,5734,11461,0,0,0,0
"17612",2020-06-01,"sbbh","transporte não regular","voo internacional",0,0,0,0,0,0,0,0,0,0
"17613",2020-06-01,"sbbi","transporte regular","voo doméstico",0,0,0,0,0,0,0,0,0,0
"17614",2020-06-01,"sbbi","transporte regular","voo internacional",0,0,0,0,0,0,0,0,0,0
"17615",2020-06-01,"sbbi","transporte não regular","voo doméstico",1082,1082,2164,760,664,1424,0,0,0,0
"17616",2020-06-01,"sbbi","transporte não regular","voo internacional",0,0,0,0,0,0,0,0,0,0
"17617",2020-06-01,"sbbv","transporte regular","voo doméstico",23,23,46,2898,2364,5262,0,0,0,0
"17618",2020-06-01,"sbbv","transporte regular","voo internacional",0,0,0,0,0,0,0,0,0,0
"17619",2020-06-01,"sbbv","transporte não regular","voo doméstico",154,153,307,177,97,274,0,0,0,0
"17620",2020-06-01,"sbbv","transporte não regular","voo internacional",1,5,6,1,0,1,0,0,0,0
"17621",2020-06-01,"sbcg","transporte regular","voo doméstico",90,90,180,8175,7830,16005,59294,74834,134128,0
"17622",2020-06-01,"sbcg","transporte regular","voo internacional",0,0,0,0,0,0,0,0,0,0
"17623",2020-06-01,"sbcg","transporte não regular","voo doméstico",148,160,308,132,31,163,0,0,0,0
"17624",2020-06-01,"sbcg","transporte não regular","voo internacional",6,1,7,0,0,0,0,0,0,0
"17625",2020-06-01,"sbcj","transporte regular","voo doméstico",0,0,0,0,0,0,0,0,0,0
"17626",2020-06-01,"sbcj","transporte regular","voo internacional",0,0,0,0,0,0,0,0,0,0
"17627",2020-06-01,"sbcj","transporte não regular","voo doméstico",91,93,184,380,62,442,0,0,0,0
"17628",2020-06-01,"sbcj","transporte não regular","voo internacional",0,0,0,0,0,0,0,0,0,0
"17629",2020-06-01,"sbcr","transporte regular","voo doméstico",0,0,0,0,0,0,0,0,0,0
"17630",2020-06-01,"sbcr","transporte regular","voo internacional",0,0,0,0,0,0,0,0,0,0
"17631",2020-06-01,"sbcr","transporte não regular","voo doméstico",24,24,48,62,50,112,0,0,0,0
"17632",2020-06-01,"sbcr","transporte não regular","voo internacional",0,1,1,2,0,2,0,0,0,0
"17633",2020-06-01,"sbct","transporte regular","voo doméstico",261,260,521,23873,25115,48988,141645,42258,183903,146587
"17634",2020-06-01,"sbct","transporte regular","voo internacional",31,31,62,0,0,0,11042,37834,48876,0
"17635",2020-06-01,"sbct","transporte não regular","voo doméstico",161,162,323,349,264,613,0,0,0,0
"17636",2020-06-01,"sbct","transporte não regular","voo internacional",4,5,9,3,2,5,30464,7188,37652,0
"17637",2020-06-01,"sbcz","transporte regular","voo doméstico",0,0,0,0,0,0,0,0,0,0
"17638",2020-06-01,"sbcz","transporte regular","voo internacional",0,0,0,0,0,0,0,0,0,0
"17639",2020-06-01,"sbcz","transporte não regular","voo doméstico",140,141,281,426,356,782,0,0,0,0
"17640",2020-06-01,"sbcz","transporte não regular","voo internacional",0,0,0,0,0,0,0,0,0,0
"17641",2020-06-01,"sbeg","transporte regular","voo doméstico",245,238,483,16599,14079,30678,112878,282777,395655,0
"17642",2020-06-01,"sbeg","transporte regular","voo internacional",36,48,84,0,0,0,0,0,0,0
"17643",2020-06-01,"sbeg","transporte não regular","voo doméstico",462,461,923,2053,113,2166,0,0,0,0
"17644",2020-06-01,"sbeg","transporte não regular","voo internacional",26,22,48,3,0,3,0,35085,35085,0
"17645",2020-06-01,"sbfi","transporte regular","voo doméstico",40,40,80,3836,3628,7464,0,0,0,0
"17646",2020-06-01,"sbfi","transporte regular","voo internacional",0,0,0,0,0,0,0,0,0,0
"17647",2020-06-01,"sbfi","transporte não regular","voo doméstico",44,43,87,60,45,105,0,0,0,0
"17648",2020-06-01,"sbfi","transporte não regular","voo internacional",3,4,7,4,2,6,0,0,0,0
"17649",2020-06-01,"sbgo","transporte regular","voo doméstico",174,174,348,14590,15266,29856,116292,115298,231590,0
"17650",2020-06-01,"sbgo","transporte regular","voo internacional",0,0,0,0,0,0,0,0,0,0
"17651",2020-06-01,"sbgo","transporte não regular","voo doméstico",1013,991,2004,3116,2803,5919,0,0,0,0
"17652",2020-06-01,"sbgo","transporte não regular","voo internacional",0,1,1,0,0,0,0,0,0,0
"17653",2020-06-01,"sbht","transporte regular","voo doméstico",21,21,42,835,721,1556,0,0,0,0
"17654",2020-06-01,"sbht","transporte regular","voo internacional",0,0,0,0,0,0,0,0,0,0
"17655",2020-06-01,"sbht","transporte não regular","voo doméstico",88,89,177,89,54,143,0,0,0,0
"17656",2020-06-01,"sbht","transporte não regular","voo internacional",0,0,0,0,0,0,0,0,0,0
"17657",2020-06-01,"sbiz","transporte regular","voo doméstico",8,8,16,538,816,1354,0,0,0,0
"17658",2020-06-01,"sbiz","transporte regular","voo internacional",0,0,0,0,0,0,0,0,0,0
"17659",2020-06-01,"sbiz","transporte não regular","voo doméstico",145,150,295,15,0,15,0,0,0,0
"17660",2020-06-01,"sbiz","transporte não regular","voo internacional",0,0,0,0,0,0,0,0,0,0
"17661",2020-06-01,"sbjc","transporte regular","voo doméstico",0,0,0,0,0,0,0,0,0,0
"17662",2020-06-01,"sbjc","transporte regular","voo internacional",0,0,0,0,0,0,0,0,0,0
"17663",2020-06-01,"sbjc","transporte não regular","voo doméstico",457,460,917,1043,665,1708,0,0,0,0
"17664",2020-06-01,"sbjc","transporte não regular","voo internacional",0,0,0,0,0,0,0,0,0,0
"17665",2020-06-01,"sbjr","transporte regular","voo doméstico",0,0,0,0,0,0,0,0,0,0
"17666",2020-06-01,"sbjr","transporte regular","voo internacional",0,0,0,0,0,0,0,0,0,0
"17667",2020-06-01,"sbjr","transporte não regular","voo doméstico",1832,1829,3661,7639,1473,9112,0,0,0,0
"17668",2020-06-01,"sbjr","transporte não regular","voo internacional",0,0,0,0,0,0,0,0,0,0
"17669",2020-06-01,"sbjv","transporte regular","voo doméstico",0,0,0,0,0,0,0,0,0,0
"17670",2020-06-01,"sbjv","transporte regular","voo internacional",0,0,0,0,0,0,0,0,0,0
"17671",2020-06-01,"sbjv","transporte não regular","voo doméstico",61,61,122,54,22,76,0,0,0,0
"17672",2020-06-01,"sbjv","transporte não regular","voo internacional",0,0,0,0,0,0,0,0,0,0
"17673",2020-06-01,"sblo","transporte regular","voo doméstico",23,23,46,2242,2220,4462,0,0,0,0
"17674",2020-06-01,"sblo","transporte regular","voo internacional",0,0,0,0,0,0,0,0,0,0
"17675",2020-06-01,"sblo","transporte não regular","voo doméstico",351,344,695,117,14,131,0,0,0,0
"17676",2020-06-01,"sblo","transporte não regular","voo internacional",0,0,0,0,0,0,0,0,0,0
"17677",2020-06-01,"sbma","transporte regular","voo doméstico",23,22,45,1977,2249,4226,0,0,0,0
"17678",2020-06-01,"sbma","transporte regular","voo internacional",0,0,0,0,0,0,0,0,0,0
"17679",2020-06-01,"sbma","transporte não regular","voo doméstico",117,118,235,284,303,587,0,0,0,0
"17680",2020-06-01,"sbma","transporte não regular","voo internacional",0,0,0,0,0,0,0,0,0,0
"17681",2020-06-01,"sbmk","transporte regular","voo doméstico",12,12,24,607,702,1309,0,0,0,0
"17682",2020-06-01,"sbmk","transporte regular","voo internacional",0,0,0,0,0,0,0,0,0,0
"17683",2020-06-01,"sbmk","transporte não regular","voo doméstico",178,178,356,256,0,256,0,0,0,0
"17684",2020-06-01,"sbmk","transporte não regular","voo internacional",0,0,0,0,0,0,0,0,0,0
"17685",2020-06-01,"sbmq","transporte regular","voo doméstico",44,45,89,6965,5755,12720,0,0,0,0
"17686",2020-06-01,"sbmq","transporte regular","voo internacional",0,0,0,0,0,0,0,0,0,0
"17687",2020-06-01,"sbmq","transporte não regular","voo doméstico",179,177,356,461,140,601,9680,47650,57330,0
"17688",2020-06-01,"sbmq","transporte não regular","voo internacional",1,0,1,0,0,0,0,0,0,0
"17689",2020-06-01,"sbmt","transporte regular","voo doméstico",0,0,0,0,0,0,0,0,0,0
"17690",2020-06-01,"sbmt","transporte regular","voo internacional",0,0,0,0,0,0,0,0,0,0
"17691",2020-06-01,"sbmt","transporte não regular","voo doméstico",1582,1568,3150,2468,2512,4980,0,0,0,0
"17692",2020-06-01,"sbmt","transporte não regular","voo internacional",0,0,0,0,0,0,0,0,0,0
"17693",2020-06-01,"sbnf","transporte regular","voo doméstico",77,77,154,7846,8102,15948,0,0,0,0
"17694",2020-06-01,"sbnf","transporte regular","voo internacional",0,0,0,0,0,0,0,0,0,0
"17695",2020-06-01,"sbnf","transporte não regular","voo doméstico",193,192,385,312,289,601,0,0,0,0
"17696",2020-06-01,"sbnf","transporte não regular","voo internacional",0,0,0,0,0,0,0,0,0,0
"17697",2020-06-01,"sbpb","transporte regular","voo doméstico",0,0,0,0,0,0,0,0,0,0
"17698",2020-06-01,"sbpb","transporte regular","voo internacional",0,0,0,0,0,0,0,0,0,0
"17699",2020-06-01,"sbpb","transporte não regular","voo doméstico",24,26,50,47,40,87,0,0,0,0
"17700",2020-06-01,"sbpb","transporte não regular","voo internacional",0,0,0,0,0,0,0,0,0,0
"17701",2020-06-01,"sbpj","transporte regular","voo doméstico",32,31,63,2993,3216,6209,0,0,0,0
"17702",2020-06-01,"sbpj","transporte regular","voo internacional",0,0,0,0,0,0,0,0,0,0
"17703",2020-06-01,"sbpj","transporte não regular","voo doméstico",216,216,432,164,132,296,0,0,0,0
"17704",2020-06-01,"sbpj","transporte não regular","voo internacional",0,0,0,0,0,0,0,0,0,0
"17705",2020-06-01,"sbpk","transporte regular","voo doméstico",0,0,0,0,0,0,0,0,0,0
"17706",2020-06-01,"sbpk","transporte regular","voo internacional",0,0,0,0,0,0,0,0,0,0
"17707",2020-06-01,"sbpk","transporte não regular","voo doméstico",30,30,60,67,68,135,0,0,0,0
"17708",2020-06-01,"sbpk","transporte não regular","voo internacional",0,0,0,0,0,0,0,0,0,0
"17709",2020-06-01,"sbpl","transporte regular","voo doméstico",42,42,84,2254,2707,4961,0,0,0,0
"17710",2020-06-01,"sbpl","transporte regular","voo internacional",0,0,0,0,0,0,0,0,0,0
"17711",2020-06-01,"sbpl","transporte não regular","voo doméstico",88,86,174,105,92,197,0,0,0,0
"17712",2020-06-01,"sbpl","transporte não regular","voo internacional",0,0,0,0,0,0,0,0,0,0
"17713",2020-06-01,"sbpp","transporte regular","voo doméstico",0,0,0,0,0,0,0,0,0,0
"17714",2020-06-01,"sbpp","transporte regular","voo internacional",0,0,0,0,0,0,0,0,0,0
"17715",2020-06-01,"sbpp","transporte não regular","voo doméstico",68,64,132,81,90,171,0,0,0,0
"17716",2020-06-01,"sbpp","transporte não regular","voo internacional",0,0,0,0,0,0,0,0,0,0
"17717",2020-06-01,"sbpr","transporte regular","voo doméstico",0,0,0,0,0,0,0,0,0,0
"17718",2020-06-01,"sbpr","transporte regular","voo internacional",0,0,0,0,0,0,0,0,0,0
"17719",2020-06-01,"sbpr","transporte não regular","voo doméstico",718,720,1438,1073,1021,2094,0,0,0,0
"17720",2020-06-01,"sbpr","transporte não regular","voo internacional",0,0,0,0,0,0,0,0,0,0
"17721",2020-06-01,"sbpv","transporte regular","voo doméstico",73,73,146,5687,5173,10860,0,0,0,0
"17722",2020-06-01,"sbpv","transporte regular","voo internacional",0,0,0,0,0,0,0,0,0,0
"17723",2020-06-01,"sbpv","transporte não regular","voo doméstico",119,119,238,47,0,47,0,0,0,0
"17724",2020-06-01,"sbpv","transporte não regular","voo internacional",0,0,0,0,0,0,0,0,0,0
"17725",2020-06-01,"sbrb","transporte regular","voo doméstico",11,11,22,1187,885,2072,0,0,0,0
"17726",2020-06-01,"sbrb","transporte regular","voo internacional",0,0,0,0,0,0,0,0,0,0
"17727",2020-06-01,"sbrb","transporte não regular","voo doméstico",140,141,281,187,106,293,0,0,0,0
"17728",2020-06-01,"sbrb","transporte não regular","voo internacional",0,0,0,0,0,0,0,0,0,0
"17729",2020-06-01,"sbrj","transporte regular","voo doméstico",463,463,926,43707,41568,85275,0,0,0,0
"17730",2020-06-01,"sbrj","transporte regular","voo internacional",0,0,0,0,0,0,0,0,0,0
"17731",2020-06-01,"sbrj","transporte não regular","voo doméstico",224,228,452,440,229,669,0,0,0,0
"17732",2020-06-01,"sbrj","transporte não regular","voo internacional",2,2,4,6,0,6,0,0,0,0
"17733",2020-06-01,"sbsj","transporte regular","voo doméstico",0,0,0,0,0,0,0,0,0,0
"17734",2020-06-01,"sbsj","transporte regular","voo internacional",0,0,0,0,0,0,0,0,0,0
"17735",2020-06-01,"sbsj","transporte não regular","voo doméstico",233,230,463,602,628,1230,0,0,0,0
"17736",2020-06-01,"sbsj","transporte não regular","voo internacional",1,3,4,5,1,6,0,0,0,0
"17737",2020-06-01,"sbsl","transporte regular","voo doméstico",82,82,164,8994,9483,18477,0,0,0,0
"17738",2020-06-01,"sbsl","transporte regular","voo internacional",0,0,0,0,0,0,0,0,0,0
"17739",2020-06-01,"sbsl","transporte não regular","voo doméstico",250,243,493,145,9,154,0,0,0,0
"17740",2020-06-01,"sbsl","transporte não regular","voo internacional",1,1,2,0,0,0,0,0,0,0
"17741",2020-06-01,"sbsn","transporte regular","voo doméstico",54,55,109,2535,2409,4944,0,0,0,0
"17742",2020-06-01,"sbsn","transporte regular","voo internacional",0,0,0,0,0,0,0,0,0,0
"17743",2020-06-01,"sbsn","transporte não regular","voo doméstico",323,318,641,198,104,302,0,0,0,0
"17744",2020-06-01,"sbsn","transporte não regular","voo internacional",0,0,0,0,0,0,0,0,0,0
"17745",2020-06-01,"sbsp","transporte regular","voo doméstico",375,373,748,31547,31460,63007,0,0,0,0
"17746",2020-06-01,"sbsp","transporte regular","voo internacional",0,0,0,0,0,0,0,0,0,0
"17747",2020-06-01,"sbsp","transporte não regular","voo doméstico",1172,1182,2354,2498,2185,4683,0,0,0,0
"17748",2020-06-01,"sbsp","transporte não regular","voo internacional",3,3,6,0,0,0,0,0,0,0
"17749",2020-06-01,"sbte","transporte regular","voo doméstico",51,51,102,6540,7550,14090,0,0,0,0
"17750",2020-06-01,"sbte","transporte regular","voo internacional",0,0,0,0,0,0,0,0,0,0
"17751",2020-06-01,"sbte","transporte não regular","voo doméstico",129,130,259,671,688,1359,0,0,0,0
"17752",2020-06-01,"sbte","transporte não regular","voo internacional",0,0,0,0,0,0,0,0,0,0
"17753",2020-06-01,"sbtf","transporte regular","voo doméstico",3,3,6,11,9,20,0,0,0,0
"17754",2020-06-01,"sbtf","transporte regular","voo internacional",0,0,0,0,0,0,0,0,0,0
"17755",2020-06-01,"sbtf","transporte não regular","voo doméstico",179,178,357,249,148,397,500,0,500,1200
"17756",2020-06-01,"sbtf","transporte não regular","voo internacional",0,0,0,0,0,0,0,0,0,0
"17757",2020-06-01,"sbtt","transporte regular","voo doméstico",0,0,0,0,0,0,0,0,0,0
"17758",2020-06-01,"sbtt","transporte regular","voo internacional",0,0,0,0,0,0,0,0,0,0
"17759",2020-06-01,"sbtt","transporte não regular","voo doméstico",109,106,215,634,614,1248,0,0,0,0
"17760",2020-06-01,"sbtt","transporte não regular","voo internacional",0,0,0,0,0,0,0,0,0,0
"17761",2020-06-01,"sbuf","transporte regular","voo doméstico",0,0,0,0,0,0,0,0,0,0
"17762",2020-06-01,"sbuf","transporte regular","voo internacional",0,0,0,0,0,0,0,0,0,0
"17763",2020-06-01,"sbuf","transporte não regular","voo doméstico",20,21,41,32,30,62,0,0,0,0
"17764",2020-06-01,"sbuf","transporte não regular","voo internacional",0,0,0,0,0,0,0,0,0,0
"17765",2020-06-01,"sbug","transporte regular","voo doméstico",0,0,0,0,0,0,0,0,0,0
"17766",2020-06-01,"sbug","transporte regular","voo internacional",0,0,0,0,0,0,0,0,0,0
"17767",2020-06-01,"sbug","transporte não regular","voo doméstico",4,4,8,14,8,22,0,0,0,0
"17768",2020-06-01,"sbug","transporte não regular","voo internacional",0,0,0,0,0,0,0,0,0,0
"17769",2020-06-01,"sbul","transporte regular","voo doméstico",45,45,90,2174,2286,4460,0,0,0,0
"17770",2020-06-01,"sbul","transporte regular","voo internacional",0,0,0,0,0,0,0,0,0,0
"17771",2020-06-01,"sbul","transporte não regular","voo doméstico",446,447,893,923,656,1579,0,0,0,0
"17772",2020-06-01,"sbul","transporte não regular","voo internacional",0,0,0,0,0,0,0,0,0,0
"17773",2020-06-01,"sbur","transporte regular","voo doméstico",0,0,0,0,0,0,0,0,0,0
"17774",2020-06-01,"sbur","transporte regular","voo internacional",0,0,0,0,0,0,0,0,0,0
"17775",2020-06-01,"sbur","transporte não regular","voo doméstico",206,206,412,635,596,1231,0,0,0,0
"17776",2020-06-01,"sbur","transporte não regular","voo internacional",0,0,0,0,0,0,0,0,0,0
"17777",2020-05-01,"sbbe","transporte regular","voo doméstico",231,227,458,13061,12882,25943,0,0,0,0
"17778",2020-05-01,"sbbe","transporte regular","voo internacional",1,1,2,40,79,119,0,0,0,0
"17779",2020-05-01,"sbbe","transporte não regular","voo doméstico",651,661,1312,802,1298,2100,0,0,0,0
"17780",2020-05-01,"sbbe","transporte não regular","voo internacional",6,6,12,6,0,6,0,0,0,0
"17781",2020-05-01,"sbbg","transporte regular","voo doméstico",0,0,0,0,0,0,0,0,0,0
"17782",2020-05-01,"sbbg","transporte regular","voo internacional",0,0,0,0,0,0,0,0,0,0
"17783",2020-05-01,"sbbg","transporte não regular","voo doméstico",12,12,24,44,43,87,0,0,0,0
"17784",2020-05-01,"sbbg","transporte não regular","voo internacional",0,0,0,0,0,0,0,0,0,0
"17785",2020-05-01,"sbbh","transporte regular","voo doméstico",0,0,0,0,0,0,0,0,0,0
"17786",2020-05-01,"sbbh","transporte regular","voo internacional",0,0,0,0,0,0,0,0,0,0
"17787",2020-05-01,"sbbh","transporte não regular","voo doméstico",964,959,1923,5679,5755,11434,0,0,0,0
"17788",2020-05-01,"sbbh","transporte não regular","voo internacional",0,0,0,0,0,0,0,0,0,0
"17789",2020-05-01,"sbbi","transporte regular","voo doméstico",0,0,0,0,0,0,0,0,0,0
"17790",2020-05-01,"sbbi","transporte regular","voo internacional",0,0,0,0,0,0,0,0,0,0
"17791",2020-05-01,"sbbi","transporte não regular","voo doméstico",1458,1455,2913,784,636,1420,0,0,0,0
"17792",2020-05-01,"sbbi","transporte não regular","voo internacional",0,0,0,0,0,0,0,0,0,0
"17793",2020-05-01,"sbbv","transporte regular","voo doméstico",21,21,42,1619,1569,3188,0,0,0,0
"17794",2020-05-01,"sbbv","transporte regular","voo internacional",0,0,0,0,0,0,0,0,0,0
"17795",2020-05-01,"sbbv","transporte não regular","voo doméstico",170,170,340,581,226,807,0,0,0,0
"17796",2020-05-01,"sbbv","transporte não regular","voo internacional",5,3,8,1,3,4,0,0,0,0
"17797",2020-05-01,"sbcg","transporte regular","voo doméstico",59,59,118,4418,4171,8589,61807,84880,146687,0
"17798",2020-05-01,"sbcg","transporte regular","voo internacional",0,0,0,0,0,0,0,0,0,0
"17799",2020-05-01,"sbcg","transporte não regular","voo doméstico",155,151,306,61,13,74,0,0,0,0
"17800",2020-05-01,"sbcg","transporte não regular","voo internacional",13,14,27,0,0,0,0,0,0,0
"17801",2020-05-01,"sbcj","transporte regular","voo doméstico",0,0,0,0,0,0,0,0,0,0
"17802",2020-05-01,"sbcj","transporte regular","voo internacional",0,0,0,0,0,0,0,0,0,0
"17803",2020-05-01,"sbcj","transporte não regular","voo doméstico",179,177,356,387,0,387,0,0,0,0
"17804",2020-05-01,"sbcj","transporte não regular","voo internacional",0,0,0,0,0,0,0,0,0,0
"17805",2020-05-01,"sbcr","transporte regular","voo doméstico",0,0,0,0,0,0,0,0,0,0
"17806",2020-05-01,"sbcr","transporte regular","voo internacional",0,0,0,0,0,0,0,0,0,0
"17807",2020-05-01,"sbcr","transporte não regular","voo doméstico",33,32,65,72,54,126,0,0,0,0
"17808",2020-05-01,"sbcr","transporte não regular","voo internacional",0,0,0,0,0,0,0,0,0,0
"17809",2020-05-01,"sbct","transporte regular","voo doméstico",185,185,370,13754,14644,28398,136013,51135,187148,146053
"17810",2020-05-01,"sbct","transporte regular","voo internacional",32,32,64,0,0,0,61387,54065,115452,0
"17811",2020-05-01,"sbct","transporte não regular","voo doméstico",99,94,193,185,280,465,0,0,0,0
"17812",2020-05-01,"sbct","transporte não regular","voo internacional",0,1,1,0,0,0,0,0,0,0
"17813",2020-05-01,"sbcz","transporte regular","voo doméstico",0,0,0,0,0,0,0,0,0,0
"17814",2020-05-01,"sbcz","transporte regular","voo internacional",0,0,0,0,0,0,0,0,0,0
"17815",2020-05-01,"sbcz","transporte não regular","voo doméstico",126,129,255,301,233,534,0,0,0,0
"17816",2020-05-01,"sbcz","transporte não regular","voo internacional",0,0,0,0,0,0,0,0,0,0
"17817",2020-05-01,"sbeg","transporte regular","voo doméstico",216,208,424,9921,7140,17061,104916,250051,354967,0
"17818",2020-05-01,"sbeg","transporte regular","voo internacional",37,48,85,0,0,0,0,25945,25945,0
"17819",2020-05-01,"sbeg","transporte não regular","voo doméstico",467,468,935,1582,0,1582,0,0,0,0
"17820",2020-05-01,"sbeg","transporte não regular","voo internacional",17,16,33,10,0,10,0,0,0,0
"17821",2020-05-01,"sbfi","transporte regular","voo doméstico",22,22,44,2125,1543,3668,0,0,0,0
"17822",2020-05-01,"sbfi","transporte regular","voo internacional",0,0,0,0,0,0,0,0,0,0
"17823",2020-05-01,"sbfi","transporte não regular","voo doméstico",42,43,85,37,33,70,0,0,0,0
"17824",2020-05-01,"sbfi","transporte não regular","voo internacional",5,4,9,2,0,2,0,0,0,0
"17825",2020-05-01,"sbgo","transporte regular","voo doméstico",119,118,237,7585,7999,15584,165259,145165,310424,0
"17826",2020-05-01,"sbgo","transporte regular","voo internacional",0,0,0,0,0,0,0,0,0,0
"17827",2020-05-01,"sbgo","transporte não regular","voo doméstico",864,859,1723,2539,2370,4909,0,0,0,0
"17828",2020-05-01,"sbgo","transporte não regular","voo internacional",2,1,3,0,0,0,0,0,0,0
"17829",2020-05-01,"sbht","transporte regular","voo doméstico",39,39,78,209,201,410,0,0,0,0
"17830",2020-05-01,"sbht","transporte regular","voo internacional",0,0,0,0,0,0,0,0,0,0
"17831",2020-05-01,"sbht","transporte não regular","voo doméstico",105,106,211,64,114,178,0,0,0,0
"17832",2020-05-01,"sbht","transporte não regular","voo internacional",0,0,0,0,0,0,0,0,0,0
"17833",2020-05-01,"sbiz","transporte regular","voo doméstico",5,5,10,420,436,856,0,0,0,0
"17834",2020-05-01,"sbiz","transporte regular","voo internacional",0,0,0,0,0,0,0,0,0,0
"17835",2020-05-01,"sbiz","transporte não regular","voo doméstico",127,122,249,34,0,34,0,0,0,0
"17836",2020-05-01,"sbiz","transporte não regular","voo internacional",0,0,0,0,0,0,0,0,0,0
"17837",2020-05-01,"sbjc","transporte regular","voo doméstico",0,0,0,0,0,0,0,0,0,0
"17838",2020-05-01,"sbjc","transporte regular","voo internacional",0,0,0,0,0,0,0,0,0,0
"17839",2020-05-01,"sbjc","transporte não regular","voo doméstico",447,430,877,1035,630,1665,0,0,0,0
"17840",2020-05-01,"sbjc","transporte não regular","voo internacional",0,0,0,0,0,0,0,0,0,0
"17841",2020-05-01,"sbjr","transporte regular","voo doméstico",0,0,0,0,0,0,0,0,0,0
"17842",2020-05-01,"sbjr","transporte regular","voo internacional",0,0,0,0,0,0,0,0,0,0
"17843",2020-05-01,"sbjr","transporte não regular","voo doméstico",1661,1659,3320,6741,1568,8309,0,0,0,0
"17844",2020-05-01,"sbjr","transporte não regular","voo internacional",0,0,0,0,0,0,0,0,0,0
"17845",2020-05-01,"sbjv","transporte regular","voo doméstico",4,4,8,0,0,0,0,0,0,0
"17846",2020-05-01,"sbjv","transporte regular","voo internacional",0,0,0,0,0,0,0,0,0,0
"17847",2020-05-01,"sbjv","transporte não regular","voo doméstico",71,72,143,696,43,739,0,0,0,0
"17848",2020-05-01,"sbjv","transporte não regular","voo internacional",0,0,0,0,0,0,0,0,0,0
"17849",2020-05-01,"sblo","transporte regular","voo doméstico",16,16,32,1084,1241,2325,0,0,0,0
"17850",2020-05-01,"sblo","transporte regular","voo internacional",0,0,0,0,0,0,0,0,0,0
"17851",2020-05-01,"sblo","transporte não regular","voo doméstico",383,394,777,163,355,518,0,0,0,0
"17852",2020-05-01,"sblo","transporte não regular","voo internacional",0,0,0,0,0,0,0,0,0,0
"17853",2020-05-01,"sbma","transporte regular","voo doméstico",34,34,68,948,854,1802,0,0,0,0
"17854",2020-05-01,"sbma","transporte regular","voo internacional",0,0,0,0,0,0,0,0,0,0
"17855",2020-05-01,"sbma","transporte não regular","voo doméstico",134,134,268,163,174,337,0,0,0,0
"17856",2020-05-01,"sbma","transporte não regular","voo internacional",0,0,0,0,0,0,0,0,0,0
"17857",2020-05-01,"sbmk","transporte regular","voo doméstico",12,12,24,390,366,756,0,0,0,0
"17858",2020-05-01,"sbmk","transporte regular","voo internacional",0,0,0,0,0,0,0,0,0,0
"17859",2020-05-01,"sbmk","transporte não regular","voo doméstico",164,165,329,266,4,270,0,0,0,0
"17860",2020-05-01,"sbmk","transporte não regular","voo internacional",0,0,0,0,0,0,0,0,0,0
"17861",2020-05-01,"sbmq","transporte regular","voo doméstico",42,42,84,2956,2950,5906,0,0,0,0
"17862",2020-05-01,"sbmq","transporte regular","voo internacional",0,0,0,0,0,0,0,0,0,0
"17863",2020-05-01,"sbmq","transporte não regular","voo doméstico",194,194,388,336,167,503,11730,32820,44550,0
"17864",2020-05-01,"sbmq","transporte não regular","voo internacional",2,2,4,0,0,0,0,0,0,0
"17865",2020-05-01,"sbmt","transporte regular","voo doméstico",0,0,0,0,0,0,0,0,0,0
"17866",2020-05-01,"sbmt","transporte regular","voo internacional",0,0,0,0,0,0,0,0,0,0
"17867",2020-05-01,"sbmt","transporte não regular","voo doméstico",1444,1445,2889,2178,2206,4384,0,0,0,0
"17868",2020-05-01,"sbmt","transporte não regular","voo internacional",0,0,0,0,0,0,0,0,0,0
"17869",2020-05-01,"sbnf","transporte regular","voo doméstico",30,29,59,3199,2934,6133,0,0,0,0
"17870",2020-05-01,"sbnf","transporte regular","voo internacional",0,0,0,0,0,0,0,0,0,0
"17871",2020-05-01,"sbnf","transporte não regular","voo doméstico",203,203,406,116,71,187,0,0,0,0
"17872",2020-05-01,"sbnf","transporte não regular","voo internacional",0,0,0,0,0,0,0,0,0,0
"17873",2020-05-01,"sbpb","transporte regular","voo doméstico",0,0,0,0,0,0,0,0,0,0
"17874",2020-05-01,"sbpb","transporte regular","voo internacional",0,0,0,0,0,0,0,0,0,0
"17875",2020-05-01,"sbpb","transporte não regular","voo doméstico",38,36,74,80,76,156,0,0,0,0
"17876",2020-05-01,"sbpb","transporte não regular","voo internacional",0,0,0,0,0,0,0,0,0,0
"17877",2020-05-01,"sbpj","transporte regular","voo doméstico",22,23,45,1823,1711,3534,0,0,0,0
"17878",2020-05-01,"sbpj","transporte regular","voo internacional",0,0,0,0,0,0,0,0,0,0
"17879",2020-05-01,"sbpj","transporte não regular","voo doméstico",179,178,357,229,216,445,0,0,0,0
"17880",2020-05-01,"sbpj","transporte não regular","voo internacional",1,1,2,0,0,0,0,0,0,0
"17881",2020-05-01,"sbpk","transporte regular","voo doméstico",0,0,0,0,0,0,0,0,0,0
"17882",2020-05-01,"sbpk","transporte regular","voo internacional",0,0,0,0,0,0,0,0,0,0
"17883",2020-05-01,"sbpk","transporte não regular","voo doméstico",30,31,61,72,70,142,0,0,0,0
"17884",2020-05-01,"sbpk","transporte não regular","voo internacional",0,0,0,0,0,0,0,0,0,0
"17885",2020-05-01,"sbpl","transporte regular","voo doméstico",33,33,66,1035,1126,2161,0,0,0,0
"17886",2020-05-01,"sbpl","transporte regular","voo internacional",0,0,0,0,0,0,0,0,0,0
"17887",2020-05-01,"sbpl","transporte não regular","voo doméstico",79,79,158,64,39,103,0,0,0,0
"17888",2020-05-01,"sbpl","transporte não regular","voo internacional",0,0,0,0,0,0,0,0,0,0
"17889",2020-05-01,"sbpp","transporte regular","voo doméstico",0,0,0,0,0,0,0,0,0,0
"17890",2020-05-01,"sbpp","transporte regular","voo internacional",0,0,0,0,0,0,0,0,0,0
"17891",2020-05-01,"sbpp","transporte não regular","voo doméstico",50,50,100,78,82,160,0,0,0,0
"17892",2020-05-01,"sbpp","transporte não regular","voo internacional",0,0,0,0,0,0,0,0,0,0
"17893",2020-05-01,"sbpr","transporte regular","voo doméstico",0,0,0,0,0,0,0,0,0,0
"17894",2020-05-01,"sbpr","transporte regular","voo internacional",0,0,0,0,0,0,0,0,0,0
"17895",2020-05-01,"sbpr","transporte não regular","voo doméstico",494,489,983,785,718,1503,0,0,0,0
"17896",2020-05-01,"sbpr","transporte não regular","voo internacional",0,0,0,0,0,0,0,0,0,0
"17897",2020-05-01,"sbpv","transporte regular","voo doméstico",63,63,126,3544,3701,7245,0,0,0,0
"17898",2020-05-01,"sbpv","transporte regular","voo internacional",0,0,0,0,0,0,0,0,0,0
"17899",2020-05-01,"sbpv","transporte não regular","voo doméstico",135,134,269,69,0,69,0,0,0,0
"17900",2020-05-01,"sbpv","transporte não regular","voo internacional",1,1,2,0,0,0,0,0,0,0
"17901",2020-05-01,"sbrb","transporte regular","voo doméstico",9,9,18,717,872,1589,0,0,0,0
"17902",2020-05-01,"sbrb","transporte regular","voo internacional",0,0,0,0,0,0,0,0,0,0
"17903",2020-05-01,"sbrb","transporte não regular","voo doméstico",170,168,338,149,23,172,0,0,0,0
"17904",2020-05-01,"sbrb","transporte não regular","voo internacional",3,3,6,0,0,0,0,0,0,0
"17905",2020-05-01,"sbrj","transporte regular","voo doméstico",244,242,486,20957,17856,38813,0,0,0,0
"17906",2020-05-01,"sbrj","transporte regular","voo internacional",0,0,0,0,0,0,0,0,0,0
"17907",2020-05-01,"sbrj","transporte não regular","voo doméstico",151,153,304,783,315,1098,0,0,0,0
"17908",2020-05-01,"sbrj","transporte não regular","voo internacional",0,0,0,0,0,0,0,0,0,0
"17909",2020-05-01,"sbsj","transporte regular","voo doméstico",0,0,0,0,0,0,0,0,0,0
"17910",2020-05-01,"sbsj","transporte regular","voo internacional",0,0,0,0,0,0,0,0,0,0
"17911",2020-05-01,"sbsj","transporte não regular","voo doméstico",172,171,343,438,453,891,0,0,0,0
"17912",2020-05-01,"sbsj","transporte não regular","voo internacional",0,0,0,0,0,0,0,0,0,0
"17913",2020-05-01,"sbsl","transporte regular","voo doméstico",52,52,104,4403,4703,9106,0,0,0,0
"17914",2020-05-01,"sbsl","transporte regular","voo internacional",0,0,0,0,0,0,0,0,0,0
"17915",2020-05-01,"sbsl","transporte não regular","voo doméstico",254,256,510,184,37,221,0,0,0,0
"17916",2020-05-01,"sbsl","transporte não regular","voo internacional",2,2,4,0,0,0,0,0,0,0
"17917",2020-05-01,"sbsn","transporte regular","voo doméstico",34,33,67,1153,1364,2517,0,0,0,0
"17918",2020-05-01,"sbsn","transporte regular","voo internacional",0,0,0,0,0,0,0,0,0,0
"17919",2020-05-01,"sbsn","transporte não regular","voo doméstico",220,223,443,103,0,103,0,0,0,0
"17920",2020-05-01,"sbsn","transporte não regular","voo internacional",0,0,0,0,0,0,0,0,0,0
"17921",2020-05-01,"sbsp","transporte regular","voo doméstico",26,25,51,1195,1230,2425,0,0,0,0
"17922",2020-05-01,"sbsp","transporte regular","voo internacional",0,0,0,0,0,0,0,0,0,0
"17923",2020-05-01,"sbsp","transporte não regular","voo doméstico",1083,1066,2149,1855,2187,4042,0,0,0,0
"17924",2020-05-01,"sbsp","transporte não regular","voo internacional",0,0,0,0,0,0,0,0,0,0
"17925",2020-05-01,"sbte","transporte regular","voo doméstico",29,29,58,3496,4196,7692,0,0,0,0
"17926",2020-05-01,"sbte","transporte regular","voo internacional",0,0,0,0,0,0,0,0,0,0
"17927",2020-05-01,"sbte","transporte não regular","voo doméstico",136,132,268,589,658,1247,0,0,0,0
"17928",2020-05-01,"sbte","transporte não regular","voo internacional",0,0,0,0,0,0,0,0,0,0
"17929",2020-05-01,"sbtf","transporte regular","voo doméstico",10,10,20,0,0,0,0,0,0,0
"17930",2020-05-01,"sbtf","transporte regular","voo internacional",0,0,0,0,0,0,0,0,0,0
"17931",2020-05-01,"sbtf","transporte não regular","voo doméstico",132,132,264,139,65,204,120,0,120,450
"17932",2020-05-01,"sbtf","transporte não regular","voo internacional",0,0,0,0,0,0,0,0,0,0
"17933",2020-05-01,"sbtt","transporte regular","voo doméstico",0,0,0,0,0,0,0,0,0,0
"17934",2020-05-01,"sbtt","transporte regular","voo internacional",0,0,0,0,0,0,0,0,0,0
"17935",2020-05-01,"sbtt","transporte não regular","voo doméstico",113,114,227,574,510,1084,0,0,0,0
"17936",2020-05-01,"sbtt","transporte não regular","voo internacional",0,0,0,0,0,0,0,0,0,0
"17937",2020-05-01,"sbuf","transporte regular","voo doméstico",0,0,0,0,0,0,0,0,0,0
"17938",2020-05-01,"sbuf","transporte regular","voo internacional",0,0,0,0,0,0,0,0,0,0
"17939",2020-05-01,"sbuf","transporte não regular","voo doméstico",19,18,37,15,7,22,0,0,0,0
"17940",2020-05-01,"sbuf","transporte não regular","voo internacional",0,0,0,0,0,0,0,0,0,0
"17941",2020-05-01,"sbug","transporte regular","voo doméstico",0,0,0,0,0,0,0,0,0,0
"17942",2020-05-01,"sbug","transporte regular","voo internacional",0,0,0,0,0,0,0,0,0,0
"17943",2020-05-01,"sbug","transporte não regular","voo doméstico",5,5,10,8,13,21,0,0,0,0
"17944",2020-05-01,"sbug","transporte não regular","voo internacional",0,0,0,0,0,0,0,0,0,0
"17945",2020-05-01,"sbul","transporte regular","voo doméstico",19,17,36,799,821,1620,0,0,0,0
"17946",2020-05-01,"sbul","transporte regular","voo internacional",0,0,0,0,0,0,0,0,0,0
"17947",2020-05-01,"sbul","transporte não regular","voo doméstico",380,377,757,892,944,1836,0,0,0,0
"17948",2020-05-01,"sbul","transporte não regular","voo internacional",0,0,0,0,0,0,0,0,0,0
"17949",2020-05-01,"sbur","transporte regular","voo doméstico",0,0,0,0,0,0,0,0,0,0
"17950",2020-05-01,"sbur","transporte regular","voo internacional",0,0,0,0,0,0,0,0,0,0
"17951",2020-05-01,"sbur","transporte não regular","voo doméstico",140,139,279,450,429,879,0,0,0,0
"17952",2020-05-01,"sbur","transporte não regular","voo internacional",0,0,0,0,0,0,0,0,0,0
"17953",2020-03-01,"sbbe","transporte regular","voo doméstico",799,803,1602,91577,95747,187324,0,0,0,0
"17954",2020-03-01,"sbbe","transporte regular","voo internacional",29,28,57,2258,2681,4939,0,14,14,0
"17955",2020-03-01,"sbbe","transporte não regular","voo doméstico",432,430,862,1152,987,2139,0,0,0,0
"17956",2020-03-01,"sbbe","transporte não regular","voo internacional",9,6,15,0,4,4,0,0,0,0
"17957",2020-03-01,"sbbg","transporte regular","voo doméstico",14,14,28,61,62,123,0,0,0,0
"17958",2020-03-01,"sbbg","transporte regular","voo internacional",0,0,0,0,0,0,0,0,0,0
"17959",2020-03-01,"sbbg","transporte não regular","voo doméstico",17,17,34,62,46,108,0,0,0,0
"17960",2020-03-01,"sbbg","transporte não regular","voo internacional",0,1,1,5,0,5,0,0,0,0
"17961",2020-03-01,"sbbh","transporte regular","voo doméstico",0,0,0,0,0,0,0,0,0,0
"17962",2020-03-01,"sbbh","transporte regular","voo internacional",0,0,0,0,0,0,0,0,0,0
"17963",2020-03-01,"sbbh","transporte não regular","voo doméstico",1016,1000,2016,4828,4701,9529,0,0,0,0
"17964",2020-03-01,"sbbh","transporte não regular","voo internacional",3,2,5,0,0,0,0,0,0,0
"17965",2020-03-01,"sbbi","transporte regular","voo doméstico",0,0,0,0,0,0,0,0,0,0
"17966",2020-03-01,"sbbi","transporte regular","voo internacional",0,0,0,0,0,0,0,0,0,0
"17967",2020-03-01,"sbbi","transporte não regular","voo doméstico",1187,1189,2376,640,560,1200,0,0,0,0
"17968",2020-03-01,"sbbi","transporte não regular","voo internacional",0,0,0,0,0,0,0,0,0,0
"17969",2020-03-01,"sbbv","transporte regular","voo doméstico",73,73,146,10317,9247,19564,0,0,0,0
"17970",2020-03-01,"sbbv","transporte regular","voo internacional",0,0,0,0,0,0,0,0,0,0
"17971",2020-03-01,"sbbv","transporte não regular","voo doméstico",210,212,422,255,132,387,0,0,0,0
"17972",2020-03-01,"sbbv","transporte não regular","voo internacional",15,11,26,5,4,9,0,0,0,0
"17973",2020-03-01,"sbcg","transporte regular","voo doméstico",372,374,746,34591,37461,72052,48036,74820,122856,0
"17974",2020-03-01,"sbcg","transporte regular","voo internacional",0,0,0,0,0,0,0,0,0,0
"17975",2020-03-01,"sbcg","transporte não regular","voo doméstico",141,147,288,87,88,175,0,0,0,0
"17976",2020-03-01,"sbcg","transporte não regular","voo internacional",10,7,17,4,0,4,0,0,0,0
"17977",2020-03-01,"sbcj","transporte regular","voo doméstico",61,61,122,4434,5194,9628,0,0,0,0
"17978",2020-03-01,"sbcj","transporte regular","voo internacional",0,0,0,0,0,0,0,0,0,0
"17979",2020-03-01,"sbcj","transporte não regular","voo doméstico",62,61,123,446,34,480,0,0,0,0
"17980",2020-03-01,"sbcj","transporte não regular","voo internacional",0,0,0,0,0,0,0,0,0,0
"17981",2020-03-01,"sbcr","transporte regular","voo doméstico",13,13,26,642,986,1628,0,0,0,0
"17982",2020-03-01,"sbcr","transporte regular","voo internacional",0,0,0,0,0,0,0,0,0,0
"17983",2020-03-01,"sbcr","transporte não regular","voo doméstico",45,45,90,95,89,184,0,0,0,0
"17984",2020-03-01,"sbcr","transporte não regular","voo internacional",3,3,6,7,10,17,0,0,0,0
"17985",2020-03-01,"sbct","transporte regular","voo doméstico",1735,1730,3465,153024,160925,313949,80038,44102,124140,140532
"17986",2020-03-01,"sbct","transporte regular","voo internacional",53,54,107,1244,1308,2552,14289,3303,17592,0
"17987",2020-03-01,"sbct","transporte não regular","voo doméstico",174,172,346,987,684,1671,0,0,0,0
"17988",2020-03-01,"sbct","transporte não regular","voo internacional",12,11,23,132,69,201,0,0,0,0
"17989",2020-03-01,"sbcz","transporte regular","voo doméstico",23,23,46,1479,2264,3743,0,0,0,0
"17990",2020-03-01,"sbcz","transporte regular","voo internacional",0,0,0,0,0,0,0,0,0,0
"17991",2020-03-01,"sbcz","transporte não regular","voo doméstico",160,158,318,569,508,1077,0,0,0,0
"17992",2020-03-01,"sbcz","transporte não regular","voo internacional",0,1,1,0,0,0,0,0,0,0
"17993",2020-03-01,"sbeg","transporte regular","voo doméstico",859,857,1716,85561,87903,173464,109629,196557,306186,0
"17994",2020-03-01,"sbeg","transporte regular","voo internacional",82,81,163,1765,2392,4157,0,0,0,0
"17995",2020-03-01,"sbeg","transporte não regular","voo doméstico",369,369,738,2970,739,3709,0,0,0,0
"17996",2020-03-01,"sbeg","transporte não regular","voo internacional",77,78,155,201,393,594,0,0,0,0
"17997",2020-03-01,"sbfi","transporte regular","voo doméstico",484,487,971,61662,59245,120907,0,0,0,0
"17998",2020-03-01,"sbfi","transporte regular","voo internacional",31,31,62,893,831,1724,0,0,0,0
"17999",2020-03-01,"sbfi","transporte não regular","voo doméstico",87,94,181,125,534,659,0,0,0,0
"18000",2020-03-01,"sbfi","transporte não regular","voo internacional",41,34,75,36,46,82,0,0,0,0
"18001",2020-03-01,"sbgo","transporte regular","voo doméstico",770,769,1539,69645,77430,147075,90577,128253,218830,0
"18002",2020-03-01,"sbgo","transporte regular","voo internacional",0,0,0,0,0,0,0,0,0,0
"18003",2020-03-01,"sbgo","transporte não regular","voo doméstico",766,781,1547,2670,2413,5083,0,7490,7490,0
"18004",2020-03-01,"sbgo","transporte não regular","voo internacional",4,2,6,0,0,0,0,0,0,0
"18005",2020-03-01,"sbht","transporte regular","voo doméstico",22,22,44,2096,2255,4351,0,0,0,0
"18006",2020-03-01,"sbht","transporte regular","voo internacional",0,0,0,0,0,0,0,0,0,0
"18007",2020-03-01,"sbht","transporte não regular","voo doméstico",69,71,140,82,91,173,0,0,0,0
"18008",2020-03-01,"sbht","transporte não regular","voo internacional",0,0,0,0,0,0,0,0,0,0
"18009",2020-03-01,"sbiz","transporte regular","voo doméstico",88,88,176,8907,9353,18260,0,0,0,0
"18010",2020-03-01,"sbiz","transporte regular","voo internacional",0,0,0,0,0,0,0,0,0,0
"18011",2020-03-01,"sbiz","transporte não regular","voo doméstico",95,96,191,27,6,33,0,0,0,0
"18012",2020-03-01,"sbiz","transporte não regular","voo internacional",0,0,0,0,0,0,0,0,0,0
"18013",2020-03-01,"sbjc","transporte regular","voo doméstico",0,0,0,0,0,0,0,0,0,0
"18014",2020-03-01,"sbjc","transporte regular","voo internacional",0,0,0,0,0,0,0,0,0,0
"18015",2020-03-01,"sbjc","transporte não regular","voo doméstico",171,177,348,365,218,583,0,0,0,0
"18016",2020-03-01,"sbjc","transporte não regular","voo internacional",1,1,2,0,0,0,0,0,0,0
"18017",2020-03-01,"sbjr","transporte regular","voo doméstico",36,36,72,38,20,58,0,0,0,0
"18018",2020-03-01,"sbjr","transporte regular","voo internacional",0,0,0,0,0,0,0,0,0,0
"18019",2020-03-01,"sbjr","transporte não regular","voo doméstico",2071,2067,4138,9932,3855,13787,0,0,0,0
"18020",2020-03-01,"sbjr","transporte não regular","voo internacional",1,1,2,0,0,0,0,0,0,0
"18021",2020-03-01,"sbjv","transporte regular","voo doméstico",159,160,319,13530,14007,27537,0,0,0,0
"18022",2020-03-01,"sbjv","transporte regular","voo internacional",0,0,0,0,0,0,0,0,0,0
"18023",2020-03-01,"sbjv","transporte não regular","voo doméstico",69,69,138,71,89,160,0,0,0,0
"18024",2020-03-01,"sbjv","transporte não regular","voo internacional",0,0,0,0,0,0,0,0,0,0
"18025",2020-03-01,"sblo","transporte regular","voo doméstico",277,277,554,21838,25960,47798,0,0,0,0
"18026",2020-03-01,"sblo","transporte regular","voo internacional",0,0,0,0,0,0,0,0,0,0
"18027",2020-03-01,"sblo","transporte não regular","voo doméstico",386,383,769,80,34,114,0,0,0,0
"18028",2020-03-01,"sblo","transporte não regular","voo internacional",2,2,4,0,0,0,0,0,0,0
"18029",2020-03-01,"sbma","transporte regular","voo doméstico",75,75,150,7216,7881,15097,0,0,0,0
"18030",2020-03-01,"sbma","transporte regular","voo internacional",0,0,0,0,0,0,0,0,0,0
"18031",2020-03-01,"sbma","transporte não regular","voo doméstico",94,91,185,131,115,246,0,0,0,0
"18032",2020-03-01,"sbma","transporte não regular","voo internacional",1,1,2,0,4,4,0,0,0,0
"18033",2020-03-01,"sbmk","transporte regular","voo doméstico",93,94,187,5531,5739,11270,0,0,0,0
"18034",2020-03-01,"sbmk","transporte regular","voo internacional",0,0,0,0,0,0,0,0,0,0
"18035",2020-03-01,"sbmk","transporte não regular","voo doméstico",113,109,222,201,21,222,0,0,0,0
"18036",2020-03-01,"sbmk","transporte não regular","voo internacional",0,0,0,0,0,0,0,0,0,0
"18037",2020-03-01,"sbmq","transporte regular","voo doméstico",138,139,277,16402,18206,34608,0,0,0,0
"18038",2020-03-01,"sbmq","transporte regular","voo internacional",0,0,0,0,0,0,0,0,0,0
"18039",2020-03-01,"sbmq","transporte não regular","voo doméstico",176,172,348,704,356,1060,6430,35100,41530,0
"18040",2020-03-01,"sbmq","transporte não regular","voo internacional",4,3,7,0,0,0,0,0,0,0
"18041",2020-03-01,"sbmt","transporte regular","voo doméstico",0,0,0,0,0,0,0,0,0,0
"18042",2020-03-01,"sbmt","transporte regular","voo internacional",0,0,0,0,0,0,0,0,0,0
"18043",2020-03-01,"sbmt","transporte não regular","voo doméstico",1883,1888,3771,2688,2756,5444,0,0,0,0
"18044",2020-03-01,"sbmt","transporte não regular","voo internacional",0,0,0,0,0,0,0,0,0,0
"18045",2020-03-01,"sbnf","transporte regular","voo doméstico",460,462,922,53463,51842,105305,0,0,0,0
"18046",2020-03-01,"sbnf","transporte regular","voo internacional",0,0,0,0,0,0,0,0,0,0
"18047",2020-03-01,"sbnf","transporte não regular","voo doméstico",247,248,495,203,255,458,0,0,0,0
"18048",2020-03-01,"sbnf","transporte não regular","voo internacional",2,2,4,6,11,17,0,0,0,0
"18049",2020-03-01,"sbpb","transporte regular","voo doméstico",3,3,6,203,267,470,0,0,0,0
"18050",2020-03-01,"sbpb","transporte regular","voo internacional",0,0,0,0,0,0,0,0,0,0
"18051",2020-03-01,"sbpb","transporte não regular","voo doméstico",20,22,42,29,17,46,0,0,0,0
"18052",2020-03-01,"sbpb","transporte não regular","voo internacional",0,0,0,0,0,0,0,0,0,0
"18053",2020-03-01,"sbpj","transporte regular","voo doméstico",154,153,307,13633,14293,27926,0,0,0,0
"18054",2020-03-01,"sbpj","transporte regular","voo internacional",0,0,0,0,0,0,0,0,0,0
"18055",2020-03-01,"sbpj","transporte não regular","voo doméstico",121,125,246,177,49,226,0,0,0,0
"18056",2020-03-01,"sbpj","transporte não regular","voo internacional",1,1,2,0,0,0,0,0,0,0
"18057",2020-03-01,"sbpk","transporte regular","voo doméstico",22,22,44,964,1017,1981,0,0,0,0
"18058",2020-03-01,"sbpk","transporte regular","voo internacional",0,0,0,0,0,0,0,0,0,0
"18059",2020-03-01,"sbpk","transporte não regular","voo doméstico",39,39,78,129,102,231,0,0,0,0
"18060",2020-03-01,"sbpk","transporte não regular","voo internacional",6,6,12,0,4,4,0,0,0,0
"18061",2020-03-01,"sbpl","transporte regular","voo doméstico",132,131,263,10271,12073,22344,0,0,0,0
"18062",2020-03-01,"sbpl","transporte regular","voo internacional",0,0,0,0,0,0,0,0,0,0
"18063",2020-03-01,"sbpl","transporte não regular","voo doméstico",57,56,113,58,211,269,0,0,0,0
"18064",2020-03-01,"sbpl","transporte não regular","voo internacional",2,2,4,45,45,90,0,0,0,0
"18065",2020-03-01,"sbpp","transporte regular","voo doméstico",0,0,0,0,0,0,0,0,0,0
"18066",2020-03-01,"sbpp","transporte regular","voo internacional",0,0,0,0,0,0,0,0,0,0
"18067",2020-03-01,"sbpp","transporte não regular","voo doméstico",55,57,112,65,70,135,0,0,0,0
"18068",2020-03-01,"sbpp","transporte não regular","voo internacional",6,6,12,4,1,5,0,0,0,0
"18069",2020-03-01,"sbpr","transporte regular","voo doméstico",0,0,0,0,0,0,0,0,0,0
"18070",2020-03-01,"sbpr","transporte regular","voo internacional",0,0,0,0,0,0,0,0,0,0
"18071",2020-03-01,"sbpr","transporte não regular","voo doméstico",510,504,1014,692,642,1334,0,0,0,0
"18072",2020-03-01,"sbpr","transporte não regular","voo internacional",0,0,0,0,0,0,0,0,0,0
"18073",2020-03-01,"sbpv","transporte regular","voo doméstico",195,197,392,20315,22901,43216,0,0,0,0
"18074",2020-03-01,"sbpv","transporte regular","voo internacional",0,0,0,0,0,0,0,0,0,0
"18075",2020-03-01,"sbpv","transporte não regular","voo doméstico",145,144,289,189,220,409,0,0,0,0
"18076",2020-03-01,"sbpv","transporte não regular","voo internacional",0,0,0,0,0,0,0,0,0,0
"18077",2020-03-01,"sbrb","transporte regular","voo doméstico",114,115,229,9875,11991,21866,0,0,0,0
"18078",2020-03-01,"sbrb","transporte regular","voo internacional",0,0,0,0,0,0,0,0,0,0
"18079",2020-03-01,"sbrb","transporte não regular","voo doméstico",114,117,231,322,132,454,0,0,0,0
"18080",2020-03-01,"sbrb","transporte não regular","voo internacional",4,3,7,0,0,0,0,0,0,0
"18081",2020-03-01,"sbrj","transporte regular","voo doméstico",2872,2883,5755,273634,259465,533099,0,0,0,0
"18082",2020-03-01,"sbrj","transporte regular","voo internacional",0,0,0,0,0,0,0,0,0,0
"18083",2020-03-01,"sbrj","transporte não regular","voo doméstico",327,351,678,925,275,1200,0,0,0,0
"18084",2020-03-01,"sbrj","transporte não regular","voo internacional",2,2,4,0,0,0,0,0,0,0
"18085",2020-03-01,"sbsj","transporte regular","voo doméstico",21,22,43,821,765,1586,0,0,0,0
"18086",2020-03-01,"sbsj","transporte regular","voo internacional",0,0,0,0,0,0,0,0,0,0
"18087",2020-03-01,"sbsj","transporte não regular","voo doméstico",328,325,653,911,925,1836,0,0,0,0
"18088",2020-03-01,"sbsj","transporte não regular","voo internacional",0,1,1,4,0,4,0,0,0,0
"18089",2020-03-01,"sbsl","transporte regular","voo doméstico",381,381,762,41456,46233,87689,0,0,0,0
"18090",2020-03-01,"sbsl","transporte regular","voo internacional",0,0,0,0,0,0,0,0,0,0
"18091",2020-03-01,"sbsl","transporte não regular","voo doméstico",167,167,334,341,587,928,0,0,0,0
"18092",2020-03-01,"sbsl","transporte não regular","voo internacional",2,2,4,0,0,0,0,0,0,0
"18093",2020-03-01,"sbsn","transporte regular","voo doméstico",145,145,290,13694,15707,29401,0,0,0,0
"18094",2020-03-01,"sbsn","transporte regular","voo internacional",0,0,0,0,0,0,0,0,0,0
"18095",2020-03-01,"sbsn","transporte não regular","voo doméstico",199,197,396,151,53,204,0,0,0,0
"18096",2020-03-01,"sbsn","transporte não regular","voo internacional",1,1,2,1,0,1,0,0,0,0
"18097",2020-03-01,"sbsp","transporte regular","voo doméstico",4952,4983,9935,511768,507197,1018965,0,0,0,0
"18098",2020-03-01,"sbsp","transporte regular","voo internacional",0,0,0,0,0,0,0,0,0,0
"18099",2020-03-01,"sbsp","transporte não regular","voo doméstico",1472,1438,2910,4537,4924,9461,0,0,0,0
"18100",2020-03-01,"sbsp","transporte não regular","voo internacional",8,6,14,0,0,0,0,0,0,0
"18101",2020-03-01,"sbte","transporte regular","voo doméstico",271,272,543,29308,32197,61505,0,0,0,0
"18102",2020-03-01,"sbte","transporte regular","voo internacional",0,0,0,0,0,0,0,0,0,0
"18103",2020-03-01,"sbte","transporte não regular","voo doméstico",114,110,224,755,1056,1811,0,0,0,0
"18104",2020-03-01,"sbte","transporte não regular","voo internacional",0,0,0,0,0,0,0,0,0,0
"18105",2020-03-01,"sbtf","transporte regular","voo doméstico",19,19,38,1177,1533,2710,0,0,0,0
"18106",2020-03-01,"sbtf","transporte regular","voo internacional",0,0,0,0,0,0,0,0,0,0
"18107",2020-03-01,"sbtf","transporte não regular","voo doméstico",103,102,205,128,156,284,580,0,580,1320
"18108",2020-03-01,"sbtf","transporte não regular","voo internacional",0,0,0,0,0,0,0,0,0,0
"18109",2020-03-01,"sbtt","transporte regular","voo doméstico",24,24,48,1812,2197,4009,0,0,0,0
"18110",2020-03-01,"sbtt","transporte regular","voo internacional",0,0,0,0,0,0,0,0,0,0
"18111",2020-03-01,"sbtt","transporte não regular","voo doméstico",70,69,139,303,334,637,0,0,0,0
"18112",2020-03-01,"sbtt","transporte não regular","voo internacional",2,2,4,7,7,14,0,0,0,0
"18113",2020-03-01,"sbuf","transporte regular","voo doméstico",7,7,14,278,293,571,0,0,0,0
"18114",2020-03-01,"sbuf","transporte regular","voo internacional",0,0,0,0,0,0,0,0,0,0
"18115",2020-03-01,"sbuf","transporte não regular","voo doméstico",20,20,40,22,18,40,0,0,0,0
"18116",2020-03-01,"sbuf","transporte não regular","voo internacional",0,0,0,0,0,0,0,0,0,0
"18117",2020-03-01,"sbug","transporte regular","voo doméstico",11,11,22,559,606,1165,0,0,0,0
"18118",2020-03-01,"sbug","transporte regular","voo internacional",0,0,0,0,0,0,0,0,0,0
"18119",2020-03-01,"sbug","transporte não regular","voo doméstico",8,8,16,23,13,36,0,0,0,0
"18120",2020-03-01,"sbug","transporte não regular","voo internacional",0,0,0,0,0,0,0,0,0,0
"18121",2020-03-01,"sbul","transporte regular","voo doméstico",320,321,641,23567,26013,49580,0,0,0,0
"18122",2020-03-01,"sbul","transporte regular","voo internacional",0,0,0,0,0,0,0,0,0,0
"18123",2020-03-01,"sbul","transporte não regular","voo doméstico",391,388,779,842,699,1541,0,0,0,0
"18124",2020-03-01,"sbul","transporte não regular","voo internacional",0,0,0,0,0,0,0,0,0,0
"18125",2020-03-01,"sbur","transporte regular","voo doméstico",49,49,98,1425,1595,3020,0,0,0,0
"18126",2020-03-01,"sbur","transporte regular","voo internacional",0,0,0,0,0,0,0,0,0,0
"18127",2020-03-01,"sbur","transporte não regular","voo doméstico",172,171,343,577,541,1118,0,0,0,0
"18128",2020-03-01,"sbur","transporte não regular","voo internacional",0,0,0,0,0,0,0,0,0,0
